022751590918;1;141;151;197;86;70;645
002947382146;1;228;128;176;104;168;804
092786067395;1;268;107;281;99;99;854
013834122631;1;187;126;192;105;124;734
075128409260;1;264;105;213;55;86;723
098139712817;1;269;99;160;83;132;743
046837877163;1;137;270;231;75;139;852
021884639707;1;160;120;212;98;60;650
053720418200;1;142;104;213;63;151;673
054403020061;1;82;118;104;113;126;543
078252097556;1;254;238;169;79;86;826
036185162089;1;136;232;176;90;165;799
093312181033;1;172;212;120;58;76;638
009369568416;1;251;202;96;90;67;706
043905741096;1;172;96;176;97;151;692
002508947307;1;133;214;120;76;165;708
050584863303;1;186;221;272;107;76;862
034305789630;1;227;288;287;103;151;1056
001821175354;1;117;177;121;63;123;601
079424067308;1;282;211;162;112;147;914
068968710753;1;105;103;251;91;131;681
000612942766;1;250;113;102;51;85;601
035092923900;1;183;91;196;54;128;652
068877329419;1;266;99;288;118;70;841
025375100202;1;250;248;104;96;62;760
018097631977;1;264;256;198;77;114;909
071953532993;1;116;88;105;54;151;514
097080960861;1;89;106;242;101;111;649
055652421676;1;266;206;193;55;98;818
030444232191;1;82;237;200;96;65;680
064244678044;1;182;269;116;90;77;734
029837136423;1;277;204;184;62;53;780
009237765267;1;216;227;280;81;142;946
050529821727;1;286;277;280;94;102;1039
045329803024;1;245;221;91;112;172;841
070309093847;1;159;133;119;96;81;588
076208512407;1;262;168;202;118;100;850
055095814776;1;252;220;236;72;118;898
055023976457;1;247;134;237;84;79;781
005761200189;1;113;199;127;90;89;618
027600547539;1;263;196;146;79;124;808
097816296633;1;254;282;164;85;71;856
029578365954;1;188;202;250;82;70;792
084794742393;1;272;84;248;53;86;743
036958223826;1;197;156;120;60;171;704
099002604049;1;141;89;273;51;167;721
055057240683;1;220;92;130;103;131;676
012238163607;1;289;211;215;61;130;906
093946413730;1;130;147;102;50;125;554
031871819789;1;138;200;136;52;170;696
026799140577;1;94;182;293;89;119;777
030891109300;1;194;193;167;96;110;760
016342681235;1;142;265;264;58;172;901
032806091398;1;186;198;278;61;69;792
041290844879;1;225;216;94;120;71;726
052450942806;1;133;156;247;83;128;747
027512670864;1;187;239;295;63;130;914
004753680525;1;164;232;126;68;126;716
038245087411;1;268;233;231;66;156;954
033511449200;1;95;213;277;77;112;774
018285217444;1;120;130;150;90;114;604
039701800911;1;219;275;290;98;137;1019
054507401991;1;150;254;174;70;94;742
068628038596;1;170;98;215;76;139;698
086122354027;1;186;163;208;110;161;828
005821006812;1;264;106;231;81;157;839
010605506249;1;94;86;208;107;160;655
095483709883;1;150;278;96;62;66;652
031733924087;1;180;155;233;92;164;824
040782476393;1;144;152;128;114;135;673
006566827488;1;262;201;210;108;61;842
087836119791;1;181;142;293;70;61;747
084234051329;1;122;269;120;67;54;632
018420725707;1;217;169;194;76;119;775
054612975574;1;177;158;190;115;149;789
064023314421;1;226;154;182;112;68;742
026016577629;1;272;194;242;56;156;920
005714070222;1;95;263;287;58;74;777
005040118375;1;167;162;251;106;123;809
038990371779;1;113;119;289;96;153;770
034014920462;1;153;203;166;118;113;753
078357913569;1;92;176;93;85;159;605
077460312574;1;225;190;183;75;75;748
007286638660;1;187;128;127;110;154;706
069510422659;1;190;222;132;50;166;760
051892921284;1;113;288;290;72;152;915
051094519176;1;202;152;245;105;75;779
053039242180;1;113;248;175;63;108;707
038562762630;1;280;94;254;64;87;779
010308416074;1;255;180;199;58;98;790
097215977567;1;209;134;110;77;89;619
085692784119;1;180;137;153;74;168;712
062330713155;1;83;102;294;79;69;627
073229053792;1;157;181;166;94;83;681
078225255286;1;272;248;187;94;175;976
094989445133;1;187;113;232;109;137;778
003707127102;1;211;198;186;113;118;826
099281860059;1;126;275;143;119;92;755
030997751273;1;229;118;181;112;177;817
064980124698;1;231;186;251;120;78;866
064646559324;1;129;146;285;53;161;774
055903507482;1;141;125;94;120;130;610
023442713110;1;108;206;258;50;130;752
021851744626;1;178;198;195;94;147;812
072036125720;1;215;155;231;115;140;856
085347075019;1;111;96;245;74;170;696
087446293127;1;130;194;300;55;83;762
027021551017;1;133;250;213;81;163;840
098051338100;1;127;86;132;97;51;493
037407389563;1;269;205;269;117;62;922
040963034804;1;200;221;245;111;52;829
029455413678;1;138;235;280;79;128;860
039763530107;1;289;112;130;60;101;692
023676210306;1;210;246;229;88;115;888
001298213041;1;159;228;136;63;78;664
066909447187;1;195;237;299;59;65;855
097203037262;1;99;261;111;97;170;738
004041384029;1;220;128;230;93;98;769
008256443580;1;205;244;151;77;96;773
025035439971;1;101;167;157;112;119;656
097799469596;1;139;196;227;68;169;799
053419470697;1;230;82;169;120;76;677
019422562158;1;116;94;169;110;79;568
036848819731;1;178;107;285;71;154;795
038296089215;1;136;214;287;99;72;808
053769799069;1;273;144;180;54;81;732
072534782590;1;281;273;157;52;165;928
065386143052;1;117;124;188;62;50;541
074923850466;1;261;220;267;65;144;957
054658775954;1;237;221;140;67;55;720
018089053987;1;196;183;293;80;74;826
049508998909;1;100;119;105;77;172;573
018562428857;1;96;227;288;117;86;814
019018290659;1;282;118;197;110;144;851
008966389007;1;171;283;136;119;101;810
034568402052;1;133;115;263;52;97;660
000005084333;1;261;100;274;64;140;839
020383211543;1;163;159;199;98;96;715
066645101222;1;137;195;257;53;51;693
014900221864;1;113;161;293;98;149;814
024297253645;1;104;178;179;81;176;718
070142824979;1;111;189;202;73;154;729
035795291741;1;176;280;137;63;58;714
002611425174;1;119;246;251;73;76;765
097689805808;1;82;145;175;58;141;601
093707084862;1;86;195;201;83;153;718
056066247899;1;262;168;210;65;162;867
044325246764;1;236;260;267;58;174;995
040980149549;1;173;265;166;118;76;798
083731870500;1;232;253;256;109;142;992
049807686188;1;266;260;96;109;82;813
017304811448;1;143;287;147;53;59;689
002406095575;1;107;156;208;66;94;631
002990222772;1;112;106;242;76;67;603
077076351109;1;151;168;177;80;128;704
071605172905;1;115;98;119;105;58;495
006176013960;1;123;158;171;65;166;683
001866331078;1;206;96;257;67;74;700
044004848766;1;198;285;264;111;60;918
051811476435;1;275;186;114;109;124;808
068550811713;1;187;145;176;104;57;669
060751403432;1;123;231;293;73;57;777
035389298928;1;230;224;122;60;138;774
082598229334;1;273;245;141;120;60;839
096773940968;1;228;164;206;106;53;757
034816551911;1;142;125;223;58;110;658
088699095387;1;194;194;218;64;149;819
035288052927;1;154;219;122;54;72;621
058929970444;1;93;271;267;118;117;866
024508826312;1;126;100;289;85;137;737
017556989630;1;250;142;91;102;131;716
036940415299;1;206;220;154;112;71;763
078479921613;1;281;100;244;117;162;904
010140901677;1;157;271;137;50;62;677
099180340334;1;146;144;236;98;85;709
022519287730;1;93;264;218;64;122;761
050546458337;1;127;195;255;120;159;856
088423730209;1;272;231;287;114;128;1032
024126644130;1;151;254;289;106;57;857
063012046645;1;124;152;129;61;131;597
098817246371;1;174;245;195;97;163;874
083146168268;1;202;221;193;120;154;890
089617791190;1;192;269;190;73;144;868
045325127627;1;136;94;205;85;74;594
083890939812;1;214;108;179;90;57;648
015589916479;1;265;276;222;110;129;1002
077415744071;1;263;98;140;88;104;693
005679768266;1;174;188;245;89;82;778
074979726997;1;125;261;178;112;98;774
049376252656;1;224;260;241;100;54;879
091441258584;1;250;262;258;67;166;1003
044210196938;1;195;274;212;112;73;866
008069764034;1;107;273;223;94;136;833
030166291004;1;133;182;137;117;175;744
025730236050;1;82;89;224;79;137;611
043100281763;1;223;177;112;93;79;684
007760588185;1;104;238;119;106;70;637
027959993056;1;256;231;172;63;164;886
051119367561;1;230;251;218;87;79;865
088972102415;1;155;95;230;74;63;617
054977294873;1;109;245;100;62;88;604
005642652821;1;229;91;200;107;135;762
006975529582;1;221;144;134;70;177;746
066395975357;1;257;281;116;92;81;827
028670119784;1;229;213;188;67;143;840
036126067318;1;84;126;282;112;115;719
094027202055;1;192;228;141;106;145;812
005991242979;1;187;189;282;58;132;848
045563156327;1;236;82;191;95;78;682
029709316714;1;203;287;115;70;152;827
059978290566;1;103;106;119;71;178;577
048960931323;1;262;180;288;66;114;910
072618191204;1;179;187;245;66;95;772
061489663453;1;184;130;248;65;167;794
025188516220;1;142;82;271;97;134;726
032149583813;1;83;158;298;53;98;690
059310303937;1;140;141;213;76;145;715
014588753440;1;95;262;300;81;128;866
012214264313;1;101;117;294;70;67;649
034437930339;1;196;203;219;50;171;839
023248338946;1;123;277;91;84;172;747
048986015687;1;226;175;126;65;52;644
009427385948;1;186;183;142;51;103;665
034773699365;1;153;195;201;96;119;764
082520552217;1;165;252;277;97;162;953
086192446557;1;179;217;246;69;87;798
000003456887;1;195;200;96;51;149;691
066349647268;1;194;174;186;114;109;777
037344484279;1;134;171;233;84;72;694
051914504305;1;274;254;261;107;132;1028
017366556403;1;232;224;156;53;177;842
091742604211;1;251;176;165;97;149;838
037349702005;1;105;198;184;82;143;712
019736372972;1;81;146;136;60;66;489
077012945981;1;133;205;163;118;74;693
087871285340;1;198;93;193;113;54;651
017742809388;1;97;107;95;73;86;458
031635747108;1;249;138;109;55;155;706
012246143882;1;256;123;287;76;98;840
001920927818;1;119;97;147;87;138;588
076548499861;1;212;272;130;99;127;840
060732305994;1;216;244;218;84;160;922
061794936836;1;210;91;274;75;151;801
058427784331;1;185;203;229;69;167;853
015552497912;1;231;286;276;65;172;1030
059598814997;1;129;130;161;111;178;709
045144669053;1;275;145;90;88;137;735
099241624252;1;158;239;185;82;158;822
082757053681;1;97;151;214;104;90;656
048097212409;1;232;145;169;99;166;811
036327228435;1;106;274;184;61;121;746
009303494931;1;163;203;233;66;170;835
067308055081;1;264;83;232;118;97;794
089804602178;1;236;218;191;60;57;762
073329890852;1;277;173;264;109;163;986
038715295700;1;194;273;185;89;152;893
042167239727;1;176;124;287;117;79;783
091450437063;1;126;117;225;116;162;746
042902729976;1;203;206;199;99;161;868
094598517320;1;140;204;298;71;76;789
061379360678;1;267;238;233;56;150;944
041159729903;1;258;267;260;113;176;1074
097817887859;1;245;188;242;117;93;885
079767022781;1;118;280;232;56;152;838
020433933864;1;251;209;180;101;142;883
076559250360;1;102;225;169;97;132;725
077580376397;1;118;143;275;54;143;733
022971234958;1;115;82;92;95;84;468
097647422494;1;290;180;149;78;83;780
021877604628;1;130;90;98;65;64;447
097360333617;1;134;288;158;105;123;808
039078386871;1;186;207;226;70;79;768
049635423151;1;211;279;249;87;59;885
020374634573;1;210;208;140;119;87;764
070064857195;1;226;123;235;86;109;779
077493265127;1;117;90;113;80;69;469
075529360856;1;149;158;155;89;162;713
013434277905;1;130;137;104;78;116;565
056311276831;1;237;81;92;103;97;610
042917917951;1;239;222;235;66;84;846
038580733559;1;228;188;193;58;63;730
013072205676;1;257;204;147;89;54;751
038057359272;1;138;204;106;79;131;658
089818457714;1;167;141;183;71;83;645
032912282792;1;92;129;144;111;97;573
053260144198;1;274;245;109;112;148;888
053249337447;1;96;250;163;107;135;751
069254036344;1;113;239;93;72;106;623
053835546043;1;243;190;165;52;162;812
057732329741;1;159;263;226;117;152;917
018237269091;1;235;120;270;53;175;853
002157364620;1;270;276;144;61;123;874
030495398435;1;287;158;111;56;75;687
077562612542;1;226;265;265;63;170;989
023383839326;1;274;155;149;103;133;814
079954146843;1;212;229;224;62;81;808
046217508778;1;281;129;157;102;123;792
045237964462;1;80;99;230;116;156;681
035514452470;1;290;191;276;68;112;937
082233300225;1;268;219;198;108;87;880
013686284658;1;229;103;289;111;93;825
077524532004;1;251;201;117;120;119;808
018781621825;1;203;191;260;52;50;756
081100985710;1;130;110;218;92;97;647
018685781164;1;197;147;216;111;160;831
067045841968;1;198;112;292;112;138;852
035162056369;1;264;92;213;69;108;746
093610027515;1;121;221;280;86;94;802
058649126447;1;232;243;160;90;101;826
094712069405;1;161;227;272;84;141;885
019503059978;1;248;167;261;112;84;872
058599774358;1;292;278;275;114;176;1135
062114229791;1;179;162;96;92;80;609
041463175960;1;250;84;257;111;100;802
067656631652;1;149;94;199;80;157;679
065414016619;1;163;240;184;74;102;763
069135654893;1;264;194;254;57;142;911
011288066489;1;273;220;246;52;99;890
065624870896;1;159;91;133;66;90;539
002433143074;1;197;288;214;97;117;913
050142608606;1;288;140;257;63;142;890
088746681417;1;198;187;122;103;77;687
006950247996;1;206;113;251;104;57;731
035114336410;1;239;163;121;100;73;696
076826775329;1;142;220;119;115;139;735
004444162379;1;259;104;223;94;103;783
042884542154;1;166;243;181;71;130;791
009375317491;1;268;245;129;70;84;796
099571314989;1;192;83;167;73;123;638
054108148387;1;183;80;286;56;100;705
010992753241;1;131;128;111;100;123;593
036913025126;1;233;196;222;57;98;806
070269782532;1;237;138;300;59;128;862
097380649147;1;228;231;282;104;68;913
096436567366;1;149;215;101;55;172;692
013224778376;1;81;201;110;82;106;580
019480678794;1;256;92;100;66;64;578
085409406002;1;111;121;108;66;74;480
046689667898;1;126;261;106;85;172;750
096490164287;1;227;282;268;72;114;963
070594966120;1;223;101;212;90;177;803
033679714869;1;267;283;134;91;62;837
020829595186;1;287;83;242;102;172;886
059473670562;1;138;275;247;60;161;881
072119024701;1;166;147;268;96;154;831
023516711083;1;256;230;249;61;155;951
023951497328;1;135;258;164;79;71;707
092006311525;1;211;241;162;119;111;844
021785129238;1;80;251;178;82;60;651
016134628988;1;287;104;274;59;75;799
064719603653;1;85;251;124;106;162;728
011190814818;1;248;83;281;73;163;848
021970037241;1;128;281;181;65;158;813
037623050622;1;237;247;211;115;158;968
049481112620;1;107;238;240;71;153;809
084259422436;1;261;161;146;84;57;709
079541595168;1;195;177;159;61;128;720
050622513820;1;280;271;201;75;123;950
036651637503;1;132;104;179;71;159;645
034995207104;1;131;154;132;50;134;601
034199885959;1;185;242;225;63;115;830
091833157326;1;120;172;228;97;95;712
013729621846;1;211;135;267;70;123;806
089374215006;1;262;156;244;111;142;915
003359585347;1;248;218;270;53;168;957
069228434928;1;236;133;141;51;85;646
026048270703;1;252;155;212;70;167;856
068096960554;1;155;88;227;99;122;691
044281717684;1;233;234;186;113;147;913
073219373287;1;139;145;155;65;148;652
082644369186;1;140;102;130;63;70;505
050645551234;1;95;99;107;65;79;445
081309559222;1;204;203;295;64;128;894
051066026252;1;212;275;103;86;67;743
095265736257;1;243;155;213;114;100;825
031952051604;1;210;246;145;60;62;723
081027642911;1;192;235;195;94;129;845
035992176272;1;101;249;280;117;162;909
001481766653;1;160;174;224;99;53;710
050103002498;1;136;102;117;98;104;557
064774497531;1;250;254;94;108;174;880
058979493425;1;192;266;201;76;95;830
036072909407;1;119;137;293;50;110;709
098849678298;1;85;231;240;67;66;689
078663836833;1;178;265;175;104;120;842
089713115813;1;153;225;192;67;67;704
032742661700;1;267;84;132;62;130;675
059586153502;1;84;228;194;52;160;718
070508069595;1;266;229;135;53;159;842
007417757258;1;240;131;279;55;158;863
027362721434;1;265;200;209;69;116;859
021999464416;1;139;106;220;105;168;738
017817759518;1;217;200;250;116;106;889
001439269634;1;104;232;130;63;58;587
089100778271;1;149;109;257;76;153;744
026887627685;1;198;182;207;107;89;783
065720564892;1;272;94;198;112;93;769
080738925876;1;252;172;99;100;178;801
082678264230;1;264;217;282;75;113;951
092629417070;1;121;208;106;68;136;639
078035533627;1;140;142;186;79;68;615
078162801689;1;257;103;90;101;87;638
011855919746;1;163;287;213;64;112;839
097999006095;1;85;162;203;66;155;671
092940176489;1;124;283;176;118;143;844
052977847730;1;278;218;168;73;63;800
089112049636;1;87;189;210;73;94;653
011235150061;1;110;267;114;85;101;677
044049384857;1;276;259;218;81;91;925
087755311344;1;155;91;290;119;132;787
079022326550;1;211;124;276;119;117;847
025568259879;1;253;240;243;56;158;950
020681770262;1;156;156;149;90;143;694
011732630336;1;126;153;187;99;164;729
075385985650;1;268;119;93;100;156;736
026431603515;1;181;263;173;97;84;798
083417541239;1;188;167;120;74;68;617
055510918023;1;118;126;188;71;175;678
004187970951;1;139;152;255;78;78;702
066968824967;1;256;229;136;116;91;828
035895222545;1;125;257;275;77;83;817
022565391250;1;122;185;165;103;64;639
077080781674;1;95;201;285;69;98;748
024628561908;1;270;157;282;115;83;907
040396302961;1;143;220;216;112;117;808
019712541725;1;250;88;275;93;131;837
078088214472;1;118;170;157;118;144;707
086790694306;1;126;140;273;110;132;781
039282074075;1;257;274;145;53;128;857
059033383142;1;268;223;294;78;177;1040
062563991475;1;117;245;91;102;121;676
092305825717;1;106;114;167;76;131;594
006896112881;1;92;111;272;116;159;750
034439275480;1;134;85;133;50;154;556
043917828783;1;204;217;137;105;66;729
062970784940;1;123;217;147;94;84;665
024362679669;1;112;173;161;76;55;577
083639363862;1;86;245;191;120;119;761
077009978991;1;146;208;298;50;148;850
056019299454;1;121;253;218;120;103;815
051951361970;1;116;119;213;80;60;588
099074418906;1;133;97;211;103;167;711
039682102236;1;230;178;236;73;149;866
088806955159;1;207;115;151;68;89;630
098733254731;1;260;220;119;87;77;763
024518236234;1;269;105;231;110;89;804
083365452798;1;176;251;260;120;165;972
076107749645;1;123;120;150;96;100;589
002633735011;1;188;260;221;57;89;815
044705573291;1;80;121;289;106;120;716
094386802353;1;169;221;189;62;174;815
074140771777;1;280;241;147;98;99;865
085375324428;1;272;264;196;80;90;902
058034587503;1;203;233;264;72;66;838
084447455398;1;121;140;266;113;130;770
054033663357;1;212;276;230;97;160;975
047199857183;1;187;231;247;89;111;865
062127937821;1;187;164;290;52;117;810
089371125434;1;287;214;227;62;141;931
031011932400;1;281;286;278;55;146;1046
071912942695;1;187;136;104;111;54;592
022988600775;1;189;88;155;78;87;597
072150331438;1;231;166;294;72;138;901
061119011530;1;124;260;223;55;175;837
099455235754;1;116;171;295;102;104;788
041384624535;1;198;277;231;104;170;980
042677817440;1;223;93;238;92;130;776
007968287198;1;204;150;160;103;146;763
022842182959;1;118;83;249;85;83;618
046213742451;1;200;138;238;84;147;807
012917481233;1;287;217;153;104;105;866
061445648201;1;215;202;184;50;66;717
044629654218;1;272;106;118;109;99;704
007837227461;1;252;198;157;65;102;774
083517615882;1;258;254;241;100;79;932
053942029236;1;249;288;94;111;55;797
011417692315;1;189;131;132;96;112;660
051052781341;1;225;150;209;77;70;731
080011378445;1;172;103;216;111;103;705
047207732319;1;109;141;219;103;103;675
092090202832;1;246;209;108;99;72;734
005489045916;1;106;167;264;56;61;654
070412309697;1;252;237;166;92;126;873
068038778758;1;233;155;217;84;131;820
042242509815;1;166;188;217;73;150;794
071712482047;1;282;168;176;51;90;767
011976154751;1;203;161;265;84;58;771
095815177901;1;153;107;223;83;61;627
077192210304;1;184;109;187;85;128;693
019983225491;1;133;166;145;55;90;589
059880337191;1;272;101;258;98;71;800
015686334287;1;87;105;234;90;95;611
049310325975;1;257;159;208;106;66;796
098001912737;1;268;267;132;95;96;858
093291335961;1;224;201;290;88;139;942
043539515430;1;137;142;153;66;97;595
009347013638;1;204;163;254;118;63;802
047199678762;1;252;108;178;57;86;681
035366985539;1;160;242;119;105;142;768
003099084385;1;221;97;134;115;172;739
075952982294;1;204;96;231;74;136;741
067567786123;1;106;107;114;93;161;581
093153965510;1;233;252;199;58;84;826
036227811992;1;186;88;202;59;172;707
039454148767;1;164;246;249;104;83;846
042246596747;1;257;255;98;70;84;764
056271064436;1;283;283;162;94;111;933
045387782096;1;197;234;219;100;95;845
083231632255;1;178;137;95;63;111;584
090254464689;1;285;219;205;61;138;908
015491820395;1;136;114;185;55;73;563
088789746891;1;207;227;121;82;125;762
047651464503;1;169;280;215;93;63;820
095539597265;1;203;148;282;88;174;895
068579023275;1;97;117;125;111;79;529
003297324597;1;178;129;170;77;82;636
058582388026;1;266;157;291;56;87;857
099477404345;1;156;265;205;104;128;858
073874084070;1;173;153;266;103;101;796
085294456180;1;151;200;186;84;111;732
000734194387;1;210;255;154;110;54;783
020631371446;1;159;210;141;87;174;771
063077040232;1;108;194;300;71;59;732
068625154653;1;128;116;266;67;99;676
043498396470;1;117;140;159;72;163;651
057287330467;1;190;164;192;57;149;752
030988864667;1;195;253;90;117;52;707
064626098846;1;270;230;221;82;97;900
015001180314;1;227;269;209;87;164;956
033452005357;1;155;226;187;64;83;715
030193224976;1;253;93;233;67;132;778
079780064398;1;143;100;105;87;156;591
060882203609;1;217;215;219;110;168;929
007775370828;1;109;224;246;88;131;798
033501098246;1;232;113;184;110;115;754
032761666765;1;242;144;116;104;79;685
059408410311;1;137;223;139;115;99;713
058761900566;1;246;82;131;97;106;662
065120729124;1;277;82;196;71;64;690
003052976971;1;83;157;299;103;169;811
086782652481;1;266;230;160;75;125;856
019203352576;1;144;150;210;105;163;772
033025925351;1;214;193;240;52;138;837
022039522244;1;146;172;289;77;155;839
016407917052;1;185;263;185;62;71;766
081960465975;1;192;274;267;68;136;937
060369785053;1;269;206;130;93;134;832
053982026203;1;169;244;171;96;63;743
080095567313;1;199;168;259;75;102;803
010138236109;1;278;167;96;88;81;710
085096289194;1;187;112;291;83;76;749
084102841780;1;234;221;193;72;155;875
004504422091;1;215;186;262;110;173;946
015463771975;1;126;252;131;67;173;749
053169858207;1;113;261;122;96;93;685
080040982439;1;239;179;249;84;50;801
077206106488;1;167;91;114;70;144;586
049165478411;1;213;254;140;110;103;820
094136675161;1;236;153;296;83;178;946
062202577838;1;285;139;294;113;89;920
032233865450;1;130;284;193;118;153;878
001327561914;1;259;168;289;85;120;921
077331833063;1;254;180;156;88;109;787
027046279474;1;177;102;283;60;81;703
076709309825;1;172;240;259;87;167;925
062753881425;1;94;287;119;56;96;652
022745040318;1;159;193;291;60;146;849
037571674705;1;125;251;236;113;104;829
063396773422;1;126;103;224;71;98;622
095056983232;1;108;85;138;57;151;539
052663859811;1;142;108;274;100;158;782
063781305644;1;142;130;110;113;79;574
095586897981;1;134;206;109;57;157;663
067288079513;1;152;235;208;102;111;808
080507600774;1;239;237;227;89;130;922
019894192691;1;85;255;171;92;147;750
033475354493;1;159;152;282;67;178;838
086554793097;1;168;107;131;59;59;524
096421717122;1;284;183;172;117;105;861
083471854189;1;126;262;234;64;76;762
036883794681;1;100;106;280;102;105;693
034348566313;1;234;94;260;85;100;773
047895222082;1;247;153;122;109;131;762
010075804816;1;249;126;293;108;173;949
054433378005;1;291;213;291;79;86;960
072960322617;1;247;169;97;78;120;711
050284497771;1;116;209;293;50;117;785
069511239621;1;102;230;192;78;115;717
010120854615;1;290;244;186;112;57;889
049619331565;1;173;134;130;66;106;609
000304734593;1;281;140;262;105;159;947
053633355970;1;234;213;108;92;72;719
020610766239;1;276;126;138;52;109;701
097799948835;1;92;177;238;81;123;711
007587913102;1;98;281;240;56;112;787
046609430050;1;289;105;104;102;71;671
027395119416;1;139;109;134;119;63;564
082411115509;1;278;240;247;112;71;948
067324185305;1;145;82;161;92;135;615
083761038911;1;211;188;179;109;87;774
024112110941;1;120;227;229;102;107;785
023414744294;1;172;210;140;54;54;630
042784050272;1;80;90;220;70;88;548
086285703851;1;184;164;297;91;136;872
062827102287;1;233;140;168;52;170;763
009737241226;1;242;119;164;100;86;711
034474911981;1;286;216;221;89;54;866
028923235921;1;105;92;104;94;139;534
026709824047;1;132;172;251;97;123;775
079231944160;1;189;80;236;116;120;741
024416550243;1;193;137;258;81;177;846
023523716568;1;155;199;275;67;136;832
028354135810;1;146;196;215;72;105;734
013467772060;1;233;264;287;109;109;1002
056596497090;1;83;94;217;57;136;587
054005001798;1;196;114;273;107;62;752
090762046197;1;84;110;243;90;116;643
012933132208;1;138;277;189;61;125;790
065120559501;1;171;259;155;91;59;735
024982430460;1;111;108;230;89;112;650
031457679148;1;276;282;175;94;122;949
091136001266;1;286;197;231;78;134;926
034941403818;1;123;125;204;90;95;637
073869526654;1;287;257;232;105;165;1046
076637002182;1;116;90;191;70;157;624
026813619942;1;250;234;122;52;55;713
043441581352;1;231;98;93;102;177;701
091533327579;1;182;125;276;65;114;762
008082529979;1;261;155;132;60;118;726
027605394875;1;246;213;116;111;149;835
089459185085;1;231;158;199;64;173;825
019362907774;1;202;155;283;64;74;778
065922937768;1;254;134;158;57;162;765
095785034210;1;82;94;139;106;99;520
018669550122;1;120;148;225;116;147;756
062818256376;1;232;202;128;56;121;739
031874519557;1;117;132;151;87;115;602
081997079333;1;197;256;102;113;60;728
016549337396;1;215;211;257;64;143;890
071033911152;1;107;98;171;64;88;528
068000534548;1;201;204;129;50;161;745
096572470074;1;82;117;237;60;167;663
070456683178;1;258;178;152;71;66;725
016102611550;1;106;193;200;110;126;735
019529936229;1;285;83;181;101;153;803
090269682528;1;241;171;140;85;161;798
020853276567;1;156;244;148;69;126;743
031694448830;1;206;220;231;119;127;903
099458482380;1;104;250;202;99;139;794
037117262586;1;121;240;233;74;165;833
042294300410;1;91;139;263;89;100;682
079789831438;1;289;180;100;97;118;784
059777251495;1;252;93;259;58;83;745
002408861052;1;192;207;281;89;156;925
094926297733;1;174;194;224;75;66;733
086580638702;1;148;239;117;108;53;665
017146888282;1;116;255;106;81;131;689
079819102671;1;180;142;282;76;51;731
041319839779;1;199;92;243;108;80;722
001626048534;1;143;126;139;119;156;683
020525148248;1;223;178;99;110;134;744
003046314736;1;129;196;261;60;107;753
054578458706;1;288;107;132;73;92;692
047319301248;1;165;86;160;93;50;554
072099723191;1;114;195;247;86;96;738
062920858252;1;136;221;148;107;94;706
029282455298;1;195;227;120;60;89;691
099557620844;1;147;209;135;50;56;597
028876255667;1;236;116;248;72;166;838
034091124653;1;195;82;122;51;62;512
076206318147;1;189;178;290;66;178;901
084332484404;1;273;163;254;74;125;889
083179723738;1;157;212;224;59;118;770
099867842295;1;181;198;121;95;111;706
078146943714;1;101;166;101;73;57;498
058913300781;1;189;221;151;85;167;813
016476443720;1;280;243;284;67;59;933
059075797711;1;92;275;208;85;100;760
067545508371;1;172;114;238;101;86;711
097769899937;1;185;164;297;56;90;792
095656347854;1;97;162;254;95;93;701
064022046276;1;98;146;202;101;131;678
059853564054;1;166;285;137;112;50;750
056253517562;1;204;271;90;72;153;790
068057227271;1;163;270;111;116;78;738
040664530374;1;184;92;154;80;170;680
025368498147;1;284;253;297;65;150;1049
055835347865;1;182;152;252;83;138;807
008063566931;1;191;152;240;91;56;730
052951889786;1;178;119;213;106;98;714
019403971541;1;93;109;259;94;87;642
021943129813;1;210;256;90;55;178;789
040529802739;1;233;219;207;74;112;845
073996101580;1;109;102;181;56;112;560
016707219490;1;123;165;184;118;87;677
032289311587;1;175;176;117;53;124;645
024733649546;1;244;264;93;53;169;823
096633483788;1;173;102;288;69;116;748
020235306505;1;175;238;154;78;118;763
002664928611;1;282;196;220;57;172;927
085961310330;1;191;226;193;80;159;849
055983869436;1;121;254;157;63;144;739
052530159939;1;95;86;217;95;79;572
091023095878;1;241;196;123;88;107;755
082318999343;1;244;118;276;60;129;827
050634179069;1;113;176;196;69;160;714
072457135148;1;219;269;187;82;156;913
046663846376;1;167;130;239;71;59;666
061444422589;1;142;192;119;90;174;717
038628285087;1;93;97;292;73;92;647
065542147398;1;255;269;248;75;96;943
071612205105;1;178;189;146;52;166;731
068480283087;1;177;84;244;78;122;705
095768672214;1;178;180;217;119;52;746
082485444355;1;235;273;91;92;78;769
083107937617;1;87;256;151;100;65;659
051700813242;1;131;270;236;108;62;807
027693686387;1;192;283;297;101;140;1013
014034805904;1;148;80;245;58;102;633
093114406564;1;95;183;178;93;82;631
007531435632;1;266;163;111;91;129;760
095493680792;1;136;145;228;99;75;683
096627591899;1;157;155;93;70;151;626
032446349722;1;118;166;124;96;104;608
060921987955;1;285;252;144;99;65;845
091688850562;1;287;287;289;73;137;1073
049963257681;1;242;150;231;105;165;893
020502585902;1;84;275;106;87;79;631
046931400690;1;164;202;142;54;143;705
015707494287;1;167;198;271;101;161;898
090614081689;1;274;131;240;76;71;792
082299685008;1;162;220;259;113;127;881
085884345318;1;195;240;244;84;107;870
027425096757;1;284;244;266;74;166;1034
049439334495;1;182;268;102;74;90;716
020142376123;1;138;94;279;54;75;640
051893640986;1;168;260;267;72;145;912
026249603018;1;84;194;164;113;147;702
032944037587;1;80;238;221;68;137;744
063481562647;1;159;252;279;88;64;842
035307921696;1;167;272;243;85;121;888
066533331889;1;156;138;232;90;113;729
068091254280;1;275;238;264;68;178;1023
081567951432;1;260;170;222;59;80;791
083250346887;1;181;208;141;57;135;722
048097306702;1;84;94;278;72;125;653
069418840484;1;154;259;275;60;101;849
077516772026;1;99;194;266;79;117;755
071820413022;1;253;116;255;102;176;902
000326972933;1;200;97;277;110;113;797
057288618668;1;290;280;258;110;112;1050
041951645523;1;244;108;237;80;129;798
026628400590;1;104;116;218;80;81;599
061840678009;1;130;131;130;113;97;601
052179088514;1;114;197;292;113;145;861
048057742813;1;289;175;211;73;112;860
074115517885;1;151;167;202;87;60;667
070398937794;1;214;175;133;105;86;713
047690024447;1;275;228;156;74;147;880
079136594166;1;227;138;153;56;107;681
058680062453;1;160;230;260;74;105;829
070563898003;1;238;147;116;61;134;696
028616656302;1;194;214;265;101;171;945
014354282997;1;99;109;92;113;152;565
029516245812;1;269;177;91;108;59;704
039401871047;1;249;205;190;56;169;869
025652371243;1;275;242;227;76;139;959
070750529498;1;276;221;169;83;127;876
071126459913;1;100;223;134;83;149;689
060067071563;1;112;285;104;78;68;647
006851115634;1;139;131;193;71;52;586
001183653462;1;130;248;292;88;65;823
023935352784;1;284;207;240;89;175;995
071253679262;1;287;202;91;92;117;789
065677326826;1;85;253;183;64;151;736
093074842411;1;173;183;278;80;67;781
032172746379;1;81;234;103;75;52;545
071022367304;1;260;283;146;69;93;851
008568463699;1;240;211;108;90;82;731
017599489226;1;225;266;282;106;126;1005
079302444098;1;127;244;186;105;72;734
065046289907;1;176;84;197;96;112;665
060927548268;1;176;113;248;86;114;737
046693485750;1;265;143;282;90;97;877
052224737304;1;283;274;290;73;151;1071
037484084276;1;280;272;277;80;86;995
056437174304;1;265;122;269;90;109;855
074783261423;1;229;132;249;73;135;818
010931360502;1;138;112;93;50;78;471
099177797585;1;253;252;117;54;61;737
021437585329;1;117;244;222;86;151;820
090239621576;1;140;228;251;81;150;850
092740270885;1;290;204;219;60;143;916
041308766207;1;248;247;285;68;64;912
096338519586;1;255;186;249;105;149;944
031569538557;1;151;140;158;113;130;692
082234680400;1;229;158;215;55;51;708
090615266886;1;210;210;122;90;141;773
013299028303;1;203;252;294;111;69;929
021572501150;1;97;216;111;97;169;690
005311593074;1;228;132;107;54;132;653
006180413229;1;104;143;200;54;150;651
009380624881;1;225;92;222;116;93;748
033197033458;1;277;91;138;54;142;702
099871306309;1;176;106;223;103;68;676
029812857659;1;205;281;271;97;167;1021
084800717886;1;231;90;183;87;68;659
008407234507;1;180;102;247;51;178;758
030706856643;1;195;95;172;59;59;580
055597947751;1;276;85;196;110;68;735
010168491864;1;116;116;276;76;141;725
048763530329;1;104;176;103;113;127;623
024600596743;1;84;241;120;87;103;635
038017655445;1;214;227;186;97;139;863
099556410514;1;99;224;268;56;86;733
065126379827;1;158;195;229;112;156;850
062398021226;1;207;87;251;69;178;792
075462966275;1;182;261;170;83;80;776
088298577553;1;149;285;219;115;107;875
089281171543;1;230;274;238;87;155;984
095342021118;1;281;144;91;88;88;692
006858416318;1;125;239;291;113;116;884
048423866910;1;88;146;199;86;102;621
044027613031;1;250;124;104;120;74;672
036289974502;1;208;161;152;61;84;666
074887796107;1;271;261;262;68;122;984
016555934611;1;286;243;180;53;74;836
062085031678;1;80;215;278;118;60;751
065737730263;1;138;164;159;60;105;626
060757476604;1;195;210;202;68;69;744
029644933353;1;128;106;132;61;56;483
046268907197;1;120;266;294;110;106;896
091469726507;1;147;106;149;63;106;571
041745935312;1;145;287;129;62;155;778
072007834878;1;271;257;174;65;129;896
013160290727;1;93;159;122;94;143;611
056933829519;1;179;229;243;119;72;842
020927209496;1;82;266;292;112;144;896
006866732506;1;175;228;193;79;65;740
054253708582;1;99;248;191;113;127;778
035178379948;1;194;200;177;85;114;770
017131116733;1;230;131;250;64;124;799
000033432749;1;197;84;248;113;116;758
077186998151;1;209;221;294;94;60;878
039799372237;1;249;223;197;56;94;819
080686230614;1;144;284;223;56;90;797
006857866371;1;221;184;247;67;111;830
042585071309;1;93;91;108;90;154;536
071600697379;1;201;252;197;102;82;834
037149451071;1;193;150;176;117;95;731
020669052296;1;140;288;161;62;106;757
069948400003;1;110;114;91;78;174;567
004868059296;1;287;214;233;117;92;943
091652567599;1;94;197;116;114;61;582
056768767153;1;252;251;170;108;105;886
097466327646;1;194;139;143;81;148;705
054645742638;1;191;217;278;63;139;888
020919198554;1;132;112;206;95;135;680
040193893526;1;271;177;250;96;60;854
089666617662;1;287;235;116;76;51;765
017795931306;1;197;92;216;72;150;727
040017383235;1;103;120;110;59;103;495
092881453065;1;185;194;122;73;91;665
024591275822;1;156;263;200;107;70;796
010151688977;1;262;126;170;79;135;772
000712501011;1;252;250;207;93;54;856
099210677376;1;162;222;227;97;67;775
023872157554;1;276;187;206;74;101;844
009984625401;1;105;95;251;97;84;632
051559640962;1;132;266;141;51;66;656
055700433961;1;285;179;204;88;144;900
051696997345;1;193;288;234;115;106;936
034604727552;1;100;275;257;89;127;848
033836096026;1;197;87;163;75;110;632
086233292744;1;97;236;126;58;137;654
072814976997;1;290;202;185;91;162;930
092350209961;1;116;247;188;100;110;761
087181405070;1;222;153;272;90;162;899
006783135105;1;279;247;168;84;68;846
050794391997;1;290;116;255;113;114;888
018608953909;1;169;207;235;115;154;880
039438821815;1;231;254;297;96;162;1040
082952724421;1;196;103;262;105;140;806
024865700452;1;152;270;280;62;85;849
022478517121;1;96;184;115;88;156;639
023556105192;1;100;236;281;61;143;821
048472566112;1;150;174;216;74;79;693
041872661606;1;93;113;193;62;91;552
093227062247;1;160;125;292;69;84;730
051003790583;1;287;90;166;85;51;679
092677461908;1;223;193;249;72;86;823
096556705931;1;147;229;289;120;161;946
023222361762;1;260;133;159;50;91;693
099590993383;1;225;190;195;59;72;741
036688669543;1;243;288;125;79;150;885
062180436858;1;273;122;194;51;88;728
051552693380;1;142;198;224;115;133;812
072631365382;1;183;283;251;51;102;870
009754624866;1;252;129;155;112;88;736
089887462687;1;122;232;194;105;174;827
042281495722;1;263;228;237;57;129;914
051348952760;1;278;87;233;117;84;799
013558461499;1;143;248;210;117;176;894
012784799097;1;179;185;237;69;51;721
002104640506;1;132;243;135;94;121;725
052047795135;1;97;229;157;83;141;707
070286623019;1;118;250;152;107;60;687
015736697134;1;282;117;108;77;152;736
014792271419;1;264;269;189;91;143;956
052588145018;1;203;150;269;109;76;807
032471293039;1;90;262;246;98;88;784
030637519704;1;227;111;185;73;76;672
047687238307;1;87;191;214;108;131;731
006363991903;1;208;122;112;82;139;663
049992001112;1;147;86;274;54;98;659
088059011982;1;152;206;230;57;127;772
028195082015;1;212;160;260;83;51;766
009151088118;1;117;261;252;51;60;741
076282193364;1;204;275;203;117;117;916
092347388423;1;174;197;188;66;54;679
041565578212;1;287;195;261;78;163;984
001051156172;1;113;252;283;86;126;860
073988689712;1;199;115;152;110;58;634
005024894216;1;112;82;152;71;127;544
011463564493;1;167;165;175;111;159;777
059680563018;1;108;137;242;95;92;674
055738158890;1;177;266;190;120;106;859
056562751111;1;195;185;234;103;79;796
033051991950;1;262;179;127;83;116;767
065746339483;1;212;279;118;80;94;783
034807729548;1;277;190;104;83;78;732
069990142870;1;271;98;169;102;101;741
037387742421;1;281;83;230;73;120;787
042286147221;1;273;125;134;65;143;740
092468822591;1;292;229;133;116;94;864
083324638181;1;129;227;247;119;83;805
022601483142;1;130;154;153;105;62;604
049081013748;1;283;202;222;109;96;912
014621174977;1;142;132;180;95;127;676
099228936268;1;139;206;190;111;70;716
008948846886;1;217;108;248;55;64;692
029717325179;1;240;155;206;59;155;815
011447637021;1;122;275;291;54;103;845
092908101642;1;179;192;179;107;81;738
047617848523;1;187;114;190;59;156;706
006648222082;1;250;217;193;78;100;838
067280601742;1;217;189;127;82;76;691
065509948963;1;110;196;263;112;148;829
026710807813;1;172;234;256;107;56;825
087604159305;1;134;111;145;64;151;605
023366177432;1;244;161;260;120;82;867
005841312598;1;292;219;205;111;169;996
045416105918;1;204;242;223;111;172;952
020705350801;1;90;94;150;56;165;555
075046414814;1;220;124;150;67;61;622
021108465601;1;256;258;115;70;148;847
094625585210;1;204;109;227;115;77;732
055532616607;1;267;281;271;118;98;1035
020011006443;1;239;233;190;94;152;908
010274016731;1;157;163;93;64;84;561
001049486411;1;256;257;130;70;89;802
056130013990;1;232;259;150;56;166;863
098467500419;1;110;231;220;94;50;705
017676687628;1;254;204;300;113;121;992
044376046455;1;86;125;220;115;121;667
081592702105;1;163;286;222;85;147;903
048942197670;1;234;138;214;69;165;820
089281918355;1;290;179;125;54;125;773
064598318244;1;186;184;292;53;53;768
023104516863;1;124;124;230;84;158;720
079624428975;1;135;96;99;53;174;557
099144435117;1;165;238;293;116;54;866
039450415966;1;119;179;167;114;148;727
028963194534;1;130;85;175;93;80;563
053058233735;1;141;246;115;120;122;744
058870998975;1;229;112;179;101;124;745
006751595171;1;220;218;144;99;95;776
066247821878;1;87;231;128;112;138;696
074748328439;1;179;149;236;82;172;818
028270034824;1;179;207;218;116;98;818
005551315653;1;277;241;162;70;60;810
047006257725;1;158;186;141;108;104;697
001698050913;1;266;109;145;60;166;746
091990227630;1;187;117;175;80;118;677
068027028374;1;135;82;246;58;57;578
014902176092;1;190;279;221;89;169;948
097065328576;1;278;263;265;79;132;1017
007190371551;1;188;271;153;114;168;894
066103978220;1;145;159;164;91;66;625
002517447233;1;91;220;138;80;120;649
046240202440;1;193;173;183;108;136;793
069421228142;1;207;87;274;82;123;773
055935384043;1;197;248;221;115;155;936
001944246256;1;185;234;106;79;116;720
033810493139;1;172;206;93;57;177;705
064800282401;1;132;91;197;73;61;554
049508526330;1;225;131;284;81;173;894
069879359018;1;142;273;230;82;70;797
016449842874;1;151;243;135;75;120;724
065781782313;1;284;166;241;58;176;925
069616192322;1;178;206;254;92;89;819
023609088645;1;259;254;264;108;153;1038
033142476956;1;155;231;166;111;56;719
004536589680;1;282;170;222;117;127;918
050931309835;1;224;126;209;108;113;780
011451069724;1;234;98;225;112;157;826
079202994361;1;219;256;197;75;79;826
074881862601;1;157;136;284;95;155;827
012972603725;1;92;117;91;72;128;500
035674887098;1;190;281;249;54;96;870
095914645347;1;180;186;105;117;76;664
001828656244;1;144;226;136;87;160;753
070323633822;1;236;268;182;88;178;952
077676138912;1;88;108;237;96;97;626
062584277047;1;218;125;186;50;109;688
068641829333;1;142;279;241;89;60;811
045269619180;1;153;164;246;59;104;726
028339410612;1;193;285;198;61;83;820
058719517067;1;289;272;244;56;81;942
037309765270;1;166;272;235;77;84;834
033541581578;1;218;101;244;68;50;681
003217793248;1;163;167;201;70;124;725
027394450389;1;119;182;195;80;61;637
056646885165;1;249;233;298;80;78;938
088608877823;1;276;113;123;81;124;717
054868625155;1;124;222;199;104;143;792
001047965654;1;250;242;163;75;110;840
036708698734;1;208;150;141;91;62;652
008782465281;1;120;185;295;54;108;762
018251684574;1;177;127;295;109;176;884
077948657146;1;129;88;92;94;162;565
048666056675;1;291;202;180;57;81;811
087763844560;1;146;269;189;108;66;778
056027712598;1;87;187;274;75;61;684
000300596992;1;165;151;115;72;141;644
008859166747;1;168;256;159;55;166;804
094169055884;1;225;169;192;110;86;782
026290432146;1;235;126;213;113;114;801
096594741191;1;241;274;165;115;54;849
008048015881;1;94;112;156;104;51;517
059401681758;1;196;226;186;74;124;806
037159194278;1;275;152;276;104;156;963
034451585361;1;159;212;92;120;96;679
024568835048;1;166;229;281;98;166;940
032643794780;1;246;159;146;109;150;810
047095384247;1;87;102;227;62;125;603
086245844976;1;149;225;209;70;120;773
040219304652;1;105;166;143;95;112;621
009402896242;1;96;188;112;82;76;554
071328810370;1;213;162;263;79;134;851
089457602137;1;282;91;128;104;75;680
096823874593;1;137;234;126;102;169;768
017150991934;1;259;267;107;53;78;764
007083862856;1;86;114;99;116;133;548
039612103516;1;112;142;141;120;174;689
071790087771;1;108;193;126;98;85;610
046494119125;1;189;138;225;98;79;729
099845459942;1;136;137;291;107;75;746
011689098272;1;230;166;251;74;126;847
002150762615;1;108;156;195;112;93;664
088276989376;1;200;205;210;62;156;833
011354318125;1;118;195;112;70;109;604
063357420335;1;249;89;273;113;130;854
036988307072;1;218;253;243;74;154;942
084681087661;1;118;177;214;66;161;736
096293456735;1;236;253;129;97;108;823
029104499213;1;205;276;142;83;161;867
057496468506;1;220;83;115;104;85;607
053166595414;1;199;229;166;101;170;865
066965157682;1;250;229;153;90;116;838
040710314656;1;267;190;290;91;141;979
084830001483;1;190;113;104;101;142;650
013548448689;1;222;111;160;90;51;634
042152528963;1;85;253;259;59;170;826
072934103112;1;288;200;190;80;156;914
054361955864;1;138;108;141;111;167;665
078263999502;1;170;80;268;82;137;737
055956387323;1;227;110;260;93;50;740
097577542557;1;140;242;141;94;63;680
036162954994;1;219;133;252;102;92;798
008897399578;1;205;122;283;98;67;775
010655408490;1;115;146;111;50;157;579
097821218330;1;215;119;170;81;107;692
019963301696;1;162;161;204;62;105;694
037266582823;1;173;81;244;117;104;719
020942911325;1;270;109;252;66;83;780
042584623386;1;162;144;114;112;154;686
042686673116;1;246;106;134;106;133;725
098146626791;1;166;205;204;101;161;837
058271538921;1;123;264;218;60;84;749
084415685947;1;250;268;116;74;63;771
093336758611;1;171;213;156;52;57;649
075913387651;1;183;170;227;72;128;780
010822177178;1;97;187;158;98;158;698
072994111468;1;106;104;273;89;149;721
023504113032;1;99;286;275;50;144;854
096256644023;1;88;122;244;99;78;631
069301211191;1;289;276;100;87;59;811
071585652001;1;122;200;141;111;139;713
020215744975;1;138;235;288;100;150;911
060785042797;1;291;261;116;93;176;937
053006131129;1;240;263;197;115;171;986
091209324721;1;280;112;117;78;167;754
024346637774;1;227;143;104;114;95;683
041928141747;1;239;224;179;86;119;847
049261278916;1;100;181;223;69;127;700
041051101120;1;102;264;136;105;71;678
038988963413;1;175;207;248;100;130;860
069705842260;1;135;154;286;79;177;831
094384885333;1;107;287;100;69;164;727
068162702954;1;137;209;260;108;59;773
019810504099;1;205;173;271;103;57;809
018952537550;1;130;96;161;84;141;612
089406982871;1;131;257;231;100;145;864
009832893251;1;273;217;134;103;151;878
027869063666;1;106;93;268;83;176;726
060811350432;1;167;283;187;81;62;780
024429212823;1;195;202;272;107;125;901
083268057073;1;98;113;105;69;83;468
044830535492;1;288;230;97;58;141;814
048194453609;1;284;134;271;93;137;919
060523585394;1;276;283;295;86;175;1115
075739008681;1;217;208;296;66;76;863
054168555796;1;274;125;109;50;52;610
071680944908;1;166;129;291;113;112;811
082290329771;1;268;278;259;112;128;1045
022977351992;1;240;210;138;98;98;784
094353176324;1;147;255;162;107;167;838
086425615338;1;165;139;163;114;95;676
000966033856;1;225;210;222;94;153;904
052381020251;1;284;211;297;50;163;1005
078690510244;1;92;220;245;103;70;730
001966897175;1;226;255;145;51;137;814
075006726133;1;280;106;141;102;67;696
043116180876;1;144;160;174;105;172;755
007933590433;1;270;285;123;65;156;899
046762462008;1;96;107;253;86;141;683
047206387518;1;244;205;221;106;166;942
085602172358;1;240;185;245;77;177;924
066099921902;1;248;106;267;108;143;872
014023150812;1;82;92;166;67;81;488
053079529212;1;146;127;279;101;56;709
028943245231;1;241;207;271;60;170;949
075650659401;1;89;215;211;108;67;690
038004420304;1;207;198;267;81;102;855
088984782898;1;239;108;241;92;118;798
030556486337;1;245;224;126;73;167;835
093372041445;1;185;276;300;112;73;946
013572458067;1;139;151;230;102;89;711
032744885573;1;166;271;222;77;68;804
056112240210;1;193;273;279;56;173;974
074842081965;1;263;220;139;82;169;873
056760597783;1;188;269;156;91;79;783
075831448327;1;163;131;161;63;96;614
029471016004;1;168;80;195;87;70;600
071704755768;1;95;133;102;65;89;484
061746268087;1;141;163;162;74;71;611
022378628384;1;280;252;198;59;102;891
071606701796;1;271;115;219;71;171;847
044620024484;1;230;209;191;109;53;792
069916706296;1;167;173;233;78;91;742
030481382969;1;279;273;270;120;72;1014
029597584920;1;203;110;184;109;178;784
069288141957;1;176;239;230;80;93;818
090929254686;1;93;237;170;102;102;704
010349300535;1;103;287;207;114;99;810
026728949540;1;132;124;101;112;144;613
001125979305;1;208;260;260;74;89;891
081486082842;1;189;279;111;98;160;837
039702371733;1;273;244;114;109;91;831
086610745285;1;163;168;105;53;128;617
039201110485;1;172;120;236;50;136;714
009948041865;1;94;147;141;116;53;551
022083604991;1;203;224;100;77;160;764
075728406725;1;268;247;146;100;158;919
077720870869;1;200;270;281;108;119;978
014272707962;1;84;208;92;104;132;620
036473955927;1;276;89;186;110;171;832
052076678902;1;126;252;260;74;61;773
028879093514;1;213;101;109;90;70;583
022369114064;1;137;112;189;119;160;717
049734563343;1;98;81;184;89;166;618
027012255182;1;199;110;134;120;78;641
030616736929;1;254;285;139;75;118;871
082723717586;1;209;115;274;55;84;737
047765144235;1;89;147;297;59;126;718
072020584454;1;90;91;276;76;121;654
044570307996;1;133;263;259;92;175;922
007666945258;1;177;152;289;116;54;788
096118086949;1;191;243;160;56;165;815
072105376162;1;106;260;236;79;86;767
011075069553;1;197;236;257;109;150;949
025282540453;1;137;261;96;114;65;673
008033150706;1;232;214;288;86;173;993
030697575111;1;123;169;261;81;120;754
026375001109;1;95;215;129;58;128;625
091912607937;1;282;201;288;63;58;892
057915031460;1;188;83;156;54;65;546
085278552168;1;244;266;131;89;87;817
067211616504;1;83;93;92;111;97;476
015160992592;1;150;181;213;82;96;722
027996955981;1;146;153;260;59;70;688
094697286848;1;222;131;280;106;114;853
024115518882;1;138;166;199;68;123;694
043241139309;1;206;269;228;57;61;821
046993149692;1;256;247;173;69;142;887
041743112256;1;97;144;229;117;85;672
077729978995;1;86;222;187;84;119;698
005439392984;1;82;283;134;103;169;771
000180377836;1;132;252;254;82;92;812
057117061921;1;174;137;181;67;155;714
040944822812;1;87;182;169;78;137;653
074751504864;1;272;183;198;65;52;770
077899090914;1;255;196;118;50;117;736
059236429096;1;253;119;163;65;146;746
050943868163;1;258;270;156;76;134;894
055322988594;1;137;119;285;98;160;799
006434209326;1;164;134;206;116;163;783
002306820339;1;139;139;240;109;174;801
070805051862;1;129;183;112;117;109;650
010276804649;1;163;203;284;66;115;831
088614998536;1;197;240;187;92;59;775
082746425867;1;165;173;100;94;82;614
030609372436;1;118;252;189;72;87;718
023195871917;1;276;261;269;54;99;959
025803319589;1;143;170;185;87;167;752
095041608540;1;190;199;91;112;160;752
024638936961;1;177;154;182;109;170;792
089080226900;1;128;145;185;87;71;616
065444610652;1;93;230;269;101;83;776
021121292967;1;197;205;234;107;115;858
020085139600;1;99;284;94;87;124;688
076781827734;1;188;197;235;78;63;761
040227134808;1;214;141;156;92;150;753
017980917492;1;266;234;107;78;81;766
058868057351;1;278;101;152;99;60;690
057447921700;1;154;188;247;94;69;752
094980950250;1;169;248;299;117;78;911
033108428666;1;265;176;259;110;127;937
068886389591;1;187;273;282;73;74;889
019955011435;1;129;96;130;53;99;507
047258163268;1;101;96;178;119;144;638
080561690348;1;291;196;291;90;107;975
026878961637;1;144;202;232;75;90;743
004583617835;1;160;165;201;90;109;725
002462653946;1;125;96;169;109;91;590
019242616163;1;291;239;227;92;175;1024
036417887409;1;100;173;115;55;64;507
038768284104;1;188;169;95;101;108;661
023020127713;1;162;199;170;62;116;709
073202632318;1;224;241;248;75;91;879
050478069276;1;104;96;180;103;151;634
066530399795;1;234;117;188;98;92;729
090791000366;1;130;219;263;59;170;841
053527075964;1;141;85;109;71;104;510
095903433593;1;215;231;142;102;99;789
081221118280;1;164;213;221;56;172;826
069276166297;1;131;253;140;84;157;765
025290294481;1;165;103;228;89;121;706
045722520341;1;131;98;147;82;177;635
022520455055;1;237;127;200;108;146;818
020665404517;1;127;188;191;108;102;716
053072978102;1;159;132;222;68;142;723
072177833965;1;86;224;113;82;161;666
029806745509;1;158;278;180;62;142;820
066418448234;1;109;147;235;53;169;713
002040516622;1;94;187;122;52;96;551
047471914726;1;120;226;210;78;171;805
033913272125;1;224;113;226;65;121;749
053032757248;1;199;221;178;95;64;757
017624162353;1;173;282;144;70;174;843
021223671467;1;183;157;146;93;69;648
083665973084;1;112;278;229;86;125;830
090498915283;1;170;104;176;113;165;728
040461665978;1;243;190;166;55;164;818
050567221966;1;101;214;151;84;151;701
016672426929;1;222;88;115;96;160;681
020565194647;1;251;231;145;107;172;906
086108138088;1;276;164;177;112;175;904
059987752524;1;274;155;208;67;56;760
063903803437;1;99;139;237;92;72;639
047348588770;1;145;221;139;57;141;703
075805926042;1;212;235;144;112;142;845
091191764399;1;182;131;158;91;171;733
063586945445;1;165;180;268;96;57;766
087196906192;1;235;201;279;81;147;943
016577023530;1;276;135;125;74;121;731
089089231714;1;215;130;296;94;97;832
028055103736;1;186;154;293;120;59;812
049021749174;1;267;201;117;64;169;818
090327156207;1;177;84;228;86;161;736
052862947654;1;176;80;267;70;86;679
014879204926;1;240;237;252;61;177;967
086697782514;1;208;138;154;73;134;707
006360912582;1;181;208;214;63;159;825
070345173265;1;134;258;156;82;60;690
032811224893;1;147;154;275;103;170;849
056039736043;1;201;284;145;79;169;878
001903894247;1;200;181;266;55;151;853
098563820463;1;141;95;259;71;169;735
083092460219;1;165;80;188;108;165;706
099247184932;1;167;84;262;111;114;738
013599809947;1;249;284;277;118;159;1087
017558955279;1;151;119;161;117;163;711
033050358541;1;145;230;281;118;107;881
020388871456;1;246;170;123;84;52;675
083522102812;1;186;97;257;66;83;689
096880671517;1;133;101;280;115;150;779
080841522810;1;113;213;272;114;79;791
016876746195;1;108;112;277;64;61;622
056581634009;1;167;266;206;51;162;852
017969342799;1;133;246;266;81;153;879
099199313969;1;175;203;234;99;171;882
028808077822;1;226;178;92;90;104;690
029729503714;1;137;200;96;76;155;664
085117660703;1;128;231;197;117;53;726
084512104837;1;181;113;221;51;95;661
092515711558;1;230;251;128;66;139;814
000622613535;1;287;262;160;59;87;855
063710858611;1;191;230;208;80;96;805
064914460542;1;241;241;193;69;86;830
039871776366;1;187;131;172;64;56;610
095879775683;1;227;245;201;50;89;812
029082190494;1;166;140;157;81;165;709
063724134907;1;139;269;249;87;169;913
009233897936;1;112;112;138;89;78;529
037598939898;1;239;216;237;62;64;818
006934225920;1;144;196;258;118;178;894
081361621669;1;96;128;198;67;135;624
011977972151;1;130;130;170;62;113;605
077787228822;1;225;191;259;93;131;899
046548917748;1;148;127;115;60;61;511
039487878251;1;84;280;212;73;81;730
011287219720;1;177;125;132;105;50;589
073482856583;1;171;110;242;51;162;736
076505446680;1;131;117;165;67;142;622
068793573410;1;224;253;260;100;82;919
033303920573;1;274;232;107;60;124;797
093825363023;1;102;87;140;73;165;567
091780577757;1;99;222;290;61;93;765
055521844585;1;290;164;169;90;166;879
061795550326;1;203;193;196;113;86;791
096740591500;1;250;226;126;103;174;879
025927581916;1;170;155;297;50;68;740
006340539963;1;156;162;158;61;134;671
085073045118;1;287;226;295;109;133;1050
085876223343;1;209;210;129;102;93;743
009593075130;1;214;240;205;115;176;950
080785200538;1;262;111;218;105;104;800
057715107070;1;188;147;146;68;61;610
043888701589;1;128;156;214;102;165;765
012452425431;1;285;260;115;57;82;799
099003131419;1;165;266;112;93;145;781
017214434058;1;159;270;150;101;148;828
020041918135;1;210;139;287;50;168;854
066717732458;1;270;254;103;65;80;772
044309088882;1;152;152;281;76;67;728
014156806841;1;143;120;138;50;79;530
003023647899;1;157;177;235;97;112;778
095809794224;1;267;227;129;89;168;880
067784427459;1;274;275;151;59;94;853
027306473143;1;242;242;122;80;123;809
013942455863;1;212;166;204;96;125;803
020813936120;1;243;128;168;64;168;771
085377837727;1;233;284;298;89;123;1027
066482387692;1;280;243;293;66;109;991
032389090854;1;189;200;150;104;167;810
042058251866;1;159;154;208;116;77;714
095350791504;1;107;256;272;55;150;840
070076583826;1;133;203;132;119;168;755
051072467994;1;243;139;214;91;71;758
069500332449;1;106;274;241;66;90;777
045275621739;1;81;201;126;77;169;654
035892887757;1;123;119;127;54;86;509
027077720739;1;157;204;249;117;167;894
028005824171;1;253;274;188;109;89;913
008669293598;1;154;239;102;54;151;700
003257920776;1;289;107;186;118;76;776
039888675622;1;222;231;129;84;64;730
034304650585;1;202;185;163;110;160;820
020201759705;1;116;249;213;54;153;785
027592075951;1;165;263;276;106;110;920
041623626198;1;194;246;102;90;131;763
046087904397;1;152;217;148;76;127;720
026935895163;1;172;111;119;99;124;625
005116867282;1;123;125;130;116;153;647
063967657393;1;263;149;282;79;74;847
090526655058;1;271;229;154;53;103;810
062395900254;1;224;265;297;110;161;1057
067843742495;1;139;128;128;120;164;679
044796701453;1;256;114;207;104;164;845
055280484552;1;145;112;147;65;167;636
030113631153;1;116;189;201;111;158;775
008346771770;1;86;275;133;54;82;630
040309304656;1;259;122;96;112;167;756
024716710849;1;89;245;152;50;66;602
023300004154;1;110;86;130;77;172;575
031631761227;1;292;150;244;59;152;897
022162954295;1;285;101;236;120;76;818
068620863218;1;138;243;184;93;64;722
072775391296;1;141;137;190;101;100;669
068118614514;1;248;139;134;77;134;732
013563669085;1;216;99;178;88;104;685
081326968879;1;263;179;190;52;139;823
097702637710;1;195;252;161;78;146;832
082105095924;1;104;243;122;114;91;674
025222005173;1;254;198;273;94;112;931
034415056328;1;256;286;291;64;177;1074
064722060576;1;86;284;181;111;169;831
001566317563;1;91;244;248;99;84;766
085653770418;1;85;102;232;117;171;707
073065427411;1;279;210;265;114;157;1025
077969694237;1;148;193;289;56;71;757
080329480919;1;277;83;130;92;149;731
024332281302;1;187;106;117;81;170;661
050303801606;1;211;115;218;120;55;719
004285458651;1;105;239;284;89;163;880
019358156435;1;241;256;102;58;113;770
057510009099;1;192;159;278;105;175;909
058880269602;1;194;221;260;81;119;875
066918570633;1;194;265;239;70;143;911
021438570238;1;142;231;250;56;99;778
089556787242;1;105;196;95;85;128;609
084879802604;1;236;189;169;75;173;842
037366694738;1;179;210;97;72;94;652
092367251480;1;210;194;150;79;177;810
021941600391;1;141;249;130;83;143;746
055057781091;1;237;179;133;109;129;787
001772315905;1;163;155;91;89;123;621
042383062041;1;116;100;143;53;62;474
052236343815;1;122;198;137;94;146;697
014741406123;1;267;274;101;65;147;854
021276696513;1;284;190;158;116;113;861
057996104486;1;158;219;253;72;103;805
095870685445;1;93;125;182;114;108;622
076913547917;1;255;146;194;104;130;829
039473562373;1;190;210;179;55;79;713
060791887475;1;206;145;241;56;165;813
066861213454;1;98;100;139;76;50;463
074914073319;1;278;279;213;79;70;919
001343147394;1;268;125;112;72;164;741
046050841268;1;221;204;272;109;71;877
084611753682;1;291;184;235;117;81;908
087596228051;1;149;105;271;80;53;658
072064118545;1;232;178;211;64;98;783
099206609127;1;94;149;193;98;175;709
085094788313;1;119;102;95;84;101;501
029707994382;1;230;280;203;58;140;911
063465983048;1;239;271;235;120;125;990
080263043704;1;265;183;295;73;73;889
005547360681;1;158;86;179;50;170;643
066415087701;1;229;171;116;112;76;704
067492064606;1;198;170;289;117;151;925
009749462108;1;107;158;166;64;167;662
042152137239;1;212;250;171;79;102;814
045708097656;1;165;286;99;94;131;775
038368393272;1;258;222;225;70;142;917
007015367554;1;130;226;195;107;69;727
090365463251;1;263;133;144;78;135;753
033262775416;1;140;262;131;53;65;651
062883202584;1;208;109;163;71;57;608
042061336899;1;120;228;134;117;174;773
058148619136;1;203;142;187;101;113;746
041025027118;1;158;236;251;69;161;875
094408578976;1;246;150;225;67;109;797
037353855563;1;215;207;219;94;160;895
080301424503;1;190;100;285;90;163;828
087009688671;1;183;99;155;105;103;645
066843313797;1;264;159;165;94;155;837
085887638434;1;112;226;168;108;87;701
079467811044;1;125;214;215;105;87;746
036669343438;1;248;179;239;75;133;874
035002390616;1;238;157;240;100;106;841
068904953362;1;243;204;240;101;147;935
007082990921;1;219;108;217;50;103;697
084658130820;1;190;252;139;81;112;774
030565541691;1;116;162;98;62;140;578
066575013790;1;112;163;238;108;110;731
068335054936;1;89;269;169;112;81;720
019215137615;1;150;183;236;63;175;807
036516311291;1;174;80;104;110;149;617
048111302362;1;170;231;250;52;143;846
085031354813;1;98;241;107;53;149;648
086080776339;1;103;262;157;73;63;658
071456472372;1;80;271;279;59;161;850
079357470499;1;158;260;94;99;56;667
062644095121;1;229;92;121;62;57;561
045783741466;1;252;160;293;86;102;893
016201649126;1;102;99;139;63;167;570
041397808433;1;146;224;190;64;115;739
015844516538;1;292;257;118;112;110;889
007984897887;1;229;145;92;64;108;638
083363758544;1;208;181;206;87;65;747
047532510697;1;254;216;141;78;145;834
009232959362;1;286;238;122;106;175;927
075906979461;1;183;124;115;105;87;614
013038702360;1;148;275;99;106;122;750
066793567907;1;91;201;200;114;71;677
096961978411;1;158;99;187;67;151;662
086963221075;1;252;276;226;55;65;874
008959375582;1;135;141;247;73;51;647
039857724452;1;235;149;165;82;96;727
014327305653;1;284;111;162;71;82;710
089691871464;1;95;85;137;93;92;502
093276595131;1;98;189;126;110;86;609
055356577312;1;204;191;157;106;176;834
088987971905;1;180;187;180;63;80;690
052811822103;1;292;236;163;82;166;939
053177299121;1;106;168;266;119;65;724
044900821952;1;264;103;222;88;80;757
018014288568;1;136;229;293;115;68;841
051855657305;1;185;198;171;116;85;755
026536976471;1;91;218;235;102;164;810
027044555863;1;121;165;105;95;78;564
020083625794;1;203;164;192;53;78;690
093873357455;1;269;251;273;95;107;995
087641717692;1;118;264;132;57;165;736
066550677934;1;137;269;284;110;117;917
075680579297;1;116;253;187;51;61;668
093846748314;1;169;180;249;52;104;754
001198241105;1;291;198;293;73;58;913
042236171335;1;211;271;108;94;79;763
043519134541;1;93;168;163;65;127;616
073351930600;1;279;227;241;90;114;951
053853329321;1;90;133;297;115;55;690
085894474075;1;223;213;234;92;62;824
022797593109;1;115;200;101;77;63;556
028917024620;1;220;92;290;119;111;832
004452489271;1;190;123;93;96;149;651
003263206033;1;80;250;173;84;74;661
049029137510;1;163;212;133;50;137;695
091715388866;1;275;123;198;61;69;726
026300125181;1;141;126;128;50;102;547
020443336945;1;111;139;256;50;162;718
038759217114;1;217;182;113;118;129;759
006252555287;1;154;250;297;81;107;889
007325552349;1;180;98;213;73;174;738
027516788426;1;136;81;255;79;146;697
075690188782;1;183;255;185;50;133;806
002930535729;1;157;248;105;81;147;738
047088246558;1;255;214;255;87;109;920
075357539426;1;274;132;295;66;144;911
047779772036;1;225;124;283;112;151;895
033906053962;1;84;122;125;66;107;504
009540327407;1;96;168;266;120;102;752
099369640733;1;124;113;125;52;67;481
077253108002;1;93;108;289;105;56;651
012843344711;1;231;173;174;94;169;841
013535804279;1;152;284;126;97;73;732
047212038217;1;206;277;137;106;156;882
080128037096;1;104;172;243;65;71;655
001607522852;1;207;229;282;109;80;907
014993437884;1;133;176;286;80;108;783
058246067825;1;151;279;215;50;103;798
032516337429;1;133;100;214;80;134;661
049642736970;1;261;113;208;110;102;794
049930941357;1;211;216;149;56;147;779
050954298185;1;237;239;176;100;142;894
003668885320;1;246;140;140;110;178;814
089943125221;1;279;129;263;77;91;839
094228958502;1;280;209;298;117;163;1067
044334214742;1;165;216;231;65;156;833
069545514528;1;143;100;238;55;74;610
092162965959;1;206;87;158;54;112;617
031286781100;1;140;158;289;55;71;713
067545921882;1;210;153;91;79;55;588
052927073183;1;108;106;242;99;120;675
060519622765;1;88;145;180;57;108;578
055715413042;1;254;274;220;96;68;912
086543542355;1;268;203;180;96;135;882
043759738388;1;114;271;121;78;149;733
051461903812;1;256;219;206;112;133;926
094666386371;1;268;256;290;104;171;1089
061687530923;1;258;167;198;67;71;761
092825762950;1;273;240;189;90;135;927
082476279455;1;165;112;176;55;131;639
081454416664;1;115;262;278;74;107;836
008265911573;1;166;247;233;120;131;897
079526428945;1;245;178;168;113;124;828
029393867796;1;253;178;145;92;175;843
036514679973;1;163;187;274;62;52;738
028082750348;1;242;166;238;72;119;837
022558881231;1;146;145;240;99;54;684
050104575109;1;285;190;226;109;54;864
011515600281;1;151;158;176;56;165;706
050068352774;1;106;270;110;116;53;655
054374040052;1;88;132;251;106;101;678
076459864077;1;220;254;226;106;97;903
084269661472;1;141;105;265;89;107;707
007802294889;1;104;160;235;88;51;638
016818655627;1;152;244;99;70;78;643
027265717334;1;284;198;213;58;94;847
004806254480;1;182;208;262;95;137;884
020149021349;1;159;111;202;60;115;647
083714199260;1;214;123;241;99;102;779
094099290336;1;272;285;287;82;134;1060
040507321068;1;167;179;219;114;140;819
044944342106;1;84;224;269;85;108;770
019252194928;1;224;128;163;72;178;765
009769842441;1;259;136;128;86;149;758
094245532034;1;238;93;175;109;67;682
051083783391;1;170;241;222;88;104;825
058453508031;1;87;145;96;97;89;514
061061879491;1;103;99;192;74;167;635
083303357961;1;218;105;270;62;166;821
013278492513;1;152;269;197;94;63;775
061359733758;1;273;241;128;84;93;819
083758507392;1;266;98;236;94;160;854
065148065695;1;270;249;173;101;124;917
061442164113;1;188;280;114;52;72;706
025737833557;1;125;197;143;72;145;682
054066018201;1;195;166;131;65;154;711
014508380131;1;207;197;289;74;100;867
040246901494;1;125;119;251;72;111;678
000277740619;1;111;287;142;118;109;767
047763735356;1;80;169;165;82;145;641
036022814931;1;284;286;156;63;52;841
062911342834;1;112;268;113;54;90;637
097991455438;1;116;273;201;81;115;786
045780664126;1;235;220;279;66;83;883
019755518095;1;157;159;145;54;151;666
062888137412;1;154;234;170;74;118;750
079789425748;1;154;267;161;70;165;817
061383859168;1;162;244;197;119;167;889
085694941797;1;197;218;222;50;72;759
096475925046;1;193;172;269;74;113;821
036146593861;1;116;140;188;59;107;610
064091024234;1;277;111;215;87;134;824
010110847386;1;193;181;294;113;110;891
080383199505;1;157;242;195;75;157;826
086818203634;1;137;230;171;97;68;703
053348568555;1;130;86;95;52;128;491
077537154679;1;101;93;290;119;116;719
031448511208;1;134;154;217;58;110;673
004695471200;1;203;93;91;89;90;566
017186802736;1;262;245;183;101;165;956
096827438265;1;166;156;136;105;79;642
060398792249;1;276;122;222;73;76;769
047734230353;1;109;241;284;90;50;774
019264355248;1;211;139;189;108;78;725
030164124041;1;113;127;187;86;99;612
061290594345;1;142;180;239;55;150;766
019561999995;1;114;239;283;109;163;908
081170512584;1;112;234;138;91;170;745
013381438507;1;155;200;179;113;126;773
025696740522;1;199;94;114;52;147;606
066242235489;1;268;247;296;52;162;1025
032875659285;1;180;225;239;68;86;798
082052310954;1;149;210;206;81;106;752
031797216614;1;241;265;147;116;148;917
070475205123;1;253;201;300;85;175;1014
024307618418;1;173;200;99;95;66;633
028703488235;1;224;113;285;120;120;862
059455867863;1;260;248;113;89;135;845
010608724071;1;126;275;263;78;171;913
028639017211;1;128;150;249;89;128;744
070866632697;1;273;208;138;60;163;842
032825194989;1;216;186;210;76;175;863
039305421717;1;100;228;175;87;172;762
056184857036;1;211;103;285;65;123;787
091084611551;1;97;168;200;119;74;658
062563791239;1;285;201;210;100;129;925
054974696795;1;275;248;225;96;140;984
092615642511;1;86;251;234;108;64;743
073573207765;1;150;97;161;96;77;581
048721476665;1;250;188;229;73;53;793
018077548682;1;254;260;172;83;81;850
079049476956;1;141;197;137;80;166;721
032580710765;1;130;94;295;83;70;672
090637485849;1;250;118;160;96;110;734
023264367718;1;173;224;184;106;110;797
098833727150;1;292;101;182;84;122;781
089355255694;1;122;178;151;53;174;678
062254186639;1;215;169;177;113;157;831
001119479544;1;103;232;111;80;93;619
029977766781;1;163;120;297;102;150;832
061852485492;1;198;124;136;65;154;677
074496895943;1;102;119;198;110;69;598
018696267960;1;177;167;259;87;113;803
028312138300;1;143;180;228;104;171;826
057795762604;1;161;99;99;71;113;543
076241039447;1;291;211;120;82;110;814
009999124144;1;153;91;200;61;88;593
074432870975;1;278;216;233;54;155;936
039460755099;1;130;208;233;120;67;758
088405915432;1;259;127;188;72;129;775
075291765682;1;105;147;216;65;93;626
010058692808;1;237;96;105;54;50;542
083003198995;1;203;121;93;114;141;672
044122434257;1;94;278;97;118;132;719
015281616561;1;248;220;215;82;150;915
092702737167;1;151;97;116;115;59;538
007712437112;1;111;266;149;77;88;691
045591248029;1;192;89;196;85;175;737
002065230325;1;121;186;139;102;57;605
076014124280;1;257;247;262;96;120;982
084076653051;1;99;81;281;91;152;704
069489912676;1;86;273;296;54;103;812
004127986743;1;269;117;232;64;147;829
011319681289;1;136;173;218;91;98;716
005699423706;1;179;136;272;100;108;795
042542526908;1;124;176;137;62;76;575
065937892012;1;232;189;169;111;63;764
088297612524;1;268;90;136;117;98;709
001357704755;1;191;121;205;91;60;668
022010098417;1;156;287;97;53;157;750
007792710104;1;202;97;270;101;115;785
011672571751;1;290;192;279;119;174;1054
027906509938;1;109;111;214;61;138;633
002275810575;1;123;230;237;67;144;801
050707809213;1;279;191;181;60;121;832
071543081561;1;187;251;175;111;138;862
029180683800;1;126;234;231;96;110;797
014169530573;1;127;213;98;62;162;662
068982246766;1;102;152;167;69;150;640
071067370799;1;248;155;179;68;61;711
007717634392;1;90;179;243;85;92;689
076734400803;1;178;140;94;107;167;686
047711240920;1;272;237;120;74;163;866
024845373207;1;280;206;238;103;158;985
081594007601;1;139;287;288;103;112;929
098946610365;1;108;157;259;98;119;741
078650665928;1;114;198;110;84;78;584
094036306082;1;244;218;96;84;113;755
080442632765;1;123;134;192;71;75;595
053588740694;1;150;216;192;104;127;789
014884906071;1;158;266;158;64;131;777
016365929731;1;199;215;134;58;121;727
058574713486;1;276;186;170;105;94;831
086492234290;1;228;108;234;112;90;772
047448287014;1;262;123;179;111;106;781
094993211145;1;96;196;93;95;61;541
046419534352;1;156;108;291;92;78;725
017210893823;1;277;193;182;94;103;849
007886927703;1;267;243;156;96;133;895
095003437071;1;152;131;113;51;107;554
088198145110;1;278;126;213;92;173;882
085824048216;1;84;113;248;53;75;573
058995368643;1;278;153;300;67;109;907
058860634512;1;181;145;174;97;128;725
081424877782;1;195;89;287;55;54;680
073241631746;1;175;267;236;92;109;879
061385416622;1;220;89;109;105;149;672
019370169821;1;168;182;213;99;127;789
018724456209;1;94;122;183;120;81;600
054753073014;1;288;142;158;109;99;796
095741801639;1;127;219;268;88;107;809
005144189623;1;261;204;99;100;178;842
035948909002;1;202;150;234;92;113;791
046976133249;1;89;163;106;91;112;561
038482207572;1;259;133;256;74;95;817
022838879679;1;96;235;90;103;108;632
009943050175;1;163;169;247;63;52;694
087784607962;1;98;161;97;92;94;542
019384619919;1;275;252;189;58;133;907
098627175015;1;127;262;175;96;135;795
090636409908;1;218;245;150;111;124;848
025282152843;1;280;281;103;115;174;953
091438749147;1;159;94;98;113;116;580
012383146374;1;133;98;140;56;125;552
046974197961;1;137;254;112;98;133;734
072046509269;1;175;216;177;69;99;736
030325845170;1;135;89;207;96;95;622
094240753730;1;167;187;293;58;121;826
077636359889;1;136;154;173;117;104;684
067319787349;1;216;168;195;50;104;733
047329607386;1;126;255;217;91;71;760
030081400556;1;243;226;193;66;163;891
016003086065;1;256;245;255;109;178;1043
013995632838;1;194;120;98;92;161;665
080967842761;1;96;227;113;86;83;605
008756547960;1;249;186;131;85;69;720
062820062358;1;224;127;95;51;147;644
048363405291;1;158;244;232;56;125;815
016546791828;1;165;274;175;104;134;852
020849708959;1;182;174;241;118;168;883
056071178590;1;184;249;104;67;155;759
086034121199;1;82;174;208;114;173;751
041467650634;1;211;153;123;80;135;702
017388465538;1;145;212;98;111;82;648
051722694467;1;117;136;202;74;166;695
003777185002;1;89;223;287;98;153;850
055612933379;1;193;115;113;66;94;581
046124123390;1;214;117;160;97;120;708
040682645312;1;119;223;286;54;67;749
070664687074;1;101;212;165;67;135;680
031825910536;1;97;187;252;50;122;708
068418375618;1;274;215;101;68;86;744
012427987463;1;89;284;174;73;145;765
000115336019;1;145;283;271;95;105;899
066295888413;1;238;254;204;74;53;823
071335751103;1;95;247;229;67;149;787
008311409149;1;177;202;236;50;111;776
001202647171;1;240;261;149;70;149;869
054381914954;1;199;212;300;69;155;935
074035359508;1;177;223;133;103;122;758
017375055807;1;104;138;255;98;71;666
052394287483;1;235;84;297;64;51;731
095731713511;1;156;199;250;58;139;802
036063848942;1;175;272;139;68;152;806
099036098901;1;273;103;139;106;65;686
099824585638;1;93;158;222;71;53;597
069595803921;1;177;229;237;82;74;799
061884061116;1;257;245;266;54;98;920
005086668852;1;209;161;228;111;175;884
050679441285;1;128;146;289;70;116;749
063550986857;1;270;152;110;116;65;713
010261140698;1;85;284;249;58;140;816
088840699941;1;258;285;201;116;86;946
035046601182;1;146;263;107;58;78;652
094713490377;1;238;135;247;98;165;883
088013698315;1;163;121;190;75;92;641
060085132330;1;146;236;230;74;120;806
043483018237;1;189;200;125;64;160;738
077758244367;1;113;137;287;79;153;769
071029363670;1;280;269;286;57;115;1007
014864481777;1;215;211;153;88;106;773
054031566011;1;130;194;251;100;71;746
007966737203;1;240;213;294;65;52;864
072377530456;1;100;181;253;71;68;673
093412916275;1;237;230;107;60;93;727
055437757329;1;225;141;152;69;107;694
073718627992;1;279;181;111;83;119;773
005550979008;1;142;205;283;73;144;847
021671320270;1;87;112;286;56;107;648
050504137019;1;191;265;272;114;79;921
039562053893;1;251;204;261;71;117;904
030445845602;1;170;218;95;70;162;715
098048331457;1;162;216;188;60;74;700
082212559176;1;231;120;98;53;76;578
033347124108;1;233;228;250;73;82;866
056575415783;1;218;99;142;105;59;623
084672880130;1;240;190;244;108;148;930
045791075477;1;126;270;278;109;131;914
064449704657;1;217;80;158;74;112;641
039104933671;1;119;178;93;113;161;664
007226196265;1;120;242;92;92;155;701
095506592072;1;97;159;267;69;121;713
062357053811;1;144;272;269;106;105;896
040881175004;1;207;256;125;91;177;856
067394360792;1;121;158;196;80;150;705
097096328741;1;289;145;122;57;129;742
071455680779;1;152;119;169;59;171;670
053616180231;1;174;140;217;108;58;697
024553593745;1;268;88;268;88;178;890
005475776742;1;138;87;252;88;73;638
006351658894;1;161;131;190;117;163;762
063287394183;1;192;266;146;83;166;853
037622966722;1;280;174;240;116;78;888
025856859826;1;177;217;130;63;62;649
013024789319;1;250;154;157;115;97;773
008998208620;1;250;114;297;63;104;828
025685840348;1;197;150;273;108;109;837
066435490453;1;94;88;158;114;73;527
059395426275;1;138;156;179;60;174;707
028233853387;1;207;152;172;116;83;730
067936340179;1;99;95;289;106;100;689
036308485981;1;270;181;248;74;69;842
099046694352;1;91;265;174;51;89;670
040907780323;1;187;210;164;98;76;735
013877775848;1;187;206;296;88;120;897
074751674971;1;221;186;102;84;75;668
000964618034;1;223;169;144;66;101;703
045608671517;1;263;282;225;119;119;1008
040812507201;1;146;145;138;61;87;577
052136261818;1;121;158;280;95;138;792
013018810052;1;208;109;155;119;84;675
002659866953;1;212;263;140;68;103;786
087077384557;1;283;226;273;98;133;1013
076266715190;1;283;110;230;76;116;815
043720398217;1;259;190;130;102;100;781
049027603920;1;198;207;219;78;121;823
090778251943;1;159;161;265;91;62;738
060603406912;1;275;264;100;95;81;815
078684796795;1;109;109;197;83;79;577
010816992513;1;144;210;257;102;161;874
010627684498;1;169;90;198;99;78;634
023079352636;1;133;285;155;70;154;797
061043121501;1;260;107;225;88;143;823
068852338691;1;95;227;204;91;173;790
038877785398;1;179;273;132;68;91;743
017976505877;1;162;140;184;114;164;764
023321102455;1;82;189;185;67;84;607
061267823732;1;266;132;291;71;69;829
091975725751;1;111;113;281;53;118;676
004753793632;1;138;218;120;82;95;653
069109041664;1;129;138;222;57;54;600
037861284199;1;274;201;91;85;61;712
098500615844;1;157;101;254;120;81;713
027105535518;1;145;163;232;74;154;768
080438338442;1;242;99;190;93;138;762
097939596801;1;282;189;175;67;165;878
011835660821;1;225;183;141;82;58;689
042488711629;1;206;281;211;114;90;902
078189614988;1;199;147;213;66;153;778
019011525548;1;218;175;110;77;156;736
046732585545;1;171;101;186;82;114;654
097328095893;1;266;184;130;73;123;776
004366973225;1;276;227;294;68;69;934
088416773354;1;283;112;260;78;135;868
025063679647;1;234;177;149;114;122;796
056160463847;1;116;267;267;102;65;817
040849954331;1;283;152;205;83;167;890
043339679615;1;179;244;164;105;55;747
013526427684;1;122;154;291;55;75;697
051301598961;1;248;139;162;105;87;741
067740184668;1;223;224;232;79;88;846
027800244662;1;103;155;233;56;73;620
091198522643;1;135;176;173;66;122;672
020856554283;1;291;234;240;106;68;939
072915893021;1;250;126;183;66;176;801
058732425944;1;244;226;138;101;112;821
040714084119;1;125;266;277;115;149;932
043475689435;1;88;99;105;98;60;450
091339133895;1;200;233;246;59;65;803
073581517530;1;162;93;111;97;81;544
000539279658;1;159;282;162;69;174;846
092505183330;1;136;264;254;115;106;875
060997106114;1;193;226;278;74;112;883
087483752568;1;114;180;283;83;108;768
087972864729;1;163;92;164;117;149;685
072701363337;1;200;270;265;87;57;879
014027063411;1;101;81;191;101;121;595
094267326060;1;230;100;158;88;108;684
002110695369;1;288;238;293;83;51;953
076863286782;1;119;122;182;103;164;690
010254137370;1;87;171;151;86;146;641
007872185660;1;91;149;229;69;122;660
003452056605;1;251;116;258;105;164;894
056852592361;1;145;277;174;79;105;780
050842146281;1;153;232;270;84;52;791
072389611209;1;106;256;200;86;154;802
078045225469;1;269;285;104;105;55;818
054135987512;1;171;140;163;51;92;617
034615310811;1;140;258;261;50;70;779
077474484052;1;287;161;125;106;126;805
003541249840;1;136;194;133;103;109;675
059098021176;1;202;107;203;69;97;678
023834813920;1;166;137;208;88;156;755
092644311326;1;113;161;122;71;170;637
063144478563;1;169;212;94;89;141;705
017677822450;1;207;194;269;107;134;911
039529709940;1;117;276;242;74;70;779
000459151575;1;282;183;280;71;123;939
040915849590;1;205;282;156;96;178;917
095463980113;1;216;176;126;58;98;674
010657496733;1;242;161;256;89;75;823
040273023238;1;174;201;221;96;59;751
010882053350;1;251;255;192;83;71;852
090225575390;1;83;128;267;90;109;677
005013114678;1;101;89;231;104;52;577
016302462129;1;211;227;136;72;52;698
061354351367;1;115;251;151;120;72;709
002526072740;1;239;211;149;66;92;757
084896412265;1;277;266;295;115;149;1102
080084451243;1;140;170;298;97;62;767
040756556121;1;232;87;166;93;79;657
098828340795;1;200;229;147;97;137;810
047746540831;1;111;256;160;73;116;716
045076382921;1;133;211;171;105;65;685
023742896414;1;126;96;285;85;174;766
043898651572;1;259;224;283;73;63;902
016597754090;1;111;164;255;68;102;700
083416572325;1;164;149;130;97;131;671
095383018420;1;240;91;119;59;167;676
042081996816;1;232;170;100;115;93;710
058153667779;1;114;203;165;116;177;775
035270295979;1;104;250;226;90;161;831
084570623377;1;165;90;248;64;89;656
045160876666;1;203;113;289;101;123;829
052406408481;1;143;124;99;92;87;545
032760943440;1;109;151;164;79;166;669
072629106783;1;270;201;141;51;151;814
056815222366;1;269;168;162;108;72;779
008277957433;1;138;252;290;76;73;829
010450782798;1;207;173;251;61;84;776
081971423693;1;188;184;271;53;134;830
008149076494;1;156;160;199;55;134;704
090479269228;1;120;117;119;87;174;617
073765648422;1;261;283;214;94;170;1022
082454960951;1;135;161;129;90;54;569
055200797165;1;220;185;298;104;153;960
048770354912;1;135;201;107;91;53;587
021042740515;1;108;134;286;77;156;761
082899152053;1;226;226;218;51;58;779
043963954955;1;108;282;120;112;57;679
069811526076;1;186;172;222;118;134;832
091549380646;1;222;103;175;96;64;660
003639945900;1;146;198;175;112;120;751
021845202695;1;118;254;253;105;139;869
061876534206;1;168;153;220;102;157;800
026019514244;1;114;275;149;57;158;753
045051955498;1;89;248;189;53;168;747
092593816593;1;183;270;259;101;146;959
080662108210;1;186;174;122;69;51;602
036700385783;1;106;115;292;113;95;721
072048793177;1;86;221;281;120;75;783
065297187854;1;282;158;223;89;69;821
074591500410;1;255;119;285;87;118;864
033371927877;1;222;212;261;57;84;836
018435977344;1;106;189;219;53;160;727
036125080832;1;273;114;146;84;158;775
087742477878;1;216;94;105;98;67;580
068576839290;1;206;226;222;119;143;916
018466319866;1;165;131;291;101;106;794
076975019781;1;282;153;176;103;65;779
011853484143;1;193;133;117;99;127;669
023953181348;1;85;282;185;60;113;725
040709085427;1;198;231;111;113;110;763
051597468807;1;94;132;147;74;174;621
061954860588;1;251;251;237;70;166;975
061376298823;1;150;91;147;70;125;583
088077993970;1;210;124;258;72;145;809
099892042511;1;135;235;262;67;51;750
064489516444;1;102;192;127;78;165;664
035643897772;1;102;168;272;81;136;759
042278209216;1;188;216;266;116;103;889
038265172930;1;197;167;108;86;161;719
029234073119;1;150;251;122;74;107;704
085547503882;1;193;103;238;79;51;664
086139841216;1;133;153;154;74;165;679
046826168036;1;200;252;175;101;68;796
077463371662;1;195;102;135;91;81;604
015289870124;1;248;151;226;90;141;856
028343929514;1;126;121;179;96;141;663
066663895501;1;102;262;183;64;166;777
080167623683;1;202;252;130;53;75;712
073020448021;1;175;129;152;52;106;614
014399694107;1;122;168;209;83;165;747
010742875482;1;139;243;127;71;79;659
022024259457;1;199;190;262;85;131;867
024857095017;1;95;103;131;91;145;565
023048748800;1;128;276;172;111;76;763
049642301793;1;122;102;230;64;99;617
004129526477;1;161;110;233;68;142;714
098927461220;1;201;83;278;70;90;722
018314164707;1;282;191;231;78;59;841
095666119719;1;216;266;163;105;83;833
051813437292;1;281;167;216;58;83;805
023004402790;1;155;95;244;78;142;714
045974704296;1;258;221;122;55;118;774
051519191656;1;197;82;171;53;153;656
041767505605;1;199;172;104;78;172;725
019756149785;1;221;149;230;104;156;860
011744489589;1;292;268;90;108;94;852
094221414635;1;161;258;195;116;79;809
065488962726;1;127;167;213;83;152;742
053196135659;1;241;147;236;60;82;766
055874376087;1;268;243;235;85;125;956
037997052044;1;244;206;175;90;100;815
014965613138;1;215;137;290;59;175;876
075166033512;1;195;275;92;103;53;718
059580937523;1;270;154;213;84;101;822
049652356300;1;152;194;254;94;82;776
014956298244;1;240;123;263;72;50;748
062674883483;1;89;217;282;78;107;773
075661155649;1;211;149;173;76;118;727
079810224206;1;110;210;289;94;164;867
070074269211;1;260;81;270;118;174;903
088172184272;1;189;185;221;103;54;752
071338523126;1;262;282;147;73;111;875
045245472415;1;170;119;208;91;77;665
022314592106;1;160;159;245;101;85;750
086482252288;1;222;217;287;65;107;898
061523934852;1;288;142;137;51;176;794
064664585725;1;258;119;239;63;99;778
020176974489;1;291;246;248;110;90;985
075188140489;1;285;104;176;59;90;714
027854387740;1;206;250;164;73;119;812
025866784763;1;258;192;231;83;88;852
096727466057;1;192;133;174;52;128;679
021986342856;1;86;178;225;51;51;591
057875768584;1;226;117;108;51;77;579
039620067999;1;287;101;244;109;138;879
066341370363;1;198;233;279;115;56;881
045054100153;1;195;114;281;112;132;834
043127422689;1;285;272;153;96;140;946
046495535280;1;217;238;126;87;73;741
067934753063;1;114;207;192;90;73;676
022982578219;1;93;202;158;94;177;724
071495060674;1;171;80;163;76;61;551
053395482790;1;108;137;289;115;122;771
068673904631;1;288;120;248;96;107;859
045299689740;1;244;220;122;92;99;777
060675936918;1;163;269;224;73;165;894
024485017531;1;149;167;138;110;173;737
063694115525;1;117;109;221;54;143;644
009470415182;1;248;216;275;57;93;889
012583431736;1;106;88;183;71;55;503
059694614707;1;265;108;139;74;170;756
082912105919;1;269;86;291;89;85;820
005693188208;1;281;134;273;88;90;866
012016944224;1;220;162;247;64;147;840
061729062492;1;83;197;109;66;133;588
039796575618;1;209;161;105;96;123;694
096682774056;1;90;100;156;67;127;540
055213258809;1;170;283;273;76;135;937
029534700830;1;106;124;300;86;99;715
006372913750;1;168;214;278;57;165;882
005240855537;1;266;245;125;88;97;821
084994267945;1;199;223;179;61;126;788
052071264230;1;236;240;253;86;106;921
006073282223;1;139;190;131;90;102;652
095180222388;1;227;217;161;104;82;791
009047145261;1;226;171;107;95;155;754
070803105858;1;81;251;219;81;152;784
000996005809;1;84;217;150;112;95;658
008491085382;1;280;89;134;78;61;642
010488308572;1;167;233;172;89;114;775
076594546692;1;160;208;265;75;163;871
049996886281;1;239;172;190;96;110;807
093025883059;1;246;227;146;50;95;764
048068960224;1;102;214;117;66;103;602
054529000531;1;114;95;169;74;175;627
019004238466;1;97;106;275;72;153;703
097213843764;1;222;187;121;72;97;699
060744140352;1;81;106;291;61;86;625
093253988483;1;226;192;229;70;82;799
056819015819;1;212;247;235;94;158;946
028399774065;1;173;134;150;80;164;701
076075672496;1;119;248;92;116;148;723
008774052912;1;104;185;213;69;116;687
019917902061;1;194;140;107;59;85;585
016147122642;1;218;110;254;114;84;780
000339074016;1;184;147;122;86;87;626
037255513942;1;95;177;208;89;85;654
051455972276;1;286;265;238;65;129;983
083708546859;1;140;276;127;54;159;756
001213925372;1;276;160;230;68;79;813
020252387396;1;206;125;146;77;167;721
078633182328;1;88;193;150;69;159;659
001244886884;1;271;143;236;81;87;818
050035496365;1;281;271;272;60;80;964
045541764462;1;201;256;151;68;62;738
012475231628;1;255;120;209;113;64;761
074003977543;1;292;138;212;62;167;871
088786722692;1;199;96;266;120;149;830
086584249471;1;168;181;226;88;106;769
058415680988;1;105;245;144;79;145;718
069731599155;1;116;281;104;98;68;667
064371814576;1;132;288;194;99;142;855
096876483207;1;235;218;110;72;127;762
079334011253;1;273;193;193;117;135;911
057452685839;1;218;196;276;118;161;969
017786734554;1;159;122;119;83;82;565
077364109251;1;81;267;172;102;90;712
041716685634;1;190;245;197;63;152;847
030660892111;1;139;112;269;106;159;785
063781365584;1;178;114;138;70;152;652
041058424640;1;121;124;240;68;59;612
099070134940;1;292;184;156;61;164;857
024693075359;1;237;124;138;64;73;636
037865614970;1;253;97;171;86;137;744
031676335548;1;286;234;133;53;72;778
092465226676;1;87;88;248;102;144;669
075791143380;1;166;150;190;120;59;685
092755338697;1;80;285;205;75;158;803
016124776764;1;235;111;185;89;80;700
068996775959;1;282;190;300;94;59;925
002830689544;1;192;247;237;96;155;927
050458619620;1;142;222;113;86;133;696
072491452942;1;227;131;122;106;174;760
061079041513;1;262;180;249;59;57;807
072177169099;1;199;286;241;87;69;882
095258036739;1;125;152;97;105;107;586
018175462318;1;228;257;175;105;138;903
086721880332;1;276;248;149;87;178;938
091355412021;1;116;240;220;84;50;710
047665627095;1;82;155;199;104;148;688
024911544561;1;142;140;201;51;146;680
009417776478;1;197;280;179;111;63;830
008061710204;1;247;235;210;102;55;849
072869788009;1;103;103;129;77;176;588
079769661177;1;147;100;160;95;124;626
096528533146;1;222;263;192;74;98;849
025318497585;1;265;145;280;76;59;825
089092066588;1;116;106;262;79;92;655
079984740892;1;167;243;98;111;159;778
022626831721;1;253;255;277;95;83;963
059615246448;1;199;215;139;84;70;707
044382886673;1;273;252;257;100;74;956
014108865938;1;123;136;139;102;54;554
048245463316;1;83;253;294;54;147;831
092850655690;1;165;181;204;73;164;787
004635273361;1;166;126;207;57;126;682
034036732116;1;202;189;100;52;136;679
083477647113;1;238;136;247;89;151;861
095113829046;1;166;84;248;92;95;685
075916477114;1;224;211;205;69;71;780
032893675145;1;173;257;157;56;126;769
074012070212;1;144;196;288;58;166;852
059140847909;1;150;245;213;95;108;811
059408499341;1;206;109;291;96;72;774
068967723820;1;273;204;247;97;101;922
007714032347;1;190;275;202;66;85;818
028184184492;1;113;238;115;64;70;600
010908667978;1;285;267;176;85;93;906
088882454037;1;228;133;103;90;98;652
077353038139;1;213;187;270;58;81;809
056310712218;1;218;163;275;74;68;798
085281071002;1;248;270;93;120;51;782
090477337541;1;259;278;276;117;133;1063
014897386066;1;169;200;99;109;118;695
087791526095;1;86;257;174;108;54;679
074547942433;1;107;89;134;67;101;498
086459209899;1;136;158;192;98;125;709
097536008682;1;278;234;213;109;154;988
049618576498;1;291;217;161;77;135;881
087953385311;1;100;170;206;100;106;682
001065896490;1;193;188;270;104;79;834
028137331248;1;152;196;103;92;134;677
076920129545;1;90;83;208;107;51;539
051481093466;1;255;254;154;66;159;888
060182519529;1;221;248;149;63;104;785
007808339906;1;244;80;163;119;147;753
047510354537;1;122;114;245;53;75;609
099699270160;1;237;236;266;91;72;902
035129502587;1;155;112;212;62;115;656
059781425761;1;268;237;277;82;91;955
070806246526;1;123;140;205;72;73;613
050861721491;1;203;165;167;112;172;819
064002971816;1;91;282;293;62;100;828
023482639052;1;275;154;102;62;144;737
042346482081;1;152;188;275;111;171;897
076659463022;1;200;189;258;110;152;909
073241572613;1;98;190;250;81;132;751
088231342242;1;238;247;245;69;57;856
018207498341;1;111;88;275;57;109;640
010488453309;1;271;259;251;63;65;909
060902025672;1;164;131;95;86;177;653
005741934494;1;95;230;134;67;112;638
075510868869;1;171;146;126;110;174;727
021210199502;1;261;155;269;101;178;964
085284071766;1;191;135;269;72;77;744
032729488987;1;266;177;144;63;98;748
095148218531;1;164;256;181;111;176;888
066828762357;1;259;283;214;83;71;910
036839642638;1;291;190;173;107;97;858
081162919870;1;267;175;94;99;84;719
004282526430;1;112;98;233;100;130;673
015887899298;1;81;153;254;91;113;692
000329040930;1;131;142;93;119;95;580
011414584447;1;101;92;165;108;108;574
030276813520;1;137;156;108;84;123;608
099170204921;1;95;157;144;65;169;630
081766410627;1;205;95;142;84;173;699
066651437439;1;201;168;121;117;166;773
096864799945;1;286;105;298;77;91;857
054661475935;1;235;92;167;65;84;643
005842141538;1;227;223;207;106;114;877
091830262874;1;278;217;193;80;143;911
079869004093;1;92;138;246;97;156;729
097105857778;1;136;212;224;119;86;777
074525613067;1;218;85;174;120;115;712
064661444879;1;271;258;155;56;177;917
086053587617;1;204;86;102;70;106;568
003622163287;1;282;284;284;118;92;1060
078537226511;1;82;152;271;61;105;671
050172550433;1;165;174;202;84;135;760
078686831940;1;122;156;266;94;126;764
095472086109;1;147;244;139;102;59;691
033594254079;1;246;206;269;83;158;962
063032015441;1;91;161;109;112;84;557
074676110638;1;176;235;194;101;82;788
067017114347;1;113;264;102;102;84;665
086656867320;1;179;189;209;115;61;753
043112739607;1;228;150;246;101;139;864
028348918987;1;222;140;122;95;144;723
039478615969;1;97;255;138;65;76;631
078055969090;1;250;221;167;104;177;919
036015228535;1;110;255;100;110;171;746
021034796118;1;187;106;134;86;87;600
075022464473;1;211;89;174;67;140;681
086560417256;1;190;184;273;92;70;809
004955271306;1;252;217;162;58;68;757
009149442679;1;158;154;292;70;141;815
028955730279;1;192;170;147;75;121;705
063894415301;1;197;206;95;107;117;722
032405396891;1;103;129;226;98;60;616
052854533430;1;139;144;169;120;74;646
083651042726;1;193;228;256;63;174;914
058316909953;1;206;127;186;93;156;768
069456008653;1;194;220;114;81;135;744
096426018034;1;149;186;188;120;71;714
085182411844;1;246;104;177;120;106;753
029235053319;1;112;249;263;59;173;856
000302055704;1;187;264;104;87;118;760
038164330500;1;181;219;234;105;104;843
083445979991;1;253;275;282;72;62;944
025110423440;1;119;150;225;68;102;664
036286549729;1;283;221;226;84;125;939
014198777887;1;280;98;140;59;160;737
019078342455;1;137;269;137;50;87;680
037570417701;1;256;160;178;68;66;728
065426361297;1;140;104;188;76;64;572
038690692482;1;246;167;118;52;130;713
048577029538;1;121;171;265;51;114;722
057171527188;1;104;268;109;84;126;691
042510070409;1;144;111;163;93;108;619
090514838934;1;187;203;240;83;144;857
043187859608;1;177;218;199;116;158;868
040436894850;1;158;166;126;87;99;636
053969239234;1;112;153;166;57;81;569
009735363768;1;264;114;234;61;55;728
060156124910;1;263;129;153;118;82;745
084910996339;1;80;144;124;75;172;595
066420622101;1;258;119;168;94;165;804
084152368203;1;245;131;237;85;92;790
094760404837;1;135;273;122;108;176;814
031524756457;1;273;141;296;52;112;874
009831883934;1;250;103;166;78;57;654
061758414219;1;251;221;236;82;79;869
094649184427;1;225;91;152;70;160;698
093295641651;1;135;198;97;50;171;651
009204477986;1;224;198;142;60;79;703
039149486301;1;261;186;293;89;75;904
032298208244;1;113;201;111;62;76;563
046541387595;1;123;274;291;53;86;827
051442229397;1;200;164;279;61;53;757
030370170288;1;201;261;113;101;153;829
096540408031;1;241;252;120;88;63;764
019222568292;1;151;218;278;84;168;899
098293917851;1;83;230;238;82;163;796
008157427927;1;265;273;159;92;148;937
070962745852;1;267;201;132;114;84;798
072685303041;1;140;217;190;89;138;774
094428243031;1;217;255;214;56;171;913
020872633300;1;230;206;112;76;141;765
079840682097;1;95;178;286;60;101;720
054709101263;1;276;169;215;107;68;835
081105282780;1;279;128;293;95;58;853
095490749510;1;206;271;248;59;149;933
095290223905;1;132;225;140;94;53;644
063469803406;1;123;187;210;100;136;756
092316680405;1;266;217;138;98;103;822
051648747194;1;177;144;164;84;65;634
024132919574;1;256;279;159;118;115;927
090667878862;1;80;207;250;107;111;755
005614043552;1;264;209;244;68;89;874
084222501215;1;232;179;285;116;86;898
074972532215;1;100;186;255;65;71;677
054083761233;1;181;191;141;64;85;662
094782320217;1;217;228;297;107;120;969
018383923666;1;85;123;279;60;92;639
014692635237;1;178;140;211;89;165;783
051583386950;1;84;184;160;107;146;681
017522267790;1;249;266;110;75;171;871
027013054547;1;103;208;120;118;150;699
090747384382;1;151;121;154;51;112;589
046484479393;1;129;187;193;95;151;755
074585808052;1;245;105;100;84;132;666
011029826774;1;106;151;130;100;160;647
026769841025;1;274;171;154;73;135;807
095969007092;1;287;284;259;109;158;1097
030756724168;1;155;134;268;56;148;761
093412157798;1;287;238;242;72;55;894
044465221660;1;148;278;253;78;93;850
075031930210;1;209;96;136;95;135;671
061525840801;1;255;183;120;78;137;773
061859068207;1;146;109;289;116;80;740
086333977936;1;190;104;203;61;130;688
015319515107;1;142;187;99;69;130;627
026509287107;1;185;251;209;58;164;867
034290930773;1;183;183;203;64;54;687
061784270466;1;252;86;210;102;54;704
085321529215;1;207;270;94;65;66;702
071229365757;1;121;146;124;74;125;590
071872168103;1;214;181;207;105;111;818
093077330277;1;172;235;180;54;139;780
012523130445;1;140;216;277;105;151;889
063384370652;1;94;159;295;67;169;784
017318282064;1;107;239;248;103;57;754
000367849818;1;82;163;109;106;165;625
065521671487;1;279;240;168;68;178;933
069688642913;1;175;207;261;72;128;843
054309124952;1;207;184;242;71;61;765
055601677928;1;291;251;300;56;118;1016
058580520844;1;110;267;99;50;100;626
033907943310;1;223;212;212;61;69;777
086448017687;1;251;211;111;94;122;789
082782072891;1;187;273;209;50;61;780
075245713781;1;116;187;258;115;81;757
038990789672;1;182;167;116;66;126;657
088862530046;1;92;218;119;56;112;597
034393767430;1;122;237;154;84;108;705
041820110636;1;193;216;260;54;115;838
004508457725;1;93;175;140;68;167;643
087759430530;1;225;126;192;73;139;755
091541756380;1;178;160;244;64;147;793
013233656139;1;202;189;255;82;164;892
050806569691;1;156;203;107;99;118;683
000335287593;1;148;80;214;90;122;654
061977016239;1;185;257;272;95;88;897
055798513162;1;99;149;120;117;59;544
002938787807;1;281;195;92;113;168;849
024307846749;1;271;163;244;84;55;817
062034447621;1;111;283;272;114;84;864
044874931244;1;117;132;167;96;57;569
099920174283;1;139;120;203;120;144;726
040364725440;1;264;260;215;86;110;935
088618963571;1;135;203;203;78;175;794
091950903209;1;284;214;278;87;176;1039
003830549961;1;250;114;108;119;140;731
045100604044;1;289;242;226;61;101;919
056509242605;1;91;139;139;97;175;641
022476603941;1;203;124;207;106;79;719
035687974582;1;213;267;225;96;107;908
062105653834;1;234;163;263;67;148;875
093388458418;1;194;183;194;94;104;769
092049802915;1;102;241;198;78;75;694
058131396194;1;111;263;189;59;176;798
070160640707;1;110;93;160;59;149;571
043088096782;1;166;239;278;75;76;834
070510540752;1;164;195;153;55;69;636
073822406036;1;271;158;181;55;177;842
036467351932;1;166;194;114;100;91;665
044864094498;1;98;147;104;77;107;533
040890295394;1;246;120;141;85;60;652
052929682096;1;136;82;250;76;136;680
009316761391;1;126;279;93;102;148;748
026512725955;1;127;102;120;100;51;500
027082870771;1;232;226;276;55;100;889
029592847983;1;275;82;231;62;153;803
047600229083;1;208;270;122;50;105;755
096771547446;1;104;200;153;77;107;641
073826363257;1;199;116;244;69;78;706
062465680265;1;134;137;207;95;129;702
090539562041;1;202;97;182;58;72;611
048972693245;1;122;211;261;56;68;718
037780560143;1;89;162;157;70;55;533
097879093756;1;201;114;158;109;76;658
059990421524;1;119;246;173;74;104;716
065535490901;1;140;94;294;84;145;757
072334559184;1;238;226;285;95;101;945
071729236438;1;100;130;184;89;151;654
035235572345;1;148;285;222;69;71;795
002508022071;1;105;241;292;56;94;788
021555776505;1;125;96;109;71;76;477
016173076942;1;98;107;112;81;161;559
072865499047;1;164;286;259;118;119;946
091232284233;1;100;197;220;59;118;694
088718167575;1;267;80;179;89;158;773
015499388673;1;158;224;137;110;57;686
002716056309;1;220;285;171;62;118;856
010870749805;1;248;185;297;64;160;954
060292238784;1;116;244;120;70;157;707
054935598093;1;213;186;158;57;151;765
041791064627;1;108;130;204;57;178;677
011241342918;1;262;143;200;57;124;786
088702678364;1;223;134;271;53;168;849
004405783134;1;233;249;224;113;125;944
076678604910;1;96;85;106;53;132;472
034087153093;1;113;107;215;75;113;623
022366690568;1;247;89;224;60;104;724
064636106873;1;238;140;151;99;100;728
022502001275;1;206;239;266;106;130;947
093264152855;1;191;278;103;64;155;791
027297602780;1;280;181;219;90;128;898
066384902700;1;162;137;266;76;69;710
047084827435;1;137;169;106;81;165;658
046762322363;1;136;237;102;113;51;639
030980658835;1;279;102;213;101;62;757
073227408219;1;253;113;149;106;102;723
039431738901;1;187;274;256;101;178;996
077432444654;1;104;216;206;93;161;780
045033472395;1;248;222;165;87;70;792
002823174194;1;80;189;100;68;110;547
033348645537;1;215;82;102;69;175;643
083237814807;1;88;200;209;100;142;739
015986907930;1;202;93;214;50;151;710
008309300546;1;99;138;245;50;92;624
014164035416;1;96;267;138;114;108;723
057453895256;1;109;131;285;61;85;671
030113151263;1;222;187;259;74;129;871
095007494803;1;170;140;195;107;153;765
087291031109;1;89;172;121;61;154;597
015740683698;1;176;284;113;57;109;739
054251783873;1;195;200;279;117;171;962
009424785736;1;109;226;266;76;165;842
093689296965;1;202;166;136;84;178;766
024927902381;1;204;260;267;101;134;966
026237752118;1;210;114;161;56;52;593
094377776026;1;126;158;272;77;101;734
031369602997;1;148;288;92;51;64;643
039371242441;1;284;230;110;118;173;915
009708290341;1;86;131;290;67;176;750
075835939592;1;168;206;228;54;105;761
082748211041;1;165;287;96;58;59;665
055228645295;1;221;244;166;113;83;827
078836300040;1;224;269;120;117;100;830
005198460674;1;174;102;170;107;111;664
065796273757;1;98;143;226;96;136;699
075435168914;1;135;242;167;54;69;667
021499673916;1;123;264;125;97;125;734
042322193345;1;217;146;291;61;146;861
088138734443;1;97;254;300;63;175;889
040785703719;1;184;190;245;119;73;811
046402892599;1;91;277;274;91;77;810
033830653410;1;209;263;176;71;174;893
045590275807;1;269;88;189;100;95;741
021669196783;1;278;98;269;94;108;847
011463754768;1;270;97;134;78;152;731
036562051352;1;91;283;138;76;126;714
077789184225;1;119;94;221;53;115;602
092407388100;1;281;149;110;98;60;698
065347699353;1;231;104;269;116;79;799
087234898431;1;135;98;230;84;135;682
075289103736;1;170;223;115;73;120;701
004062468341;1;196;81;165;117;67;626
067629807043;1;190;229;235;105;120;879
083955957518;1;237;201;129;113;137;817
028904177587;1;155;148;200;89;146;738
057818705438;1;97;218;253;100;70;738
000593504982;1;219;145;218;119;112;813
048297283141;1;188;180;187;85;132;772
091280560919;1;111;229;101;59;101;601
095711478577;1;278;146;202;69;134;829
083147124189;1;246;209;91;59;56;661
008657192182;1;168;205;244;88;56;761
081898825552;1;285;138;124;103;139;789
048823954986;1;121;201;292;76;90;780
096275256676;1;255;166;186;50;146;803
034919958865;1;233;110;115;104;113;675
079994340321;1;98;141;125;96;119;579
071005492814;1;88;104;126;87;112;517
017915876602;1;207;195;259;115;114;890
092784897958;1;124;248;95;94;148;709
096461390780;1;133;88;175;76;166;638
034937081210;1;290;188;133;105;99;815
037042993190;1;113;87;110;79;112;501
080751474676;1;174;181;284;55;154;848
025497797264;1;115;88;112;118;90;523
020136237222;1;161;177;171;64;140;713
051925122527;1;119;222;99;55;52;547
097539565175;1;200;189;299;118;96;902
055993419783;1;201;217;219;74;162;873
042712740618;1;204;274;180;116;66;840
088046154747;1;119;91;222;80;99;611
040410297511;1;210;219;92;68;58;647
038757322407;1;230;256;204;76;146;912
073631215153;1;141;271;132;106;107;757
018560463096;1;165;236;165;115;80;761
029269634006;1;217;122;109;60;65;573
047156700153;1;282;175;239;85;152;933
072860417210;1;88;188;295;105;64;740
039697316700;1;290;152;228;83;109;862
017540169214;1;135;91;279;85;142;732
047337173181;1;186;221;148;59;104;718
006473507770;1;100;147;161;69;141;618
011686040956;1;136;193;148;74;129;680
048800314583;1;289;148;299;110;127;973
053412694691;1;163;136;188;89;70;646
064478105447;1;268;262;272;111;111;1024
003476818722;1;171;125;232;76;162;766
026584900122;1;270;275;149;56;165;915
066702285167;1;145;113;294;96;172;820
072254872927;1;107;250;165;96;63;681
077645760165;1;167;147;181;73;148;716
065719689043;1;148;236;177;113;59;733
007018939778;1;159;211;163;50;75;658
002670143345;1;150;230;186;70;51;687
058095742533;1;194;156;167;70;82;669
063463587172;1;203;279;153;57;163;855
000404055642;1;161;93;183;70;126;633
066697846396;1;189;158;271;53;110;781
084488979045;1;172;95;263;73;72;675
077502141761;1;290;191;182;73;65;801
061690663469;1;185;170;196;64;98;713
027661341521;1;180;221;91;118;170;780
006445411717;1;180;108;251;88;65;692
098372232241;1;142;139;207;108;98;694
036916133649;1;84;281;127;57;175;724
072378075348;1;166;175;153;100;168;762
092878472035;1;153;243;259;59;61;775
087484698971;1;86;83;148;99;115;531
046283088213;1;260;287;184;72;136;939
000556638833;1;99;153;111;67;170;600
057355526726;1;169;172;236;94;73;744
093197129184;1;174;245;131;111;111;772
059884137865;1;263;200;178;69;111;821
033503823266;1;149;278;242;62;174;905
047633127998;1;256;114;281;98;89;838
036022079485;1;118;138;274;111;124;765
033984245482;1;103;278;211;57;94;743
048112019356;1;178;162;153;56;91;640
083871289853;1;98;164;264;61;58;645
098498857876;1;143;234;198;70;153;798
039597202792;1;155;269;128;65;115;732
094584613295;1;98;152;221;60;79;610
086883427762;1;163;189;252;98;96;798
093368122486;1;87;102;242;50;134;615
086713607371;1;291;152;140;73;89;745
084159974073;1;211;200;262;75;135;883
055852213627;1;256;272;190;64;52;834
061540534827;1;234;185;171;99;165;854
087894278832;1;111;281;150;50;75;667
086818017792;1;216;92;179;87;71;645
005053999783;1;187;169;137;99;91;683
044442118581;1;81;252;298;81;88;800
089275021514;1;149;111;202;100;55;617
027325393827;1;112;140;149;105;119;625
072422785277;1;186;151;240;95;74;746
013135196954;1;215;219;256;113;129;932
034527243857;1;212;133;235;60;162;802
055305354656;1;283;84;251;73;72;763
072445625904;1;275;197;102;82;78;734
009291331215;1;116;176;167;84;144;687
094403176461;1;205;97;205;54;167;728
068110262809;1;277;140;257;70;73;817
075895957766;1;107;121;297;114;121;760
006431210548;1;193;269;300;87;145;994
099506424947;1;80;215;159;97;92;643
036382053027;1;200;287;248;99;51;885
030890667496;1;82;203;179;62;102;628
040979689875;1;94;103;115;89;76;477
090752792638;1;80;127;293;102;90;692
074001644555;1;156;84;129;81;151;601
024339508712;1;282;129;126;78;68;683
093365225342;1;259;122;133;71;171;756
068675663290;1;252;222;140;53;175;842
016405521518;1;129;89;127;108;91;544
029386067929;1;276;94;234;56;53;713
040675265277;1;285;102;140;81;62;670
036433890823;1;182;147;141;81;101;652
039722990435;1;214;265;270;58;104;911
008912441798;1;140;167;177;51;80;615
084205433115;1;122;128;90;75;141;556
095614901498;1;89;267;293;87;52;788
092561764891;1;212;205;151;120;97;785
010679303574;1;187;194;125;102;98;706
004677750761;1;270;192;124;117;53;756
093243511710;1;128;156;108;92;156;640
012706201722;1;278;268;256;110;67;979
060000017305;1;291;189;220;68;71;839
025828997038;1;166;218;110;57;164;715
089937757647;1;283;95;137;108;50;673
045227880025;1;265;262;149;109;87;872
036358684484;1;266;133;280;104;137;920
098717363067;1;190;103;245;85;67;690
003244641542;1;281;245;286;54;89;955
085245902505;1;287;288;156;57;175;963
080591282423;1;160;113;287;114;176;850
013424034129;1;135;210;267;73;121;806
020990865291;1;284;278;139;112;89;902
071137346014;1;175;111;133;115;118;652
085630201707;1;163;118;290;111;170;852
052806311711;1;263;229;186;85;127;890
001109048740;1;223;241;155;79;91;789
009665827531;1;283;111;172;63;111;740
009195858626;1;252;159;127;74;171;783
023601113522;1;207;226;244;52;56;785
059465569674;1;109;185;158;73;102;627
015327661352;1;269;239;228;111;95;942
068762199236;1;288;263;125;119;116;911
065623052755;1;138;148;272;91;141;790
037023820571;1;81;108;110;77;132;508
090852199886;1;266;139;220;72;132;829
099178978253;1;203;254;163;57;130;807
064146767240;1;162;82;116;81;73;514
064785430369;1;272;208;197;61;68;806
006501759479;1;107;215;121;94;139;676
003422239059;1;265;244;202;114;81;906
079682938353;1;132;187;285;65;50;719
038740876335;1;239;284;286;59;169;1037
015113784141;1;159;249;260;67;149;884
045503213587;1;256;96;170;58;126;706
093883906859;1;220;253;251;50;160;934
092979835829;1;163;177;135;89;84;648
089565561311;1;159;85;222;78;174;718
043255212590;1;137;99;260;68;107;671
052117730675;1;255;84;92;103;158;692
043689280003;1;238;198;111;106;148;801
030311546197;1;169;188;216;108;129;810
071343555470;1;276;132;263;103;120;894
063601884995;1;93;219;270;73;93;748
046717425582;1;126;129;180;98;56;589
035513107475;1;110;137;263;89;94;693
099866779080;1;80;229;216;120;69;714
026122972099;1;277;286;130;114;97;904
046360907164;1;198;118;283;66;121;786
078439089975;1;190;114;260;104;83;751
048846744685;1;280;284;285;56;62;967
082934609416;1;132;196;235;57;109;729
043291558715;1;147;125;263;65;113;713
000395085697;1;159;118;194;107;91;669
099723827388;1;280;249;177;56;153;915
008651185233;1;128;129;139;75;126;597
084784550259;1;193;240;158;51;82;724
029987485571;1;111;283;274;50;97;815
023125885994;1;193;242;123;110;177;845
018916249264;1;86;188;223;98;52;647
038331103643;1;107;132;228;105;145;717
064083944173;1;209;217;91;63;88;668
043545154373;1;128;96;257;71;113;665
059933248431;1;245;211;151;110;80;797
015615888039;1;195;261;168;58;93;775
025419503584;1;161;168;300;63;56;748
040965176288;1;102;285;107;79;96;669
011615387487;1;150;80;107;84;118;539
098460424591;1;82;223;247;67;176;795
030854140389;1;183;159;164;53;165;724
021658234089;1;116;107;196;107;55;581
048140891886;1;112;168;126;89;170;665
068097413229;1;148;140;92;65;125;570
037273714808;1;172;85;206;82;86;631
028945603693;1;82;268;298;106;166;920
039305605613;1;87;206;215;115;139;762
035117259462;1;262;115;233;95;104;809
007066795084;1;158;156;191;109;160;774
052196473088;1;154;239;174;98;98;763
099186733307;1;252;189;125;109;105;780
023673411930;1;285;173;194;96;156;904
081074264983;1;241;178;124;103;63;709
039085843151;1;159;282;230;88;108;867
062754773743;1;242;94;241;59;123;759
056388447493;1;126;232;234;81;127;800
052816808505;1;251;117;280;60;80;788
007167041220;1;110;283;207;99;115;814
047395650465;1;259;84;150;87;159;739
083331386306;1;90;256;208;118;98;770
043972762625;1;184;251;206;73;76;790
076408656940;1;161;204;298;100;123;886
086682369331;1;262;93;144;69;62;630
006804780480;1;100;178;234;65;136;713
086602258204;1;220;117;115;94;132;678
014558789237;1;204;225;239;115;170;953
071448457513;1;203;128;269;97;130;827
064945433222;1;123;86;174;69;72;524
057995481756;1;206;257;253;67;125;908
026906865642;1;159;221;139;97;151;767
041904589667;1;102;228;168;54;125;677
055734173871;1;114;91;253;100;109;667
029601236549;1;208;128;196;76;67;675
082735520965;1;290;213;149;76;157;885
079443876727;1;282;182;181;105;67;817
028279667389;1;84;166;110;113;175;648
051327426085;1;243;237;300;55;164;999
046097445074;1;147;245;274;117;150;933
066040870328;1;132;198;232;105;171;838
023721724777;1;194;215;219;67;105;800
012385621477;1;273;237;201;104;103;918
074056013334;1;248;186;96;115;176;821
035376640966;1;164;226;233;59;134;816
016350789847;1;253;206;119;114;68;760
028288768848;1;170;273;127;63;154;787
073843571691;1;275;150;249;52;119;845
080722941672;1;275;108;233;105;133;854
028365847453;1;230;206;248;76;149;909
098562207823;1;105;137;222;50;119;633
008906539635;1;158;192;129;84;142;705
045250129278;1;267;129;174;114;84;768
013389636664;1;152;100;168;51;58;529
021684644880;1;102;131;254;89;141;717
051950821341;1;260;186;95;79;113;733
095935058716;1;117;210;95;55;68;545
089613370967;1;192;84;112;85;133;606
018764079958;1;281;84;161;57;88;671
064436686007;1;108;268;107;110;115;708
048450967767;1;197;284;228;88;129;926
072955177330;1;129;207;214;69;150;769
099233121009;1;85;124;280;61;166;716
002693092981;1;203;247;274;106;105;935
018862802937;1;278;277;114;70;173;912
040753944916;1;259;92;267;52;128;798
088322428209;1;176;214;288;103;121;902
069878959521;1;113;224;283;86;137;843
057776947477;1;268;274;261;101;178;1082
020267821415;1;243;283;195;108;93;922
008313182465;1;275;230;292;66;151;1014
028635170633;1;265;150;151;88;93;747
031311513285;1;156;244;228;103;146;877
012464057236;1;119;153;123;65;84;544
089017589778;1;235;100;235;64;55;689
073004355265;1;177;262;236;106;177;958
042152068040;1;234;131;257;76;113;811
067266362154;1;136;204;129;58;129;656
014846670679;1;287;237;190;103;106;923
028803523741;1;246;232;188;81;75;822
039755634042;1;260;225;130;66;113;794
052280665888;1;156;274;127;101;116;774
099081658716;1;231;114;239;60;128;772
061148136399;1;193;254;139;113;73;772
004651431643;1;113;124;230;88;96;651
088901851116;1;162;210;105;116;145;738
053950047479;1;272;130;149;86;61;698
001894053347;1;286;144;132;117;163;842
065783929662;1;171;91;244;100;123;729
071632531326;1;213;275;120;94;170;872
062897023512;1;275;147;183;60;133;798
071829799901;1;138;286;209;89;59;781
047150027600;1;141;257;122;102;177;799
010680030826;1;165;141;177;97;141;721
006511582132;1;193;112;297;105;97;804
089750655830;1;222;243;120;61;115;761
056205544942;1;215;95;236;78;86;710
008197382546;1;133;132;118;120;118;621
040992697843;1;133;248;117;67;165;730
016633753499;1;253;203;218;75;158;907
055632891639;1;107;254;124;100;50;635
017950935676;1;264;97;215;74;57;707
077467985924;1;289;218;295;88;116;1006
012668136810;1;291;272;208;66;139;976
062858061282;1;85;203;239;85;99;711
008648893939;1;208;124;233;86;168;819
017554353566;1;174;273;290;105;131;973
023618927933;1;228;195;186;86;165;860
063601590518;1;138;248;242;95;71;794
018941877545;1;168;235;280;69;67;819
001258511537;1;140;150;204;114;152;760
079957037636;1;206;228;202;61;59;756
045001058572;1;188;197;217;106;155;863
012847190911;1;142;121;109;57;162;591
046542382564;1;146;201;205;68;75;695
081183863673;1;201;206;189;72;127;795
063379942733;1;243;88;212;50;147;740
053768652635;1;112;207;251;120;111;801
077546950383;1;83;138;195;99;136;651
082285834644;1;257;277;216;58;120;928
098337817006;1;236;232;226;99;134;927
070397114880;1;205;244;105;86;117;757
027939835756;1;160;133;140;73;119;625
069284828014;1;245;150;205;86;72;758
012848748763;1;112;94;281;51;146;684
039031870415;1;192;110;247;86;90;725
065942882811;1;117;181;117;81;67;563
054488430512;1;151;126;247;58;82;664
068744816388;1;98;81;257;77;151;664
045123871065;1;142;107;135;120;140;644
095763493541;1;165;127;104;96;106;598
034485798375;1;113;154;174;87;103;631
066240086461;1;232;228;250;89;64;863
081511689392;1;208;286;223;75;118;910
070904831018;1;251;254;216;76;128;925
079477600856;1;199;160;131;59;72;621
068375734657;1;160;197;288;98;67;810
012347036414;1;159;106;260;100;105;730
095842491523;1;84;111;148;93;178;614
001728222114;1;257;208;221;67;77;830
050106000364;1;115;175;161;105;112;668
076808996286;1;286;193;168;83;133;863
091663999880;1;166;210;200;84;64;724
088272411529;1;80;159;114;88;147;588
084705316176;1;141;162;164;71;54;592
089170017371;1;199;115;273;90;166;843
040678173751;1;192;149;225;95;66;727
050834086008;1;117;93;249;114;77;650
095263127090;1;90;280;196;62;52;680
058734160116;1;116;278;243;50;76;763
029240486344;1;95;265;279;59;115;813
024847280984;1;256;230;205;69;59;819
007626768512;1;100;90;187;96;143;616
027241714351;1;198;247;116;82;171;814
022548906796;1;83;275;251;119;113;841
045997526192;1;281;110;112;73;150;726
062815215633;1;107;141;239;113;91;691
089861821447;1;179;129;198;98;157;761
049922118535;1;111;179;96;84;69;539
060776330914;1;86;276;109;93;131;695
087595481238;1;185;265;135;90;156;831
070099967633;1;144;147;194;68;54;607
081643010231;1;138;283;152;108;167;848
058339489162;1;213;270;187;52;112;834
023104655805;1;114;168;188;89;66;625
020731513897;1;173;102;236;58;150;719
060196212706;1;258;84;281;99;52;774
049471148828;1;217;87;299;50;56;709
044252932313;1;284;135;195;54;57;725
066794830514;1;109;224;190;53;111;687
022760927444;1;211;151;116;89;82;649
046137828973;1;190;164;250;71;96;771
098856136541;1;254;273;165;72;152;916
073689843904;1;171;124;206;69;99;669
064570868292;1;220;181;299;83;153;936
015068387283;1;238;192;187;107;136;860
077962340960;1;81;228;172;117;116;714
033596058230;1;136;207;145;72;68;628
081864575252;1;210;260;180;51;159;860
055754752095;1;111;85;270;115;148;729
078477558740;1;115;249;283;60;52;759
060977496604;1;224;202;186;84;160;856
039200533325;1;156;260;176;92;150;834
000641882299;1;234;268;291;98;150;1041
064449596977;1;135;288;168;100;156;847
019826217078;1;82;193;224;104;50;653
043933500474;1;227;275;209;66;178;955
069367937720;1;188;208;170;82;146;794
042577607798;1;277;141;299;65;133;915
055822862348;1;110;237;264;79;161;851
077385943087;1;194;200;113;75;110;692
078435231431;1;202;81;147;80;105;615
084057608341;1;285;115;262;80;175;917
084884132793;1;155;151;221;93;53;673
036448374730;1;202;150;143;119;67;681
007822673294;1;83;91;151;91;60;476
094728776255;1;250;249;293;117;113;1022
043441493456;1;199;279;143;90;164;875
035933244286;1;154;270;155;51;124;754
057823299346;1;255;147;209;106;105;822
040234360252;1;95;144;92;89;98;518
067382089484;1;224;193;244;85;87;833
082937184205;1;221;163;191;115;174;864
053066497596;1;264;259;174;114;57;868
052134566297;1;137;87;204;106;142;676
003794807576;1;275;80;173;105;112;745
065448503177;1;80;245;201;55;92;673
057361481071;1;119;103;113;80;102;517
093807407432;1;122;157;252;73;106;710
085093159100;1;149;100;162;81;86;578
074009239110;1;124;225;292;109;57;807
048845072884;1;163;125;215;60;62;625
070286300008;1;129;101;130;88;153;601
087242159915;1;149;141;248;85;57;680
098376654713;1;228;279;229;93;163;992
008031979668;1;120;194;282;117;71;784
050015688427;1;174;196;97;52;151;670
037197631145;1;90;138;225;118;70;641
023674691053;1;90;149;261;75;111;686
034815242653;1;87;173;260;64;131;715
077458919743;1;168;159;267;60;125;779
093134472870;1;149;283;221;102;65;820
084542626630;1;197;196;158;111;120;782
049586107077;1;84;171;234;68;172;729
019599917972;1;137;161;186;54;172;710
055804628289;1;256;219;119;73;139;806
015523320046;1;231;211;132;77;139;790
051446187514;1;225;189;125;60;174;773
097827215737;1;165;194;290;90;134;873
002093586855;1;217;103;214;113;98;745
070683777512;1;85;246;274;60;137;802
085408587605;1;96;231;158;101;159;745
098184531257;1;89;141;110;119;157;616
073555487577;1;107;221;154;117;166;765
036173320335;1;218;273;148;58;159;856
090890561838;1;165;221;224;76;169;855
067540550529;1;172;174;216;103;123;788
018201690992;1;113;82;260;71;153;679
060059436654;1;241;263;184;70;73;831
065743246600;1;257;254;172;80;88;851
071303765908;1;223;245;299;70;153;990
087183330777;1;250;184;255;59;118;866
084689307131;1;273;90;232;53;79;727
078480583642;1;173;125;232;113;165;808
060525739024;1;114;101;140;99;156;610
083626081463;1;85;99;187;53;65;489
052402511864;1;292;84;191;96;99;762
022198489541;1;284;172;156;71;165;848
047451181308;1;220;258;121;112;130;841
085660426916;1;281;193;298;67;100;939
086016860296;1;208;212;119;87;146;772
025186629076;1;93;227;250;94;88;752
059942154404;1;102;274;224;68;129;797
033553348563;1;118;87;170;97;83;555
011272737067;1;250;135;154;102;51;692
070557162862;1;106;273;210;53;68;710
099240275136;1;153;206;143;55;82;639
041155996472;1;277;114;156;56;57;660
045243661782;1;179;106;169;51;151;656
059227179222;1;189;102;237;89;112;729
096673059227;1;221;104;185;110;62;682
046906325780;1;125;280;154;81;136;776
063674101904;1;143;149;106;81;79;558
095491912220;1;93;202;145;66;55;561
098153597503;1;165;273;113;101;147;799
046993520830;1;97;102;228;55;117;599
034112737189;1;132;176;166;97;50;621
017703318144;1;254;238;237;118;118;965
095872331275;1;169;197;278;109;57;810
086108006236;1;213;173;98;107;116;707
034705507497;1;286;180;251;97;116;930
066768142236;1;246;146;247;75;75;789
021062605754;1;173;123;256;88;103;743
085698404142;1;235;146;236;98;69;784
081798667574;1;268;275;190;50;60;843
012063555683;1;292;245;226;87;176;1026
054725073688;1;224;191;274;72;169;930
051842985579;1;252;218;106;93;84;753
094926027231;1;277;286;204;104;89;960
072673785708;1;253;177;145;65;79;719
020174359295;1;286;263;119;97;92;857
024660994183;1;96;172;217;67;50;602
019446441080;1;85;81;250;67;101;584
012360071839;1;213;252;215;69;61;810
076652884646;1;193;126;196;78;69;662
079876973966;1;191;82;117;79;172;641
027571555529;1;280;170;231;60;74;815
085870982307;1;115;250;198;86;96;745
021089827988;1;259;137;228;98;75;797
017597427560;1;188;115;260;105;139;807
057272260574;1;186;257;277;61;102;883
084756049372;1;161;287;140;63;115;766
080137167949;1;202;236;272;51;129;890
023090423174;1;245;143;132;65;79;664
022814173517;1;268;252;173;100;50;843
025462496157;1;226;209;286;74;160;955
031125712958;1;189;142;211;82;178;802
067281301135;1;168;134;105;86;153;646
056995632883;1;233;209;187;113;149;891
058271787679;1;96;136;92;86;158;568
059970210612;1;209;241;91;65;66;672
070923937775;1;172;88;177;81;113;631
050969976281;1;169;141;147;95;57;609
098720851983;1;270;141;243;92;174;920
031603510854;1;287;213;188;67;121;876
003179784147;1;224;261;129;103;88;805
036614163587;1;153;191;165;51;117;677
083007117816;1;106;229;152;50;79;616
090720704623;1;106;153;151;89;113;612
003946786713;1;289;177;96;90;68;720
007412325694;1;118;217;222;119;150;826
021110593557;1;168;84;277;89;117;735
008626516741;1;173;211;191;56;156;787
003056542154;1;203;210;223;50;153;839
084429831292;1;209;210;214;76;64;773
029665067520;1;241;222;218;94;97;872
099567928967;1;187;127;274;69;67;724
072180806941;1;269;110;99;103;73;654
028137977513;1;199;263;232;87;109;890
072698591627;1;253;125;162;92;168;800
077588154213;1;199;212;114;118;60;703
045883504254;1;155;138;166;109;166;734
060743867035;1;228;148;97;118;54;645
050039987233;1;240;145;252;100;97;834
037411853141;1;229;239;195;61;67;791
013217946787;1;211;98;271;63;118;761
033164551686;1;246;100;268;79;133;826
007676927117;1;259;169;233;83;72;816
093664742766;1;225;91;218;101;150;785
084682337398;1;253;254;205;104;124;940
001878314652;1;187;138;259;97;105;786
028777487035;1;174;84;130;74;83;545
000773574472;1;134;165;109;74;177;659
054526033231;1;271;262;176;103;157;969
016965439466;1;265;135;108;108;130;746
041938963678;1;247;197;163;50;169;826
018025669597;1;120;245;150;85;51;651
020460056304;1;169;282;263;94;114;922
053574697108;1;132;188;215;98;52;685
090296961602;1;173;101;298;96;109;777
031986043243;1;87;191;251;92;155;776
037120803009;1;139;121;175;111;95;641
003101333178;1;194;202;241;99;121;857
082298724417;1;178;132;114;100;143;667
073530673404;1;133;263;113;61;107;677
001014803147;1;219;184;300;87;82;872
077847547566;1;125;80;226;114;166;711
008945685086;1;240;285;272;112;144;1053
053262781830;1;174;198;137;70;51;630
064005929815;1;257;246;269;68;122;962
046840531484;1;123;215;93;88;122;641
091061868226;1;88;142;153;105;67;555
014040572270;1;125;165;154;53;158;655
042512721381;1;248;131;158;54;67;658
094767188798;1;83;140;119;84;81;507
075046198541;1;250;251;257;97;56;911
074203222595;1;248;270;100;50;87;755
047323983690;1;153;280;176;96;141;846
056213768909;1;217;269;287;120;162;1055
023745546355;1;276;169;264;79;112;900
010970885193;1;205;86;291;111;59;752
097926163395;1;87;110;185;120;148;650
087104744569;1;183;125;269;76;164;817
038998048484;1;256;233;95;76;174;834
089405458790;1;103;279;284;82;56;804
089092845226;1;267;228;269;86;51;901
079303799402;1;168;253;116;94;73;704
093136864915;1;282;124;113;82;130;731
034871908909;1;135;130;263;57;103;688
000395669805;1;196;150;180;74;92;692
088824796244;1;107;132;222;108;68;637
041494721120;1;90;132;294;62;175;753
013196485046;1;141;180;198;63;119;701
062497469721;1;166;243;189;91;128;817
081181914626;1;256;191;212;72;110;841
019313050391;1;287;225;250;108;86;956
054105612652;1;196;135;95;60;103;589
086114873603;1;239;231;202;93;113;878
092784064502;1;196;285;120;70;114;785
099632051349;1;249;145;288;93;57;832
078021087817;1;175;111;134;91;168;679
053701352544;1;137;167;127;54;126;611
026718279404;1;260;199;279;116;143;997
016524582297;1;126;218;183;60;150;737
021156382592;1;161;263;133;110;166;833
012597719104;1;111;215;270;63;178;837
072487537875;1;103;225;143;53;113;637
058342348110;1;274;195;256;93;93;911
018929978690;1;206;184;102;66;114;672
088760863591;1;264;214;163;68;148;857
070615175810;1;178;215;124;103;118;738
061729813044;1;165;173;264;58;140;800
057075068715;1;113;96;201;97;167;674
099318256905;1;113;233;232;72;98;748
091506190923;1;92;222;240;61;65;680
003748126571;1;118;239;116;116;135;724
016710985526;1;229;192;90;51;79;641
016310052908;1;91;247;163;97;99;697
074663872037;1;160;167;152;82;122;683
035571801396;1;209;180;177;77;120;763
027962052135;1;180;147;280;108;170;885
092733526416;1;289;217;119;80;86;791
081728817035;1;113;121;156;55;175;620
047534351879;1;191;206;277;64;168;906
038998733244;1;84;155;113;109;149;610
070636463737;1;148;211;206;61;91;717
059251919696;1;113;279;261;52;125;830
096007052205;1;211;216;98;105;175;805
027469857602;1;95;272;249;60;76;752
052116899230;1;259;105;288;59;155;866
015137636342;1;150;239;294;58;107;848
020119158861;1;84;264;138;120;55;661
007197149566;1;203;137;278;95;77;790
039651161542;1;171;145;213;95;152;776
095252580413;1;156;217;97;113;118;701
022447120192;1;151;174;120;57;71;573
047930756866;1;153;243;205;81;126;808
012572859366;1;261;227;279;54;112;933
029982958945;1;104;214;206;73;154;751
098787258257;1;162;204;150;85;74;675
074966620191;1;217;80;211;76;171;755
070436154897;1;158;262;107;85;111;723
022598182765;1;254;256;289;56;154;1009
086554371422;1;164;184;280;78;169;875
086010533849;1;187;210;98;91;71;657
041408697611;1;193;284;92;94;144;807
094684247959;1;248;239;150;78;176;891
022595878259;1;243;219;134;97;120;813
089289694295;1;201;186;210;74;148;819
065380723636;1;85;231;298;107;80;801
005089631358;1;195;242;293;60;51;841
007860966578;1;123;84;228;82;102;619
011155125990;1;97;195;269;93;62;716
052660527665;1;256;121;235;116;167;895
022928833073;1;250;93;121;71;88;623
019532318021;1;128;212;134;97;72;643
007559407497;1;264;242;180;106;88;880
015205911516;1;285;265;105;52;123;830
060082213562;1;115;193;225;93;101;727
018795581763;1;272;118;124;77;83;674
035749487243;1;233;183;275;52;85;828
004133961546;1;88;132;118;72;133;543
011345337407;1;141;126;130;76;152;625
086090518737;1;153;260;209;89;69;780
088971563864;1;170;200;181;84;124;759
005569926313;1;174;163;116;84;70;607
013117683992;1;207;187;183;85;75;737
054806979884;1;162;86;170;58;85;561
086491067488;1;190;212;286;112;124;924
083740981271;1;196;274;126;85;164;845
053418642253;1;148;102;140;71;65;526
061263709550;1;227;148;269;116;106;866
075730968484;1;210;274;162;111;167;924
053547382606;1;234;254;290;68;127;973
054616483023;1;253;111;167;119;73;723
038014779679;1;176;130;236;72;124;738
092393861078;1;233;112;124;50;173;692
069639001852;1;140;239;152;95;64;690
066194692588;1;96;270;266;98;57;787
055101190061;1;117;184;279;102;95;777
002574410227;1;200;191;163;76;143;773
055909652089;1;238;243;300;62;116;959
005904260127;1;217;215;281;83;76;872
033358640147;1;236;136;194;116;131;813
081204636062;1;275;166;103;93;94;731
034817680379;1;190;136;176;108;123;733
089457803401;1;260;223;257;65;96;901
076100288254;1;220;281;121;50;63;735
088088667436;1;217;204;234;106;142;903
000301235450;1;196;243;175;102;83;799
052216984887;1;228;214;216;65;162;885
018016053217;1;146;228;160;98;106;738
067714133721;1;210;157;215;113;161;856
046846061227;1;163;200;94;99;71;627
089758595462;1;198;287;142;105;144;876
075092408031;1;176;221;250;120;57;824
038507543360;1;155;233;245;68;172;873
076892825589;1;200;111;146;63;70;590
055612575040;1;203;209;204;63;106;785
053074427110;1;147;163;188;85;126;709
035072986448;1;95;275;256;95;51;772
088231924233;1;120;85;198;67;146;616
038808365053;1;124;123;288;85;94;714
001731037440;1;136;130;285;104;85;740
034722770453;1;88;211;216;115;113;743
051739400318;1;159;271;266;120;136;952
094751787250;1;267;282;155;53;107;864
007300275691;1;137;218;243;62;136;796
084990519546;1;278;89;124;105;141;737
090114159328;1;184;81;210;89;116;680
028163527125;1;274;109;164;51;75;673
018230949525;1;188;140;110;106;139;683
003037124173;1;160;237;188;88;51;724
058407643267;1;235;145;134;105;131;750
019673754621;1;291;87;252;57;147;834
098660363710;1;217;265;166;72;120;840
064039801499;1;165;255;212;72;173;877
097077954691;1;176;258;118;67;157;776
069899562120;1;230;181;201;55;59;726
035219388935;1;220;252;286;88;61;907
013423910308;1;242;172;269;117;77;877
083051351646;1;90;177;213;85;136;701
082799580754;1;267;244;244;50;159;964
066165146609;1;177;196;289;74;155;891
093347562852;1;247;258;180;79;155;919
005684746115;1;119;279;262;107;145;912
099592258316;1;108;208;199;111;178;804
027015148308;1;216;266;116;58;115;771
030834829731;1;221;120;174;76;148;739
025362980247;1;122;154;222;103;128;729
029932718942;1;248;213;117;57;150;785
024803477859;1;239;210;269;111;135;964
013067877588;1;292;192;181;116;141;922
059159128667;1;256;121;114;62;121;674
056626068734;1;258;118;166;70;146;758
008294830402;1;113;277;240;114;131;875
006404790727;1;191;228;162;71;139;791
026797766945;1;220;279;270;110;89;968
055521958200;1;264;168;185;61;165;843
097819963699;1;113;285;142;111;124;775
003620466514;1;155;204;96;79;83;617
004895016446;1;130;148;273;76;178;805
079525531226;1;215;277;198;89;108;887
001385622929;1;261;282;296;111;80;1030
023923584760;1;95;141;235;61;72;604
093310489446;1;157;148;145;55;136;641
070451348522;1;141;260;237;59;137;834
004680328307;1;223;80;269;117;69;758
046893643073;1;107;261;192;77;149;786
053134551757;1;231;182;213;57;150;833
000352855646;1;82;143;158;79;90;552
026331329006;1;237;229;207;51;166;890
032019596954;1;227;208;202;103;59;799
013179957659;1;90;268;262;67;67;754
014195131724;1;184;211;240;50;123;808
070225402172;1;196;159;190;79;149;773
041449320165;1;93;157;127;72;137;586
047224905026;1;286;95;109;94;111;695
062827340282;1;127;265;221;52;134;799
044860762167;1;137;209;236;81;85;748
043525861640;1;145;123;255;106;98;727
037360120342;1;142;249;259;55;74;779
005104637469;1;173;266;131;55;146;771
025245692962;1;104;258;183;112;116;773
041285949530;1;150;130;248;70;99;697
089690775227;1;252;94;266;84;110;806
015774069170;1;181;225;130;92;133;761
061083960293;1;185;257;138;73;69;722
026728874889;1;206;153;187;95;135;776
011095356329;1;205;140;215;99;60;719
098231153250;1;243;246;232;54;150;925
045796064661;1;223;92;249;99;135;798
075023036982;1;93;137;181;57;71;539
063401710271;1;203;220;120;66;148;757
078911525348;1;118;130;287;70;73;678
091595122289;1;174;176;252;113;150;865
028930326436;1;286;282;118;63;118;867
063782410153;1;196;188;283;104;88;859
037003332030;1;135;137;263;103;83;721
021800373916;1;137;182;228;104;54;705
066777126044;1;282;168;152;84;63;749
072477288091;1;215;131;197;104;74;721
067588862436;1;250;179;260;52;139;880
066778642714;1;82;281;143;101;59;666
015800763830;1;177;132;146;114;90;659
091613105494;1;262;171;189;99;64;785
083946464379;1;288;129;286;70;106;879
007727681371;1;87;221;267;117;158;850
010599498293;1;252;216;132;71;138;809
005386606697;1;89;136;205;66;97;593
011253146897;1;126;253;135;79;88;681
033178720186;1;218;281;149;120;62;830
018719663403;1;232;265;232;105;136;970
079836151333;1;138;215;149;112;77;691
054660948094;1;147;177;145;93;72;634
050638787271;1;214;149;167;52;60;642
077668010706;1;262;131;127;113;166;799
075264300636;1;211;101;127;93;92;624
059537827205;1;182;96;267;61;143;749
033973460153;1;168;236;149;62;81;696
035562601099;1;284;168;241;117;158;968
051026934740;1;278;161;262;88;172;961
040996281652;1;198;118;285;67;112;780
024000129805;1;203;94;254;120;103;774
033491511754;1;226;146;268;74;97;811
073449920501;1;213;282;147;98;157;897
012438123283;1;127;93;243;105;111;679
052071746640;1;200;232;91;96;148;767
081718489014;1;100;127;283;80;156;746
022226872280;1;199;121;291;118;154;883
063997240484;1;157;163;173;54;55;602
011168315463;1;84;152;136;80;103;555
056780298142;1;135;244;115;111;80;685
072452683857;1;220;96;206;75;145;742
079252077159;1;259;104;214;50;169;796
092008102836;1;179;253;165;105;167;869
059752412242;1;258;169;235;54;155;871
024242325456;1;139;88;190;55;93;565
095070995773;1;233;271;235;75;67;881
055833649421;1;242;227;101;116;109;795
010250201992;1;225;271;215;108;142;961
089226176773;1;285;285;155;88;163;976
073224929993;1;195;126;233;64;164;782
005605111355;1;253;218;125;68;130;794
039293289137;1;82;198;139;79;125;623
047972159927;1;268;235;101;83;95;782
051064045406;1;235;107;124;67;80;613
017973550802;1;228;150;160;73;63;674
038404967208;1;137;231;254;113;177;912
011576122888;1;187;239;242;77;117;862
040483609524;1;279;87;155;80;167;768
057325146326;1;127;269;244;58;53;751
035456519790;1;106;172;138;82;114;612
089967766127;1;110;95;129;103;125;562
070480359802;1;254;207;191;92;64;808
030935312724;1;187;187;126;77;82;659
043400482692;1;183;92;220;103;171;769
091167904482;1;226;207;136;102;80;751
043371352933;1;162;86;181;79;73;581
019785754225;1;230;174;153;87;132;776
031138533792;1;263;186;170;57;120;796
057009062480;1;265;282;169;118;165;999
005180563601;1;107;243;212;91;128;781
036971684831;1;184;118;253;86;176;817
075634842304;1;164;186;287;96;137;870
034953073599;1;100;222;241;104;85;752
016892814627;1;262;249;149;65;67;792
046650237878;1;201;148;192;59;159;759
089978388176;1;137;213;181;101;51;683
025058851584;1;256;144;247;105;142;894
078925037358;1;152;96;252;77;90;667
088384052834;1;139;198;166;85;66;654
072018461226;1;240;163;285;98;134;920
057425144467;1;168;98;166;53;113;598
058323559799;1;170;96;192;61;139;658
058109963834;1;209;244;126;74;107;760
006241290739;1;287;117;268;94;106;872
090571350301;1;269;287;270;73;97;996
079507663644;1;235;138;245;118;130;866
071884823376;1;277;121;170;59;152;779
008427869280;1;270;232;175;69;159;905
067113986681;1;248;191;171;98;157;865
002206293676;1;87;166;259;99;131;742
076484394416;1;159;268;97;114;81;719
047179045290;1;82;92;178;70;154;576
041157970700;1;281;277;174;98;89;919
024266465108;1;112;193;131;64;137;637
029520327864;1;92;182;203;50;64;591
054546081701;1;170;266;196;54;51;737
044134794227;1;234;132;150;92;148;756
066868541497;1;220;143;186;71;171;791
095307797052;1;179;103;195;115;147;739
073117272517;1;127;166;172;108;56;629
095142570283;1;85;189;198;104;86;662
099346081987;1;97;155;248;86;56;642
048754082832;1;166;271;96;86;120;739
022737044421;1;226;207;99;94;146;772
045171732294;1;274;106;296;88;165;929
039639299657;1;279;259;280;113;166;1097
011756403873;1;261;175;243;55;60;794
027393827645;1;117;123;248;118;162;768
023218185653;1;253;97;150;62;65;627
000203843592;1;246;105;175;56;135;717
066272509621;1;198;189;115;84;107;693
041829640836;1;259;177;248;82;80;846
010046596400;1;256;134;141;115;147;793
097139687017;1;90;221;227;103;155;796
066200908026;1;200;188;209;92;117;806
053713018367;1;132;134;132;77;166;641
053478514900;1;83;171;147;51;69;521
074361476296;1;267;131;189;59;51;697
041961468382;1;219;141;284;111;120;875
027926960875;1;211;123;94;76;160;664
030304456397;1;116;162;246;71;100;695
019154576726;1;159;126;165;99;132;681
063180224602;1;275;220;204;86;112;897
060114906677;1;198;269;228;120;162;977
085040383240;1;155;164;116;102;119;656
096199792899;1;121;118;230;103;154;726
085027529865;1;190;213;295;64;103;865
026090060632;1;254;212;113;92;54;725
061269242202;1;148;162;275;103;168;856
069809881178;1;120;239;240;60;172;831
058777499933;1;287;143;155;116;122;823
011622199819;1;154;231;168;114;148;815
007189608492;1;208;121;245;99;52;725
063724577306;1;194;217;235;78;131;855
029229472154;1;243;110;249;95;80;777
006007406295;1;88;233;243;72;101;737
086199302584;1;275;267;155;109;123;929
069097702209;1;86;193;209;111;152;751
011713792961;1;218;146;181;117;67;729
067927630050;1;288;167;112;113;60;740
084296750942;1;271;123;119;83;71;667
044709599906;1;147;199;296;64;84;790
009507051991;1;140;222;146;75;139;722
009002115620;1;237;173;197;68;156;831
051613162478;1;223;96;169;116;53;657
022021951708;1;128;110;245;104;153;740
059864729819;1;271;232;266;104;124;997
029307358468;1;244;87;166;94;102;693
085204237878;1;221;161;280;72;156;890
044021300832;1;86;136;263;120;167;772
097485608269;1;250;208;151;91;128;828
094192665882;1;150;208;283;64;137;842
069140233658;1;269;207;212;78;112;878
001087263666;1;183;93;233;96;151;756
074089339615;1;222;284;174;57;150;887
006952328857;1;222;272;166;101;140;901
026008684769;1;182;271;274;102;111;940
040781254467;1;224;226;230;64;65;809
016948284018;1;92;89;255;56;71;563
020041748835;1;104;221;169;89;87;670
062589245779;1;95;96;184;86;111;572
056261116182;1;116;248;212;71;169;816
098786758332;1;288;158;238;98;64;846
003577055843;1;275;186;260;97;90;908
000687468479;1;143;233;248;59;159;842
085876877678;1;176;127;150;72;111;636
087390267273;1;141;196;271;107;61;776
055654630115;1;238;138;198;70;90;734
067615597035;1;292;215;165;100;89;861
067147216636;1;252;86;192;113;93;736
085123942756;1;185;224;124;84;161;778
079589412477;1;212;84;124;53;172;645
018622418949;1;120;250;232;84;141;827
027547088856;1;256;226;213;119;103;917
073678240784;1;107;285;99;66;57;614
027701789407;1;263;274;256;106;106;1005
000019534586;1;130;237;168;61;99;695
016843165181;1;121;284;178;65;125;773
047447083393;1;109;156;235;70;152;722
006566185186;1;165;128;124;119;136;672
002252647422;1;82;213;235;82;156;768
051002860664;1;213;229;262;100;153;957
090150132643;1;87;192;95;70;163;607
026415369685;1;245;211;225;81;158;920
016388533268;1;122;251;193;61;156;783
093832594799;1;127;221;130;53;106;637
069368185631;1;85;255;96;75;132;643
077770962478;1;284;285;111;119;108;907
091095131258;1;242;88;123;56;110;619
027526898969;1;205;146;90;79;52;572
061205515583;1;243;94;100;75;113;625
008595367974;1;285;107;215;74;110;791
000873830985;1;137;288;299;107;121;952
053443675910;1;128;229;274;73;97;801
096543946774;1;171;160;227;114;76;748
070193479507;1;206;232;142;104;54;738
076677153860;1;158;159;201;77;86;681
070652086470;1;177;262;188;95;76;798
039312410026;1;138;219;114;83;52;606
092235530911;1;112;145;205;109;52;623
014485047642;1;281;234;134;93;94;836
086013510056;1;213;157;199;83;114;766
037668593327;1;199;149;215;86;61;710
093495155944;1;196;105;178;67;133;679
086373795930;1;86;201;214;84;116;701
098359057107;1;234;235;296;71;114;950
081943908107;1;217;178;280;108;60;843
018915210002;1;114;119;283;67;95;678
059502597978;1;290;137;234;113;113;887
053811036167;1;209;157;296;96;157;915
013968485812;1;85;287;223;68;70;733
091509195947;1;150;99;200;106;66;621
008722921348;1;231;126;271;118;130;876
092733014521;1;220;210;285;88;151;954
002215576329;1;233;96;124;59;94;606
097429062511;1;253;248;143;84;131;859
065894270527;1;136;191;246;57;162;792
056645722863;1;221;242;222;87;113;885
080350724854;1;135;137;273;113;138;796
090868134128;1;227;248;255;64;53;847
009850747050;1;229;251;171;88;86;825
082336574167;1;97;207;129;87;66;586
070039714537;1;166;131;109;115;117;638
069964288391;1;181;178;140;65;56;620
016255358336;1;208;226;176;85;113;808
060985187012;1;233;271;270;118;102;994
065504008826;1;123;130;201;61;66;581
038781869819;1;110;248;112;79;63;612
097949129734;1;139;80;192;63;158;632
058988410226;1;161;98;203;76;70;608
034458123625;1;278;102;261;86;123;850
005468269767;1;169;178;290;55;80;772
043637183256;1;110;169;187;80;132;678
019336972394;1;212;112;91;52;67;534
061241935135;1;148;139;240;117;126;770
033822737138;1;116;191;199;102;83;691
061643780928;1;88;249;175;99;76;687
062793437489;1;126;89;273;86;51;625
042540853518;1;181;198;214;79;59;731
043965636527;1;171;198;189;68;96;722
078838844114;1;202;192;188;98;130;810
032925949007;1;165;102;211;72;169;719
098026455860;1;259;88;293;75;59;774
059527798588;1;218;278;191;80;55;822
068448085552;1;179;234;175;63;122;773
097852473401;1;274;144;124;82;82;706
067657748279;1;222;103;213;76;70;684
052366957412;1;188;137;142;62;54;583
078231507688;1;195;265;178;53;140;831
002388644064;1;246;252;188;98;127;911
067864027499;1;219;109;152;68;108;656
095000719693;1;131;193;123;68;69;584
040073249817;1;273;286;281;77;79;996
069226608693;1;193;117;115;58;161;644
055232226792;1;283;237;124;70;163;877
066537309016;1;227;208;196;101;148;880
097970393891;1;275;88;171;56;93;683
035976566763;1;147;123;101;104;61;536
096626094729;1;240;179;214;52;176;861
027202303740;1;243;288;256;77;152;1016
050107072704;1;181;251;223;120;131;906
049116065164;1;245;246;246;74;91;902
033623730855;1;196;210;274;70;103;853
060313586667;1;125;214;181;110;175;805
073899564344;1;284;215;98;81;177;855
086864820586;1;241;167;185;90;106;789
023836933275;1;288;83;205;91;68;735
089607000943;1;246;106;135;52;129;668
021807798286;1;121;267;115;107;93;703
073630507213;1;165;147;141;77;103;633
054839842188;1;282;175;108;70;164;799
048617167168;1;98;247;216;116;64;741
007886954079;1;164;114;223;50;156;707
098340002824;1;201;179;130;67;95;672
017452844749;1;120;148;211;96;103;678
079560203449;1;153;193;196;64;114;720
099974909499;1;164;183;225;62;153;787
046128533313;1;131;90;240;112;149;722
097726801504;1;185;99;234;72;83;673
095009138907;1;177;222;208;65;53;725
002561774595;1;108;196;110;74;171;659
037239577840;1;231;89;147;81;88;636
010694964895;1;169;189;283;102;83;826
046938260023;1;211;203;153;115;98;780
073712605517;1;106;95;209;93;50;553
039032549435;1;136;271;189;83;64;743
037670692081;1;211;151;179;59;59;659
012070689949;1;89;93;208;82;131;603
090707333940;1;160;118;176;66;121;641
047091054825;1;198;164;199;101;98;760
003859672400;1;151;233;287;96;102;869
056533571592;1;99;203;180;117;92;691
026191185865;1;112;210;294;63;108;787
060130703843;1;89;143;92;77;80;481
025806392016;1;216;249;269;102;78;914
050764459163;1;101;99;108;58;79;445
016529222001;1;275;197;90;108;158;828
056437652680;1;100;247;114;114;109;684
020775895245;1;252;202;106;118;86;764
020953300277;1;162;83;112;103;98;558
016219081073;1;153;94;269;115;73;704
020084677465;1;185;278;149;79;139;830
063191431568;1;110;193;247;74;76;700
063362420878;1;212;186;201;96;135;830
016142067144;1;214;204;247;74;163;902
000292078368;1;85;247;197;68;161;758
039445386806;1;200;272;91;99;79;741
045268564411;1;176;89;287;58;119;729
024471181117;1;141;101;251;77;116;686
044719597235;1;102;176;300;100;157;835
080935630935;1;283;152;289;120;116;960
000447094387;1;91;230;169;88;63;641
008658669778;1;165;182;240;81;177;845
052466629395;1;108;171;178;78;129;664
037446588286;1;126;92;192;70;87;567
085820633884;1;94;257;172;94;124;741
013691040745;1;82;257;193;88;66;686
083961061346;1;197;169;187;60;157;770
001722852920;1;225;164;193;118;162;862
072883304633;1;204;144;286;76;147;857
014826794831;1;224;169;111;120;61;685
075159860186;1;278;284;219;59;55;895
052070764066;1;144;237;157;70;104;712
043390951113;1;135;146;288;97;162;828
020725791753;1;211;120;90;51;68;540
016293864528;1;208;101;266;68;113;756
090150257311;1;286;139;235;84;85;829
089935819031;1;237;188;229;119;93;866
095796841889;1;250;221;215;81;56;823
020163582103;1;96;259;102;100;150;707
004557726622;1;285;142;267;97;84;875
060693659632;1;183;227;155;78;129;772
005449191213;1;258;161;192;96;119;826
040740611506;1;240;274;227;113;81;935
070868625555;1;99;276;178;91;50;694
033342569596;1;155;223;254;79;123;834
062331804099;1;154;137;123;98;178;690
058956873931;1;268;95;272;75;161;871
075539919786;1;221;241;288;87;133;970
077874235559;1;146;236;115;106;172;775
037029956324;1;120;182;289;90;84;765
040328097664;1;91;244;270;119;174;898
072843695023;1;123;173;261;92;125;774
088340486792;1;156;217;117;111;87;688
097553909137;1;178;233;219;84;177;891
007488444365;1;161;228;96;90;117;692
050428331550;1;107;147;196;112;119;681
056025283287;1;115;278;136;71;150;750
002791981107;1;284;175;245;55;109;868
022676811979;1;251;117;175;69;173;785
009236287807;1;288;111;229;111;72;811
075845179158;1;164;173;290;93;96;816
068513496164;1;113;129;256;66;113;677
029072468069;1;117;215;109;80;178;699
049578204238;1;227;92;126;70;125;640
052187773091;1;152;149;226;102;147;776
053833140522;1;163;147;169;101;176;756
002417084499;1;102;174;226;110;127;739
027799170866;1;169;234;104;62;106;675
018491428516;1;277;191;140;102;155;865
043408244681;1;167;272;115;60;95;709
087983152437;1;209;275;121;117;155;877
082894885064;1;105;247;241;82;84;759
066026739224;1;120;112;180;115;57;584
061521258467;1;202;283;167;72;93;817
091457263473;1;112;211;184;96;129;732
059630849222;1;234;211;197;58;174;874
026671409044;1;102;181;188;114;171;756
033445652826;1;211;129;294;53;99;786
056783888084;1;232;203;256;51;114;856
024092729582;1;169;102;258;66;101;696
063048525852;1;160;156;229;116;125;786
008985756048;1;273;224;253;108;95;953
089763824174;1;129;208;204;92;112;745
087645561795;1;223;198;187;56;96;760
087518533196;1;168;245;222;72;151;858
059651273741;1;233;106;193;73;69;674
016014767997;1;114;210;278;60;113;775
050076670151;1;201;226;122;58;167;774
037227642838;1;230;103;102;72;82;589
001561962815;1;241;122;176;96;129;764
099716499048;1;222;284;236;69;61;872
010867510776;1;176;137;265;117;70;765
079780613563;1;243;250;248;74;62;877
013907780293;1;213;141;261;66;166;847
052681711616;1;291;154;156;99;178;878
085297507856;1;152;99;221;88;52;612
011805181277;1;100;288;211;53;177;829
000561893067;1;235;160;108;54;51;608
068687020277;1;156;249;266;86;150;907
075857378295;1;149;113;204;92;135;693
063684547261;1;90;90;246;106;55;587
078098073905;1;150;285;251;99;96;881
069618054583;1;260;164;198;105;155;882
002864049615;1;137;182;294;50;77;740
048453144233;1;208;93;277;90;133;801
056355497973;1;214;245;124;75;155;813
097370932969;1;159;185;191;55;141;731
065290163832;1;271;262;140;79;127;879
042103377453;1;101;239;194;107;168;809
003682246251;1;280;151;191;56;88;766
073581370348;1;186;184;114;69;110;663
079962914250;1;142;165;203;64;104;678
038211874855;1;269;138;107;56;72;642
033460897298;1;232;202;153;104;61;752
043934946830;1;263;100;263;89;163;878
017472695156;1;234;228;131;56;84;733
066115521725;1;191;142;263;107;129;832
078360663192;1;233;157;97;105;173;765
044213017184;1;92;91;260;77;75;595
066899169431;1;81;182;243;118;164;788
087338018465;1;269;99;225;99;97;789
030555260800;1;128;146;289;62;139;764
084676892491;1;250;165;143;85;101;744
030219731522;1;263;275;244;59;127;968
063583565113;1;276;129;134;106;77;722
036083673107;1;121;243;277;86;118;845
055851269827;1;275;82;234;90;144;825
092831591375;1;226;180;211;74;121;812
082145160818;1;89;103;206;85;147;630
033721723428;1;137;277;160;56;98;728
084662772608;1;252;179;142;64;65;702
045511458785;1;187;205;186;105;121;804
093692725063;1;200;232;215;87;135;869
019466588279;1;220;280;206;55;157;918
074755267060;1;157;227;98;96;131;709
089151421342;1;263;171;259;98;68;859
059894232047;1;231;248;285;96;119;979
075975223631;1;292;233;266;115;101;1007
013950800160;1;93;123;285;111;82;694
000965176510;1;86;237;196;56;75;650
004081633865;1;114;186;104;117;110;631
096791010120;1;102;106;217;88;119;632
012965801403;1;284;187;112;53;93;729
091354483281;1;114;180;148;100;153;695
064458636685;1;101;283;111;96;126;717
092510843602;1;226;209;112;55;148;750
029243017279;1;288;155;254;76;134;907
082812569702;1;262;149;191;105;84;791
080203217974;1;96;94;234;50;155;629
004118745040;1;175;269;134;118;163;859
050961125939;1;283;164;156;97;135;835
065784440423;1;219;161;236;58;139;813
000704179098;1;205;182;294;99;176;956
055823077620;1;221;96;243;76;84;720
003079198552;1;265;230;293;59;54;901
085235085627;1;131;134;264;107;157;793
014558146004;1;165;129;124;82;79;579
054693205463;1;145;252;203;59;156;815
094504633182;1;183;203;105;106;59;656
075608360677;1;211;208;101;65;171;756
001238902194;1;83;269;179;109;95;735
012487286806;1;142;90;158;90;54;534
016143097176;1;207;103;178;86;65;639
009459606887;1;278;119;213;111;75;796
009602280655;1;256;266;229;79;64;894
052538365697;1;284;182;217;77;123;883
099393802332;1;216;286;261;110;70;943
061659938697;1;237;160;255;115;89;856
012210106133;1;182;286;265;74;101;908
042504593482;1;120;89;170;101;119;599
084692592518;1;229;190;140;66;148;773
031067069026;1;103;226;272;102;85;788
048480324075;1;180;104;290;75;163;812
089083165026;1;193;287;99;83;106;768
081307974442;1;244;269;132;118;57;820
020769732915;1;124;142;122;60;157;605
099571530120;1;283;110;150;103;94;740
007577429073;1;292;280;273;65;170;1080
045385559290;1;160;87;93;78;70;488
009925776959;1;209;177;202;91;102;781
094574741909;1;213;244;212;110;79;858
039834983596;1;128;207;274;65;72;746
065251806830;1;118;90;131;65;53;457
080836031620;1;168;216;300;89;123;896
059117303273;1;191;186;102;92;126;697
078419974912;1;195;127;94;95;116;627
078314034534;1;243;108;212;109;60;732
075607458599;1;199;157;132;53;93;634
025270587706;1;292;165;101;101;142;801
065406298074;1;106;173;238;119;99;735
026743360802;1;157;277;149;92;118;793
064944195557;1;190;92;297;120;63;762
046759275659;1;132;188;224;106;166;816
068388887275;1;248;180;96;80;76;680
042921504489;1;167;190;234;79;171;841
038470015342;1;113;267;92;77;106;655
032612418085;1;291;205;233;66;89;884
028128470017;1;239;206;261;84;95;885
036032079037;1;259;221;275;73;146;974
043176530330;1;112;280;178;77;86;733
049296591444;1;250;82;220;68;56;676
098528120019;1;228;110;121;79;118;656
056529424604;1;181;284;244;83;116;908
016697794919;1;149;102;161;53;109;574
082951370783;1;248;180;90;120;102;740
099289433253;1;169;110;255;68;170;772
065332828780;1;129;215;135;52;75;606
015855420470;1;106;219;171;110;154;760
063092879221;1;122;182;195;80;150;729
046890697811;1;132;170;190;103;53;648
049276993079;1;104;206;164;58;173;705
040819700014;1;156;117;276;118;107;774
002537856585;1;210;144;272;70;104;800
080495095554;1;279;86;190;55;177;787
095458910522;1;140;112;229;115;162;758
088109940766;1;192;186;181;118;121;798
006841239700;1;133;182;271;62;64;712
040693416530;1;220;142;165;103;109;739
049998637029;1;194;249;132;63;158;796
089479693216;1;151;157;182;99;123;712
066964060053;1;221;191;122;89;132;755
085642552244;1;218;217;184;82;115;816
000489755018;1;230;279;199;96;152;956
096797089959;1;234;117;201;74;95;721
048289539785;1;265;254;158;88;145;910
087936964048;1;248;136;223;72;107;786
061999665039;1;290;150;118;113;114;785
058109299957;1;270;138;109;116;175;808
081212345562;1;129;120;295;83;99;726
050434110870;1;110;271;192;86;167;826
026065074710;1;93;102;193;118;150;656
066010867688;1;120;233;226;86;135;800
099726191095;1;183;286;259;79;161;968
044286599251;1;124;213;220;73;142;772
071650028638;1;267;230;269;83;150;999
050037013939;1;256;142;229;80;177;884
056341964732;1;243;100;216;72;178;809
023402848459;1;129;185;185;101;116;716
014100665034;1;236;132;134;61;155;718
032510352664;1;169;140;121;80;103;613
000104352883;1;237;133;134;83;57;644
028236236138;1;136;113;296;66;71;682
044075457313;1;257;103;182;53;130;725
096023450382;1;275;167;228;63;120;853
077664554115;1;113;89;99;59;83;443
043048030874;1;291;132;202;57;52;734
057978600791;1;180;93;197;60;140;670
042466566282;1;238;250;124;108;119;839
048634908456;1;89;278;125;93;140;725
045846985293;1;264;224;219;95;114;916
002810029287;1;259;272;133;100;85;849
003702095028;1;146;105;299;85;74;709
040308693203;1;243;138;294;68;94;837
028630832738;1;259;88;245;66;119;777
004133154244;1;281;283;146;95;151;956
030788995847;1;138;96;297;102;175;808
009141587468;1;119;115;178;65;134;611
081626516736;1;169;184;265;65;118;801
009793628258;1;292;118;249;77;151;887
084832098113;1;288;144;207;101;98;838
060629402601;1;121;257;176;73;113;740
055451554612;1;81;151;184;53;95;564
035595461178;1;171;254;262;66;91;844
096133805688;1;83;191;119;57;92;542
034623761553;1;169;156;164;88;85;662
048231389119;1;164;135;146;96;156;697
034984644202;1;85;200;242;69;98;694
048679906919;1;147;179;185;66;60;637
040638594928;1;245;82;129;119;73;648
034910889958;1;215;187;181;114;68;765
048542201423;1;125;279;93;61;87;645
028748845395;1;272;219;210;91;151;943
055242179884;1;262;203;207;55;50;777
020514718663;1;255;103;264;58;119;799
047749062853;1;283;167;157;60;162;829
015775742698;1;201;258;266;111;80;916
049850648227;1;202;188;269;81;82;822
005767650772;1;271;85;123;71;78;628
041577736955;1;207;122;291;89;102;811
071527298940;1;270;91;262;64;71;758
088723956953;1;101;81;135;104;106;527
063083593161;1;146;222;249;97;50;764
091291146442;1;133;269;162;52;88;704
074227676599;1;213;218;238;120;159;948
028056117640;1;83;137;132;100;169;621
078290353716;1;166;202;228;118;89;803
009106108371;1;197;180;153;64;100;694
074572410739;1;190;221;231;55;51;748
064451841091;1;225;150;261;108;80;824
064747305774;1;148;160;238;68;68;682
021767302904;1;185;117;144;98;77;621
066715622253;1;129;124;187;96;56;592
001984114729;1;108;232;92;98;69;599
020827355416;1;155;153;210;59;95;672
041355249084;1;129;98;257;112;178;774
072041879661;1;155;182;299;62;172;870
020847923404;1;124;236;210;90;111;771
082741736551;1;169;192;138;63;132;694
012905563656;1;105;119;93;108;87;512
087436096683;1;182;283;278;87;105;935
004988620376;1;165;206;144;59;146;720
045276344492;1;215;202;230;107;178;932
028923311598;1;247;255;255;105;150;1012
095317333479;1;247;288;140;100;104;879
059246907706;1;125;122;290;63;83;683
019160860995;1;118;119;254;75;136;702
028833400873;1;154;89;227;88;104;662
061315454159;1;82;222;242;54;77;677
027204797620;1;102;168;217;55;160;702
099669930213;1;235;141;295;67;77;815
093595055919;1;102;207;91;91;173;664
047429825144;1;246;243;204;84;146;923
049382084724;1;277;160;91;113;176;817
096083825616;1;246;224;268;95;139;972
001344300349;1;249;279;241;120;151;1040
085326932437;1;146;84;229;82;171;712
034490544432;1;252;185;102;91;165;795
037256198974;1;275;127;194;95;108;799
077697040602;1;246;87;293;81;106;813
088001499963;1;208;262;168;54;130;822
066282946787;1;128;132;111;114;137;622
050443309035;1;178;184;185;68;117;732
016315221489;1;271;142;210;99;137;859
028127624616;1;160;198;274;93;80;805
067304216381;1;282;148;101;116;155;802
085699870773;1;184;288;224;109;151;956
090209939073;1;118;81;100;51;118;468
016024156536;1;125;222;282;118;147;894
076579881417;1;187;189;295;53;116;840
097635591824;1;282;165;176;77;72;772
064625539135;1;152;137;167;89;56;601
066594980023;1;179;217;107;93;147;743
009665586821;1;288;253;292;113;87;1033
079577300947;1;209;186;276;73;60;804
002284726962;1;226;123;98;116;150;713
057501043097;1;222;280;276;50;93;921
015573481287;1;267;218;117;74;171;847
059783646927;1;261;260;155;112;66;854
052059492940;1;89;118;135;90;135;567
018739005388;1;245;146;283;84;75;833
033541074185;1;225;181;111;91;50;658
022291195054;1;130;266;164;68;129;757
069478565225;1;97;276;138;66;163;740
010583990075;1;257;241;244;63;65;870
013062061217;1;125;223;91;105;59;603
081179299612;1;287;262;91;68;99;807
045342007742;1;270;241;215;66;113;905
085067060408;1;287;104;133;51;116;691
016949521200;1;109;224;90;106;109;638
024327588144;1;154;266;164;109;63;756
016001582766;1;257;155;272;93;130;907
039274047716;1;283;214;233;64;89;883
010284025046;1;107;156;101;112;130;606
011507703557;1;193;238;287;97;155;970
064929489595;1;216;248;203;60;153;880
097523390691;1;103;114;224;103;61;605
061730525096;1;229;224;125;84;124;786
001653761214;1;207;224;229;51;148;859
013912987099;1;275;239;210;77;175;976
044772880785;1;230;114;230;65;119;758
096734117557;1;240;226;91;96;136;789
005386495668;1;110;81;141;62;80;474
093251057845;1;267;279;111;73;129;859
018758026357;1;236;280;95;65;63;739
025623476068;1;107;198;135;117;160;717
015428052002;1;258;205;224;115;107;909
076666876639;1;87;122;171;73;72;525
039732547719;1;202;145;146;102;105;700
012797021388;1;181;152;259;103;137;832
095781968405;1;173;180;95;67;173;688
059653529428;1;84;92;179;89;162;606
005893494916;1;152;239;175;90;72;728
047817818638;1;113;193;145;79;173;703
032040504911;1;88;242;212;54;97;693
021986921384;1;100;188;273;94;177;832
076835435813;1;128;114;215;101;157;715
067502125408;1;209;210;160;100;74;753
018857914670;1;236;231;120;58;79;724
076875513902;1;195;209;94;54;65;617
000529021822;1;213;104;236;54;65;672
041533027436;1;235;121;133;60;62;611
061316163818;1;241;179;121;56;85;682
000838968556;1;157;245;233;50;70;755
093021929877;1;207;156;104;54;136;657
016375961978;1;243;124;174;118;82;741
087562745300;1;178;271;146;97;167;859
087829954403;1;258;131;139;83;54;665
093335091067;1;110;112;118;114;146;600
098543918395;1;273;263;272;82;50;940
056833867686;1;225;194;123;104;172;818
025738519628;1;177;130;105;87;144;643
017163717671;1;286;97;258;114;141;896
048167521054;1;224;196;181;65;112;778
009639113177;1;235;245;135;101;126;842
007668724586;1;114;247;177;55;142;735
008376269461;1;202;182;118;68;57;627
025023504593;1;225;275;116;60;175;851
042395987529;1;225;180;206;95;100;806
031558169593;1;107;148;250;86;162;753
001659673863;1;291;278;269;76;136;1050
078306766273;1;246;133;103;55;125;662
049575939574;1;126;203;274;63;150;816
075515144840;1;186;190;103;113;142;734
073779917735;1;158;197;250;115;144;864
088119026642;1;289;161;117;64;62;693
062197107296;1;232;107;270;104;54;767
007697941476;1;141;281;215;53;109;799
081937674234;1;113;144;112;55;98;522
029745437392;1;112;120;212;115;135;694
091446096967;1;113;175;134;62;148;632
059825784082;1;122;94;290;76;79;661
039675222156;1;205;108;229;95;79;716
052332723060;1;253;146;243;84;71;797
072634120644;1;224;231;140;120;136;851
001112567918;1;126;87;206;69;107;595
023341523209;1;237;225;106;111;150;829
048103132615;1;215;252;287;106;70;930
055142178666;1;194;193;173;83;91;734
086529028408;1;265;200;119;111;59;754
067819067626;1;139;218;166;67;50;640
062538036526;1;277;116;256;72;125;846
097444906231;1;92;151;180;50;69;542
089967987930;1;83;80;298;90;108;659
017586644473;1;282;240;119;63;134;838
035025734626;1;285;84;243;110;112;834
029407626872;1;93;172;92;88;68;513
013760476190;1;97;184;270;77;135;763
048090981865;1;148;183;135;85;79;630
040673725665;1;218;86;292;85;94;775
015095194913;1;254;127;115;109;99;704
096179180080;1;139;141;272;81;111;744
027897648944;1;231;99;225;74;160;789
021465945347;1;240;98;258;55;110;761
011415109290;1;105;235;269;83;50;742
035894630385;1;139;241;178;57;68;683
051009318542;1;242;102;95;102;132;673
082374647935;1;149;139;185;58;74;605
021729538145;1;218;115;106;106;102;647
064680886944;1;101;132;183;116;129;661
088810446469;1;273;82;175;72;95;697
024406980294;1;105;282;250;81;107;825
058375578187;1;211;185;238;118;52;804
040915840594;1;274;171;274;80;90;889
001399250452;1;231;106;137;86;125;685
098009978874;1;268;226;284;69;95;942
004052394075;1;152;133;265;73;146;769
018554108802;1;108;199;205;102;82;696
007002660413;1;269;202;197;68;85;821
020018641767;1;131;116;236;106;171;760
052590930195;1;173;234;205;112;86;810
016086089320;1;98;219;126;50;95;588
005120229058;1;247;254;235;65;173;974
094460793453;1;173;158;131;75;139;676
000653889805;1;190;143;196;89;119;737
069542916888;1;97;101;255;98;131;682
084898825942;1;262;272;105;74;149;862
047061974067;1;181;125;259;64;167;796
077371139159;1;265;197;129;85;169;845
075266201809;1;218;198;135;115;56;722
091886441007;1;84;113;185;70;53;505
086004441423;1;234;122;210;52;176;794
068395556197;1;266;268;193;117;110;954
002784547945;1;215;286;298;75;149;1023
055287192683;1;162;259;177;106;120;824
001637296143;1;227;209;136;65;96;733
004249563609;1;245;165;170;64;123;767
089107967882;1;107;191;252;93;126;769
049611772728;1;217;266;125;89;141;838
097223726565;1;263;141;111;110;137;762
012610847954;1;161;84;298;98;117;758
031905751374;1;233;115;232;56;163;799
002160715725;1;252;170;107;81;128;738
075368602370;1;267;80;220;93;76;736
073180003387;1;215;167;125;68;132;707
056187225989;1;115;217;135;101;153;721
090760051908;1;264;146;186;119;117;832
002467173594;1;149;263;153;88;82;735
058396518995;1;114;136;114;57;160;581
018583201393;1;103;120;139;83;105;550
020148086710;1;132;118;194;77;168;689
082081450224;1;246;165;177;79;118;785
093137371768;1;210;111;171;120;111;723
007206917784;1;149;267;254;107;162;939
077280429642;1;185;217;148;111;143;804
012053761159;1;252;121;216;97;114;800
065125333003;1;228;137;283;59;150;857
019433944406;1;266;202;96;93;123;780
065957973346;1;258;247;102;68;81;756
039834606557;1;166;104;290;54;86;700
094459908766;1;214;112;288;66;174;854
000384059446;1;189;105;116;98;114;622
084216558732;1;234;180;141;85;152;792
041154719390;1;242;177;176;109;148;852
057319456129;1;195;134;188;76;69;662
059893019590;1;149;222;231;112;175;889
030925969558;1;291;82;263;68;137;841
056282176140;1;111;96;202;78;162;649
013021780477;1;171;124;288;100;69;752
022667695547;1;84;108;291;51;55;589
008566391633;1;198;219;215;113;108;853
037482822569;1;160;218;140;82;148;748
085726002157;1;232;207;284;76;75;874
088354742505;1;242;83;167;114;118;724
032118201842;1;188;262;183;75;65;773
024192107974;1;282;211;174;101;133;901
089377503285;1;238;181;272;115;168;974
009128617595;1;128;177;94;66;92;557
081094008609;1;287;175;207;77;102;848
015758633529;1;275;183;243;81;61;843
059538024899;1;210;209;204;70;163;856
061146143165;1;126;157;242;80;88;693
087677624709;1;237;225;130;110;99;801
002787257788;1;135;80;245;69;68;597
069416077390;1;194;152;96;111;121;674
010989098526;1;250;222;118;96;56;742
080058698246;1;193;175;138;97;95;698
045702149377;1;137;268;168;103;160;836
059751576671;1;94;265;193;96;106;754
010146777666;1;89;201;297;64;110;761
035746364975;1;120;116;114;61;57;468
024718861037;1;222;203;188;86;120;819
021404788090;1;200;99;284;50;126;759
083091359290;1;277;203;164;51;57;752
043490094148;1;251;126;210;66;94;747
005185192219;1;146;244;207;66;112;775
032978361548;1;200;209;140;90;149;788
045711571040;1;224;197;96;92;77;686
048614413213;1;133;209;163;66;170;741
079364028395;1;222;154;277;57;58;768
038133404611;1;213;176;211;90;127;817
080061539164;1;113;186;204;92;64;659
038332190965;1;229;278;215;94;97;913
074882633779;1;241;200;109;112;103;765
071149123636;1;83;278;132;92;147;732
081773082865;1;276;157;147;56;102;738
083740068905;1;157;160;164;106;143;730
099344638567;1;275;166;166;115;85;807
014939637244;1;95;107;186;116;52;556
036056534550;1;156;168;90;90;79;583
089452220575;1;205;149;182;110;94;740
062979718220;1;281;84;225;119;144;853
020160512591;1;207;88;159;99;101;654
099067325344;1;238;143;267;83;78;809
039299995167;1;231;111;136;82;170;730
027285270304;1;261;219;111;100;97;788
099224294007;1;292;251;186;86;141;956
034770448388;1;289;236;114;62;123;824
099133925740;1;241;195;114;117;96;763
084024443144;1;244;156;232;64;71;767
023798153365;1;102;160;277;97;79;715
015968817935;1;164;167;285;67;58;741
032337297008;1;292;280;209;109;51;941
015648315371;1;120;101;224;116;90;651
006710633643;1;173;85;279;58;100;695
008411708411;1;283;287;282;79;154;1085
030112111958;1;147;194;226;56;65;688
026562103092;1;286;176;127;50;75;714
078219012929;1;98;116;262;115;98;689
040312190532;1;221;89;163;94;166;733
002584332834;1;246;251;171;107;126;901
049575652906;1;150;156;153;118;153;730
016142609792;1;159;200;149;120;98;726
071443883114;1;198;256;100;82;154;790
094900619433;1;181;174;184;96;165;800
054796822879;1;131;284;132;89;92;728
085657081870;1;111;109;107;99;153;579
031904323910;1;227;109;272;50;58;716
063997944128;1;94;272;261;82;60;769
001806683946;1;226;278;165;96;176;941
029874937129;1;227;244;224;83;169;947
090922168703;1;266;278;222;109;105;980
020874558643;1;158;152;208;115;54;687
018230762179;1;215;81;125;56;86;563
009589483168;1;151;171;238;62;51;673
072658626257;1;101;165;121;94;108;589
057365626071;1;147;257;114;113;138;769
053127661938;1;198;255;106;74;115;748
026349902737;1;194;237;194;109;86;820
059582667941;1;261;90;262;112;120;845
078939774559;1;176;146;140;103;54;619
063327419137;1;129;161;202;65;121;678
056303130519;1;232;242;144;89;162;869
096208893563;1;127;94;285;109;59;674
048400649916;1;268;236;205;70;165;944
080281962102;1;124;134;100;79;90;527
024640114932;1;291;258;149;110;102;910
011068686666;1;104;188;210;77;94;673
086483342817;1;172;231;270;110;128;911
073228431487;1;116;233;280;93;104;826
091747092673;1;183;190;276;90;123;862
063227825882;1;203;136;113;111;52;615
087258168337;1;239;189;157;67;138;790
072637516552;1;220;266;294;112;56;948
071468266282;1;116;157;151;59;173;656
081341593831;1;142;146;226;84;155;753
001633286081;1;207;235;140;75;175;832
032668199340;1;219;87;132;69;104;611
073531186799;1;166;147;246;120;74;753
046004693532;1;115;150;285;116;154;820
044207503139;1;159;280;150;56;105;750
090481765831;1;226;269;241;120;164;1020
067414093677;1;148;138;254;72;175;787
032628067256;1;280;120;196;79;140;815
073272084916;1;188;119;192;85;157;741
051193975605;1;240;131;98;105;156;730
011954727997;1;101;249;92;51;75;568
079681896865;1;177;159;96;113;111;656
039256127335;1;199;229;246;54;123;851
098357693010;1;122;98;162;87;152;621
087723749106;1;204;287;146;63;160;860
038177318179;1;273;218;276;83;147;997
074185238626;1;144;282;127;54;97;704
066192196487;1;269;200;145;66;156;836
077488564006;1;149;96;159;56;158;618
047288089481;1;218;121;290;62;143;834
030073878522;1;190;287;110;86;177;850
067538372031;1;133;103;97;107;117;557
067336662556;1;277;254;114;98;130;873
016095786582;1;170;108;265;86;82;711
080894052050;1;258;100;127;111;142;738
065129156046;1;274;250;188;88;95;895
089512521958;1;249;278;150;99;52;828
032664343111;1;132;135;159;54;63;543
070176302909;1;187;148;257;100;69;761
040803187035;1;228;157;125;104;161;775
060992151427;1;273;161;178;116;89;817
025640708363;1;259;202;129;105;82;777
017456018010;1;282;288;207;114;110;1001
082319473936;1;137;273;145;56;171;782
014426683402;1;81;261;217;112;112;783
098490680301;1;220;163;108;119;51;661
096233851439;1;111;174;171;57;170;683
016233543363;1;284;110;290;50;151;885
027627377316;1;200;145;209;103;124;781
029644602255;1;103;130;190;103;157;683
002757795729;1;230;162;245;67;103;807
091763655538;1;288;143;260;79;114;884
030084707748;1;222;92;142;95;54;605
023925558922;1;290;111;279;84;106;870
076794867316;1;250;260;183;73;125;891
014753413480;1;234;124;186;85;134;763
091803488573;1;169;132;123;96;93;613
050393400061;1;87;210;245;104;60;706
062530872637;1;249;252;216;71;143;931
094457213495;1;242;131;148;55;82;658
029908455508;1;265;221;190;77;141;894
070491763146;1;95;232;255;78;137;797
001308089619;1;251;153;218;51;63;736
072521735818;1;125;231;180;93;170;799
094410978466;1;189;205;253;71;151;869
029368256862;1;260;236;275;65;140;976
007742261622;1;103;255;195;111;96;760
091907260985;1;222;127;218;119;91;777
084880698105;1;102;257;130;55;92;636
079380779754;1;235;106;262;105;77;785
060266448391;1;182;149;136;84;114;665
032905813177;1;206;89;118;53;53;519
033791161519;1;224;264;109;65;60;722
035352565247;1;285;245;105;52;108;795
048443317861;1;233;207;239;57;103;839
013961155455;1;211;124;97;105;59;596
091586199486;1;238;186;184;77;85;770
048745540852;1;178;117;271;84;168;818
037740151759;1;102;141;244;95;125;707
040406739732;1;176;200;90;69;145;680
014847569178;1;184;142;211;82;125;744
070233913139;1;276;246;207;112;169;1010
022563040517;1;267;224;106;118;72;787
009118555420;1;144;280;172;105;110;811
001744429474;1;239;139;152;57;78;665
059500313268;1;265;287;220;76;175;1023
068300721521;1;107;123;206;87;164;687
056700910754;1;243;91;245;69;122;770
034204975421;1;132;270;175;64;82;723
046598210703;1;182;195;220;93;53;743
044984267374;1;99;252;199;102;141;793
064478354548;1;212;90;216;71;85;674
051022004210;1;143;266;142;106;111;768
045958930855;1;128;278;90;71;72;639
045095916758;1;287;196;279;68;84;914
010758631616;1;149;191;129;99;108;676
045112051510;1;281;173;170;107;67;798
073960837297;1;87;263;263;120;169;902
095553971693;1;201;164;186;54;115;720
066748696101;1;118;96;260;68;172;714
060880301087;1;274;161;297;56;59;847
005284933125;1;118;284;144;80;172;798
011194910021;1;235;275;99;63;73;745
024943416540;1;254;237;107;75;77;750
096527929778;1;161;126;282;60;177;806
028043605661;1;278;153;204;89;175;899
069201193743;1;114;259;205;70;128;776
029748216368;1;213;155;258;118;119;863
048476271999;1;205;93;122;99;178;697
023424120982;1;142;256;171;64;79;712
095972766910;1;288;282;119;91;121;901
005558097962;1;284;233;247;81;118;963
025387867599;1;176;194;123;84;64;641
010291562267;1;259;245;159;104;64;831
032899464793;1;225;171;141;79;119;735
077632009709;1;122;95;198;50;129;594
037690704346;1;180;212;114;95;102;703
058256735249;1;182;269;114;80;66;711
019752684188;1;223;247;98;69;93;730
093825839297;1;121;166;101;105;165;658
029828655660;1;211;223;112;61;86;693
053643156514;1;199;238;201;50;97;785
054552286499;1;172;287;171;59;56;745
051801314127;1;242;123;94;109;150;718
074911002079;1;139;97;111;75;144;566
004686209447;1;107;95;187;93;78;560
021709885282;1;104;266;115;86;115;686
097278130486;1;248;118;231;98;111;806
044398374874;1;180;244;271;80;152;927
069713935995;1;158;175;201;95;58;687
040357777699;1;226;260;153;94;103;836
063849575315;1;149;100;210;73;115;647
014240837250;1;138;180;192;104;128;742
046294707131;1;223;145;182;80;61;691
039111824318;1;255;222;97;93;85;752
001287095683;1;113;220;287;87;172;879
016219103145;1;244;224;120;120;66;774
032581380401;1;243;161;124;73;52;653
082012566745;1;136;257;226;120;86;825
015751517744;1;133;203;246;114;121;817
068566467695;1;200;240;104;70;87;701
052896547712;1;162;196;137;54;141;690
066706924637;1;166;251;90;91;178;776
062017514061;1;269;246;203;50;166;934
068150591211;1;134;142;100;83;146;605
017463223997;1;93;198;148;100;62;601
013166707231;1;113;282;293;102;145;935
086955922437;1;92;235;277;93;100;797
071720302484;1;107;110;278;54;136;685
038911832647;1;94;254;244;114;123;829
058474668441;1;136;256;146;114;58;710
091305512265;1;222;256;222;57;84;841
030489626189;1;108;98;205;93;149;653
050510440099;1;129;210;297;63;163;862
034909929924;1;156;136;169;94;124;679
080107956997;1;115;136;298;62;98;709
083771929739;1;191;143;129;58;147;668
063029634892;1;234;273;138;112;122;879
054502478631;1;250;149;160;59;166;784
040671810440;1;236;190;103;114;127;770
001814928894;1;180;121;97;56;87;541
066580493523;1;266;161;192;111;169;899
020555373105;1;93;182;134;88;128;625
010617378609;1;93;129;297;55;94;668
001996609091;1;150;250;193;75;136;804
024228270784;1;91;282;180;54;141;748
014766976357;1;94;87;261;118;96;656
092387211402;1;195;181;195;54;123;748
022325743184;1;272;219;261;120;128;1000
093884596748;1;119;93;238;112;178;740
028364306398;1;291;87;155;113;58;704
080864172487;1;104;85;297;112;112;710
084648985027;1;236;133;113;114;111;707
090922523685;1;169;169;181;82;154;755
078267271308;1;215;159;278;88;88;828
021284585240;1;277;143;139;54;75;688
062479293786;1;80;277;223;50;144;774
039614860109;1;178;148;183;91;94;694
088465864264;1;144;172;120;56;136;628
022151679991;1;212;149;160;69;78;668
049728597166;1;178;139;170;60;51;598
023029604425;1;182;232;154;120;169;857
009060208724;1;198;276;291;116;68;949
067624798864;1;177;222;120;60;52;631
035886305129;1;283;177;236;73;142;911
054329812443;1;157;206;266;70;122;821
048102835243;1;152;260;198;88;92;790
098307144245;1;285;242;192;68;111;898
069749708997;1;256;216;156;85;125;838
038667248942;1;277;167;237;106;104;891
085829577743;1;275;226;261;71;173;1006
011394896270;1;266;132;92;91;176;757
040491783500;1;272;208;284;51;151;966
034492197255;1;184;281;120;120;109;814
036784609733;1;169;217;196;90;111;783
000101812444;1;220;267;289;62;93;931
027617352156;1;173;285;169;55;70;752
000870967962;1;127;128;273;113;96;737
078928005056;1;202;127;91;112;168;700
064371059950;1;218;217;224;86;75;820
075545142124;1;214;218;257;101;72;862
060495493280;1;273;256;247;92;129;997
098222540139;1;145;250;131;66;157;749
036966081642;1;167;82;216;66;86;617
016319716142;1;264;166;140;96;146;812
029819845811;1;281;240;177;101;170;969
074202074286;1;284;223;184;112;169;972
068357815193;1;265;275;138;62;122;862
020651743020;1;193;130;135;68;83;609
063536970045;1;127;111;217;103;101;659
086263675883;1;164;251;136;98;91;740
012443693292;1;216;125;258;92;95;786
074600871130;1;168;102;284;66;155;775
058313304083;1;174;176;252;100;163;865
068838027914;1;114;225;113;60;57;569
007679132438;1;98;112;98;115;144;567
031846387401;1;158;277;92;111;110;748
079477064039;1;174;286;232;90;54;836
002031716867;1;103;251;229;92;74;749
039777990944;1;218;286;253;101;132;990
082896357859;1;115;88;294;93;105;695
068844857258;1;261;227;172;59;57;776
017090369687;1;118;246;106;84;135;689
008744851268;1;291;157;255;105;94;902
078625613686;1;120;231;128;100;141;720
070884886284;1;191;153;210;117;157;828
086820424524;1;251;179;268;100;94;892
028367658184;1;146;196;201;74;162;779
057210001756;1;211;91;139;70;177;688
006631738292;1;175;125;268;70;176;814
075601295166;1;151;112;149;58;111;581
018929037850;1;86;146;147;110;167;656
032212553250;1;102;83;168;105;154;612
065755297885;1;111;231;202;91;153;788
000859395006;1;116;86;175;118;124;619
086365329856;1;269;172;237;109;140;927
050959315623;1;103;187;148;59;165;662
076113867209;1;84;231;200;100;133;748
077160768725;1;276;193;279;60;96;904
029712216977;1;140;244;269;90;101;844
043836509553;1;156;267;247;91;71;832
031065643266;1;211;241;284;99;140;975
091725860096;1;214;100;156;101;163;734
083425624619;1;176;163;121;116;177;753
077434564025;1;225;165;114;96;108;708
036262208284;1;130;107;262;72;107;678
026561107674;1;97;280;103;85;55;620
016241837994;1;107;266;259;114;146;892
012585611803;1;86;171;213;110;57;637
071044888002;1;232;184;124;81;70;691
088024680444;1;233;235;111;106;138;823
068704851064;1;271;228;141;107;143;890
013501435462;1;119;255;158;63;91;686
093238401307;1;292;124;190;52;128;786
000127592058;1;161;155;232;115;81;744
006434413489;1;93;145;205;98;111;652
040576329251;1;134;195;175;81;50;635
002263357570;1;105;178;195;63;144;685
013186734758;1;159;147;200;70;176;752
041667054295;1;259;87;216;94;97;753
003646295849;1;187;195;133;119;143;777
090226137445;1;197;175;146;103;149;770
077031302116;1;280;102;101;119;114;716
034910822787;1;242;285;264;83;94;968
034168520501;1;208;124;252;71;103;758
069480073693;1;257;180;143;97;64;741
032765170013;1;209;84;96;101;111;601
035785605975;1;217;104;194;82;132;729
079018632850;1;225;177;94;76;149;721
020890442269;1;209;143;159;82;142;735
020090505273;1;279;260;272;98;60;969
098990372505;1;280;181;281;99;63;904
059708631938;1;93;287;124;76;135;715
060536183404;1;234;193;249;80;126;882
098159460560;1;242;280;191;95;92;900
093080956555;1;165;80;162;111;109;627
087308264024;1;220;150;124;94;118;706
067118588075;1;177;264;201;83;84;809
034970738450;1;103;255;299;104;60;821
096189906835;1;141;145;94;86;170;636
093489559253;1;219;150;173;89;165;796
099066920429;1;274;208;258;106;83;929
062320061943;1;117;178;149;77;168;689
058173562740;1;274;179;286;113;152;1004
008419668546;1;244;140;284;53;105;826
093195024339;1;262;209;127;104;174;876
035542472058;1;104;179;192;81;131;687
094476693492;1;232;96;191;96;176;791
094363778587;1;143;197;232;93;50;715
032653921339;1;130;273;113;108;70;694
032884462628;1;85;274;255;79;123;816
029648033122;1;274;224;134;62;69;763
068262063890;1;291;224;297;79;124;1015
065963446705;1;265;247;247;103;154;1016
067039061043;1;166;126;272;98;155;817
062524753231;1;236;111;207;88;53;695
056280341947;1;264;161;138;57;91;711
004343584540;1;247;267;178;105;118;915
031974422436;1;226;129;252;81;117;805
075257854474;1;140;127;215;86;134;702
036993793336;1;190;222;127;91;95;725
050218451412;1;251;131;223;63;112;780
059663442759;1;231;130;277;86;134;858
031054010405;1;160;202;243;50;176;831
006836302770;1;250;114;106;56;130;656
000527181832;1;127;196;251;62;81;717
081029625901;1;213;145;155;69;118;700
093191383160;1;102;101;110;85;125;523
003245859608;1;218;215;120;104;59;716
055538803924;1;94;112;234;98;128;666
080436708229;1;278;110;158;69;51;666
018693977328;1;270;176;141;97;103;787
088906286228;1;87;280;138;66;145;716
076609137575;1;186;92;227;85;138;728
050750472421;1;146;94;256;71;56;623
049652642973;1;254;236;224;91;162;967
026354497277;1;223;171;208;94;134;830
045481424876;1;241;140;160;72;86;699
087063938033;1;90;240;163;56;171;720
000510112726;1;174;197;126;73;97;667
098673663225;1;117;222;282;96;58;775
087783668901;1;211;203;91;94;75;674
041180749782;1;289;267;148;91;124;919
084062402724;1;250;251;274;50;112;937
090344907852;1;281;162;133;97;151;824
039459332033;1;165;177;174;97;78;691
058941197146;1;172;224;204;80;144;824
091032305572;1;249;224;145;115;166;899
097104299302;1;86;129;275;79;80;649
029749282715;1;100;268;231;99;174;872
027608790656;1;149;190;238;72;104;753
001612319766;1;260;252;294;79;64;949
019847607597;1;94;179;155;95;159;682
037180006169;1;262;141;91;52;58;604
010750175667;1;209;171;179;66;134;759
048876099843;1;204;108;164;117;53;646
056241359242;1;82;155;197;98;128;660
003802482267;1;231;206;256;108;127;928
056831522110;1;190;140;172;65;165;732
083528968898;1;216;134;258;64;104;776
012391910486;1;213;154;216;67;110;760
086979271454;1;160;252;194;52;67;725
016589512805;1;86;247;164;68;172;737
099637899850;1;223;241;216;61;99;840
054928755487;1;110;224;253;111;126;824
056871356737;1;283;99;185;111;133;811
045101723114;1;230;189;158;94;137;808
078302925384;1;247;150;194;72;51;714
055095913055;1;149;103;283;61;77;673
019273072039;1;228;168;217;101;170;884
063387384463;1;182;171;158;84;105;700
025754760743;1;155;85;162;57;147;606
077096044505;1;163;277;221;74;55;790
041945980160;1;270;80;154;59;116;679
056040673129;1;119;212;257;108;72;768
058950614008;1;265;192;125;68;155;805
026073789197;1;82;95;128;55;73;433
049083382354;1;119;100;151;97;99;566
098488098365;1;244;169;257;112;145;927
026074241857;1;113;207;284;117;58;779
032530989514;1;97;267;262;108;87;821
033811274766;1;84;126;124;101;99;534
026083317465;1;110;198;191;117;112;728
013832897960;1;226;173;250;89;151;889
058891133115;1;232;180;300;110;140;962
085151928910;1;97;157;102;83;97;536
024717087641;1;155;104;299;116;102;776
034431484868;1;131;168;148;80;97;624
027983404995;1;128;202;129;75;141;675
011201215430;1;202;217;126;107;89;741
080748354393;1;240;105;106;59;51;561
071029948998;1;178;207;222;72;64;743
096361522835;1;164;288;247;67;79;845
050787923004;1;87;83;143;103;65;481
058117045513;1;93;188;105;92;125;603
039671312653;1;201;231;282;120;144;978
058767807548;1;215;92;93;61;176;637
014620926505;1;219;279;208;77;124;907
081228037897;1;206;201;217;67;128;819
021127143591;1;168;256;220;64;57;765
081096306483;1;173;173;165;76;126;713
067207874865;1;104;202;164;81;103;654
023625098089;1;278;167;239;78;75;837
007538955170;1;161;242;178;51;170;802
077179245252;1;246;288;218;59;175;986
054178332390;1;143;253;144;70;81;691
085349657836;1;279;173;132;61;91;736
091706737036;1;222;264;180;116;133;915
077470332312;1;230;259;201;78;138;906
010082673063;1;258;254;296;63;131;1002
072816403623;1;274;282;166;93;58;873
049578846517;1;224;113;237;67;153;794
035653064027;1;85;93;260;95;56;589
079132075537;1;197;282;191;77;76;823
025587263199;1;85;139;138;87;149;598
006117508531;1;200;238;156;64;104;762
079175104172;1;283;109;234;64;72;762
075778770030;1;114;214;230;102;142;802
049129623099;1;120;224;168;93;55;660
046620384335;1;142;284;127;100;101;754
038803581562;1;251;110;142;109;99;711
083310908416;1;151;208;157;98;144;758
075738554929;1;224;283;192;91;141;931
063690792510;1;278;93;190;67;129;757
026838843648;1;234;273;281;99;149;1036
005585563975;1;105;91;113;93;141;543
041467029998;1;225;82;199;86;98;690
058340721681;1;219;278;154;91;169;911
041483208092;1;276;269;162;116;104;927
020642227057;1;181;127;147;55;119;629
050209203281;1;103;81;256;65;153;658
015393855017;1;149;115;125;74;167;630
035580992667;1;102;158;189;106;85;640
046344496304;1;219;162;252;92;64;789
096660714671;1;145;195;283;89;99;811
078303170614;1;204;161;261;69;58;753
075550792714;1;163;133;119;50;89;554
015845721972;1;163;197;298;61;167;886
041942570213;1;219;201;252;54;70;796
032629879183;1;112;130;176;63;51;532
061162831136;1;216;261;161;58;140;836
058578656319;1;206;194;211;111;174;896
027432840331;1;135;85;248;79;56;603
084268629978;1;271;196;195;55;156;873
033779264988;1;238;181;299;108;97;923
071042431639;1;236;92;217;68;156;769
082174632300;1;112;150;109;72;73;516
092487933167;1;108;141;251;92;122;714
003995290848;1;109;259;191;69;129;757
035172105278;1;82;193;300;81;134;790
045783147082;1;206;153;260;91;126;836
029166310859;1;160;240;128;68;165;761
001503415370;1;161;200;148;73;50;632
038866356504;1;99;245;234;58;169;805
018411351911;1;186;140;225;88;59;698
087813867421;1;285;273;146;65;176;945
030364562821;1;280;110;235;87;50;762
087772615835;1;226;262;233;77;142;940
020981822189;1;148;226;160;82;127;743
067181682354;1;129;205;187;119;135;775
055485682365;1;257;225;122;69;117;790
019628825060;1;87;222;147;95;128;679
094293003506;1;245;232;257;102;115;951
062200902520;1;265;181;282;119;118;965
092733644242;1;266;261;224;99;124;974
066984815661;1;269;243;163;110;137;922
089309122152;1;142;100;234;93;153;722
042493775154;1;135;206;199;116;116;772
041414957098;1;292;84;185;75;85;721
053220047910;1;116;115;130;100;157;618
062896690267;1;198;91;270;114;159;832
039399161670;1;142;273;126;116;168;825
022908592959;1;241;225;142;76;91;775
065410008992;1;194;89;170;79;138;670
010951097400;1;250;114;172;56;59;651
023861728650;1;157;202;157;81;51;648
090122281881;1;117;122;254;101;69;663
025614574311;1;175;143;253;88;94;753
039511147400;1;273;203;123;90;82;771
062050136022;1;132;262;189;114;133;830
077791515058;1;211;195;133;91;101;731
059771324137;1;233;99;248;98;85;763
072062349792;1;219;83;170;104;62;638
008375311758;1;195;133;177;69;102;676
006139697686;1;275;197;232;74;57;835
028115020405;1;227;271;251;112;145;1006
052488613576;1;226;83;101;68;177;655
079253816073;1;207;191;252;66;135;851
019822951864;1;152;195;91;64;118;620
059881894777;1;175;188;148;66;177;754
037898276702;1;284;196;146;101;114;841
005796758748;1;239;151;110;92;104;696
096075840864;1;281;195;167;85;144;872
042174494526;1;121;273;190;64;63;711
040497473591;1;184;232;219;78;156;869
098899021250;1;169;197;262;116;95;839
088221318639;1;134;86;174;97;117;608
066868437947;1;90;169;248;56;128;691
003906950746;1;225;262;278;93;92;950
024190473631;1;148;237;135;79;112;711
056679849177;1;173;210;283;70;135;871
021675056836;1;99;172;93;56;76;496
080019533939;1;131;192;173;56;98;650
037339999007;1;153;145;278;79;168;823
036864240636;1;175;252;175;77;81;760
007612125387;1;181;284;252;87;107;911
018924646645;1;166;188;99;120;109;682
027513132016;1;133;175;276;96;69;749
092846806826;1;170;144;255;118;165;852
015909162337;1;289;240;268;101;97;995
058059696943;1;95;104;170;97;103;569
025578467578;1;85;202;136;67;85;575
009963644889;1;283;250;116;63;75;787
057727767575;1;290;206;269;83;108;956
063517209320;1;244;266;122;79;65;776
060225945927;1;174;109;213;68;160;724
038403974288;1;116;276;298;64;112;866
068551646647;1;122;126;152;81;67;548
007620240759;1;280;278;249;117;103;1027
074972484238;1;93;198;109;87;154;641
023274314588;1;268;237;214;51;132;902
006886193987;1;281;171;172;115;89;828
006612865196;1;179;231;255;103;109;877
034801542134;1;263;162;116;102;177;820
019478495817;1;156;218;116;68;112;670
033724018548;1;218;150;162;119;67;716
090275399361;1;267;146;233;73;106;825
004258388737;1;266;194;228;104;65;857
035350535858;1;113;215;147;119;168;762
004725821826;1;215;95;249;64;164;787
025998788917;1;130;147;225;61;112;675
044196661288;1;119;129;157;70;118;593
051162155672;1;223;225;229;69;171;917
060191794224;1;288;154;211;107;87;847
073425122770;1;157;122;190;83;83;635
057997040517;1;219;278;144;111;127;879
031924151380;1;129;105;194;65;147;640
074115594197;1;123;156;118;57;64;518
097838902121;1;121;147;106;67;134;575
001415207155;1;259;277;197;116;77;926
000864545270;1;200;120;259;52;95;726
073318475029;1;133;288;180;116;62;779
057128808582;1;202;214;158;107;81;762
063153765424;1;197;90;264;52;118;721
061223749356;1;122;156;287;61;76;702
080149579907;1;144;178;291;114;108;835
005874915620;1;282;193;192;61;139;867
063508798283;1;252;208;173;83;105;821
064758586359;1;291;245;234;85;173;1028
002427641513;1;232;159;154;96;145;786
041868407536;1;212;231;241;119;133;936
018311193038;1;193;254;191;75;83;796
041056655117;1;209;201;282;78;126;896
071005008300;1;97;121;171;57;150;596
029225771698;1;253;152;92;53;67;617
028926310530;1;147;190;195;100;175;807
013557978798;1;223;272;225;53;61;834
007805794709;1;279;206;246;94;71;896
010356269914;1;201;116;144;80;86;627
033847866921;1;222;256;113;59;130;780
007993203457;1;278;101;255;56;155;845
087790104015;1;261;283;186;59;94;883
068351735978;1;275;138;112;102;125;752
035050096945;1;222;142;256;81;144;845
036580157757;1;242;222;159;52;166;841
032958649719;1;206;116;186;99;89;696
003712614407;1;109;91;254;81;74;609
003720134952;1;262;202;107;109;77;757
080546733668;1;138;257;225;51;144;815
057446536081;1;115;226;288;79;61;769
096365693058;1;206;98;275;95;146;820
002863096717;1;138;158;247;79;144;766
045886872697;1;155;159;264;120;51;749
077995386418;1;116;255;95;59;77;602
068901795820;1;192;147;139;119;99;696
099823341132;1;99;84;137;72;76;468
000805240474;1;144;115;267;103;99;728
004554892495;1;166;119;198;105;67;655
010155805132;1;281;243;142;53;84;803
056908773036;1;237;270;234;92;102;935
004895224948;1;133;209;137;93;165;737
067381452704;1;247;147;284;70;114;862
066085270533;1;283;102;189;106;169;849
099992594333;1;127;228;225;100;123;803
093008851957;1;129;164;237;103;129;762
050598555701;1;83;167;188;105;61;604
067673614893;1;145;179;229;74;172;799
005760802304;1;179;114;182;97;119;691
094668953142;1;218;255;208;83;143;907
057655092893;1;213;182;148;109;71;723
063281891630;1;153;202;258;95;133;841
045992066933;1;222;107;278;79;79;765
016495399809;1;102;210;142;86;75;615
003030780412;1;184;142;203;70;59;658
029112378359;1;276;247;149;81;64;817
089439670298;1;100;94;289;80;96;659
053043782282;1;253;116;105;114;143;731
043688213906;1;122;207;97;60;71;557
084848778598;1;167;229;175;67;144;782
067316414342;1;190;181;185;55;64;675
024642557063;1;116;181;157;76;132;662
002416341415;1;113;122;107;79;175;596
063035348080;1;184;100;234;76;84;678
046103606885;1;146;100;250;75;80;651
053415718094;1;126;168;254;73;74;695
035815385642;1;231;88;134;109;55;617
045618746757;1;159;133;273;118;128;811
097970410132;1;103;125;164;113;149;654
039370008550;1;133;199;179;109;83;703
005089056111;1;243;287;254;54;97;935
047709740499;1;182;201;246;87;128;844
068740661662;1;272;190;276;100;57;895
065453901355;1;121;104;146;104;69;544
036649700745;1;239;100;115;70;149;673
081460608856;1;159;116;137;105;93;610
088316642183;1;91;104;129;86;101;511
033998836178;1;198;236;222;53;66;775
030431273352;1;245;248;184;97;86;860
063960169614;1;139;91;287;53;111;681
003190723848;1;219;260;148;69;171;867
045351527697;1;184;120;158;62;129;653
099553850273;1;200;99;174;108;135;716
046040865806;1;278;162;213;55;83;791
091360211394;1;115;129;113;120;124;601
081685117716;1;282;279;200;92;110;963
079195809248;1;226;105;139;67;109;646
092694367148;1;133;81;106;95;104;519
023357759423;1;167;241;107;54;129;698
009770857725;1;154;93;228;60;63;598
022972424273;1;245;95;123;61;147;671
023281374834;1;269;158;230;79;172;908
092624783758;1;256;97;256;98;76;783
094499783285;1;258;130;261;115;158;922
081929914734;1;105;117;105;114;51;492
072312387230;1;261;93;205;87;117;763
028107928359;1;262;219;105;70;176;832
096182905458;1;240;173;246;105;147;911
048439953370;1;161;164;134;62;75;596
026549689321;1;246;243;277;96;112;974
015710184504;1;135;129;248;83;153;748
012771603410;1;96;114;138;79;77;504
071297877584;1;241;231;278;113;53;916
059723218948;1;172;265;264;95;172;968
046973950076;1;249;259;254;59;111;932
097660203092;1;177;242;146;102;156;823
054692719730;1;201;267;197;67;76;808
063241693238;1;276;286;223;107;114;1006
074695522769;1;258;232;283;68;134;975
026698890095;1;151;93;208;62;149;663
043957123033;1;155;161;228;54;113;711
064944752063;1;171;276;182;90;146;865
083261671438;1;274;96;214;59;58;701
004011228754;1;273;168;227;66;77;811
086904205759;1;221;161;115;53;91;641
071140509386;1;125;274;188;86;67;740
019106000557;1;106;134;289;72;69;670
067080507290;1;252;201;145;118;128;844
027637331803;1;224;93;142;64;55;578
043345311599;1;249;192;108;59;118;726
058134666144;1;290;250;123;67;87;817
080987452242;1;121;231;279;94;139;864
084268367103;1;85;256;275;113;55;784
011231236563;1;230;133;168;100;155;786
007136476273;1;151;237;182;66;115;751
057857448678;1;82;184;226;90;112;694
009268976538;1;257;222;216;55;171;921
000751263829;1;91;191;251;71;170;774
033907941009;1;218;144;97;53;50;562
015922212052;1;162;120;259;104;154;799
065399920612;1;252;234;210;102;113;911
053956745516;1;289;184;112;106;91;782
018323296270;1;212;262;238;69;90;871
050522091135;1;287;188;134;71;149;829
063122461747;1;235;176;159;64;137;771
055885920589;1;284;201;297;97;68;947
007191870588;1;263;286;264;66;132;1011
060161685293;1;238;201;136;112;167;854
067419849228;1;236;88;172;111;51;658
072390332624;1;149;151;222;62;118;702
001145729819;1;124;206;295;108;73;806
046293277184;1;283;93;299;76;96;847
006182701048;1;112;149;181;86;73;601
040886069020;1;243;90;252;94;151;830
023934263598;1;256;96;265;50;91;758
008581479925;1;283;236;122;57;75;773
069582165265;1;100;149;149;89;121;608
058671154753;1;216;196;189;51;165;817
052981819141;1;287;161;230;115;158;951
047415813239;1;245;264;132;93;64;798
087841409903;1;163;173;103;65;53;557
008501971352;1;222;237;133;106;53;751
044082067573;1;242;107;106;114;160;729
086716132744;1;189;262;264;64;170;949
082041078835;1;257;285;278;52;165;1037
036063988146;1;120;174;134;54;160;642
059459541734;1;140;134;139;64;139;616
014355504437;1;272;281;93;72;72;790
066893494556;1;107;185;250;119;112;773
001978656894;1;247;149;144;114;99;753
005851126725;1;217;201;239;62;127;846
029885364454;1;95;126;288;104;127;740
061654588360;1;99;129;287;94;95;704
081956877528;1;149;94;146;73;102;564
072770730683;1;222;137;135;62;101;657
085243944511;1;235;280;117;107;166;905
091215493268;1;282;167;220;66;124;859
089568577800;1;94;269;232;56;150;801
088955240653;1;210;168;295;54;76;803
000753274127;1;222;95;222;84;73;696
073729143832;1;239;183;136;112;177;847
056321403623;1;253;259;145;99;63;819
031860450884;1;168;181;150;101;52;652
054717152358;1;199;190;119;110;159;777
012660234303;1;198;148;112;104;67;629
083222656680;1;179;282;167;74;167;869
067801933065;1;176;221;129;76;114;716
000331992885;1;157;257;209;106;92;821
019939368661;1;112;211;196;75;126;720
019010295021;1;83;95;193;62;124;557
085035813677;1;208;173;284;116;124;905
007833537265;1;188;124;251;99;67;729
089194961721;1;180;207;103;64;130;684
091758922895;1;239;126;122;79;105;671
086322676652;1;232;112;160;113;106;723
016766271399;1;85;102;213;57;169;626
025477936158;1;274;168;181;119;50;792
072066234539;1;278;158;265;67;141;909
033706070838;1;90;123;169;94;117;593
044965703458;1;184;168;195;92;175;814
004093918389;1;166;181;157;68;140;712
051881359313;1;282;108;172;77;167;806
082589547897;1;144;274;106;88;64;676
002765733729;1;98;97;101;110;171;577
070571394909;1;153;188;207;101;52;701
045159832878;1;202;142;116;81;144;685
029278337870;1;175;94;264;65;54;652
097713002754;1;285;106;278;86;72;827
016963847418;1;191;262;133;91;157;834
077292031107;1;151;264;177;59;150;801
082856641124;1;160;178;133;104;51;626
042399968411;1;209;130;208;60;69;676
031509725204;1;186;104;221;60;102;673
026164124346;1;125;106;276;91;132;730
057019520761;1;220;177;114;81;158;750
035444644103;1;204;125;275;63;59;726
026351169603;1;155;85;290;52;74;656
028294131767;1;147;83;136;52;100;518
025823247491;1;144;159;93;92;72;560
054779413576;1;144;245;218;78;135;820
022852299181;1;171;265;122;93;52;703
093994802121;1;82;195;133;52;60;522
095476036691;1;214;276;243;118;125;976
074272980726;1;90;164;181;84;136;655
067774486158;1;188;90;263;72;86;699
075983085457;1;182;260;192;96;122;852
067058488245;1;140;158;284;51;99;732
003105052422;1;283;251;124;61;152;871
069432760729;1;210;125;143;77;80;635
099209243078;1;265;284;256;88;113;1006
057693107288;1;277;164;283;58;85;867
034128200437;1;223;96;188;117;150;774
070177781173;1;247;105;194;118;135;799
036062044725;1;112;202;245;57;62;678
029995871302;1;140;109;187;114;82;632
050981836870;1;129;150;108;120;171;678
000937856606;1;200;148;170;120;133;771
067176628582;1;139;104;279;112;55;689
099678053948;1;257;272;123;112;80;844
089233809521;1;225;207;220;89;136;877
022503687207;1;181;248;180;91;148;848
015655341543;1;235;120;146;57;62;620
036255875358;1;136;287;117;77;127;744
072900642960;1;81;151;241;85;73;631
011726392285;1;117;177;201;96;137;728
082494591700;1;176;80;242;52;61;611
022103486948;1;285;201;108;71;71;736
091195326797;1;83;187;264;89;175;798
052421273729;1;266;94;202;93;144;799
067212800073;1;153;146;107;69;98;573
025017640802;1;278;101;222;109;152;862
023159545638;1;178;255;145;82;59;719
044249721515;1;240;219;111;114;102;786
000273954052;1;216;191;141;76;58;682
001649189619;1;104;143;232;76;133;688
095287368743;1;89;109;216;106;83;603
007247839616;1;270;194;95;77;93;729
033871767700;1;282;131;259;100;105;877
094261243616;1;120;131;274;114;118;757
067789370481;1;283;217;226;52;174;952
067775091325;1;152;245;209;94;123;823
004163949816;1;196;179;293;107;79;854
085128916344;1;272;287;210;106;175;1050
046218799287;1;209;218;210;116;176;929
018591130103;1;102;215;184;82;171;754
017464449269;1;127;274;135;86;66;688
074499606343;1;197;94;91;56;94;532
044075714093;1;159;165;282;54;142;802
025838767857;1;118;228;171;56;56;629
031843084506;1;124;230;103;77;116;650
009830761335;1;136;172;155;86;123;672
086875963773;1;253;228;111;86;136;814
070973175378;1;175;235;272;65;107;854
006148532850;1;214;105;267;97;110;793
068112332341;1;161;288;247;57;106;859
053439470579;1;226;98;249;92;157;822
072030916215;1;172;136;113;52;145;618
022537609263;1;103;207;204;118;144;776
030212022695;1;290;250;99;65;95;799
043919194060;1;290;124;187;71;178;850
006213267941;1;94;275;117;80;173;739
086164617345;1;195;86;152;52;78;563
087953254210;1;234;281;90;91;145;841
055971218974;1;243;85;266;96;95;785
033698529603;1;234;135;96;97;55;617
031944942081;1;125;104;136;87;152;604
015660496965;1;279;191;296;81;142;989
066917875339;1;292;97;241;113;129;872
031611963194;1;177;282;200;110;125;894
047536136794;1;212;132;183;99;62;688
065592442733;1;292;193;198;84;148;915
034054445457;1;202;187;270;79;83;821
050159203375;1;210;241;104;111;57;723
075407264108;1;254;197;224;106;108;889
005584080177;1;254;197;142;94;158;845
039910129299;1;273;274;252;105;151;1055
047312722138;1;135;149;141;98;63;586
027502579619;1;200;81;100;120;148;649
013150553303;1;204;283;250;54;177;968
019095251134;1;150;171;256;53;109;739
064281488691;1;290;247;225;67;82;911
032528039228;1;234;286;248;83;145;996
046707429832;1;289;108;135;80;118;730
011681731194;1;208;154;295;78;115;850
020146887942;1;258;215;200;81;155;909
000168109474;1;82;85;171;88;134;560
013984346809;1;282;143;133;111;117;786
052588459296;1;117;108;298;107;156;786
079417672604;1;195;158;278;87;59;777
025206602896;1;271;136;147;104;177;835
047027496691;1;88;237;229;79;134;767
083202149909;1;125;88;166;98;139;616
033446496632;1;285;256;109;57;173;880
085301913744;1;271;148;118;67;123;727
055278496244;1;145;280;241;51;150;867
048410795668;1;146;169;203;83;95;696
085300178676;1;157;136;146;91;118;648
043826559243;1;185;154;145;114;139;737
022921631392;1;107;187;259;75;82;710
068846225965;1;176;115;279;107;71;748
095801743643;1;269;127;163;106;61;726
008463782301;1;226;172;197;73;135;803
064531875421;1;154;127;120;98;122;621
018526598400;1;283;188;249;63;84;867
072694145266;1;226;236;262;89;91;904
088524770034;1;114;209;101;55;72;551
089187729507;1;171;110;175;76;177;709
006903386277;1;104;237;173;96;153;763
039337925705;1;217;213;169;109;50;758
004692739820;1;127;132;150;89;52;550
074485737662;1;108;190;280;81;80;739
090227338370;1;101;197;133;95;76;602
014485644529;1;143;136;100;80;83;542
081920740716;1;233;182;299;67;95;876
028048552491;1;136;286;201;78;72;773
032118953716;1;190;216;194;75;157;832
006716496078;1;128;239;150;119;58;694
080522004339;1;184;117;134;117;82;634
097260925555;1;268;207;137;102;72;786
059873771066;1;101;104;213;107;117;642
060471898006;1;123;171;273;59;61;687
087341272509;1;190;140;158;103;150;741
045689004180;1;144;106;180;57;130;617
007909427374;1;146;193;138;102;67;646
041496488787;1;164;256;220;87;111;838
061816637255;1;125;188;243;116;67;739
044860817710;1;268;271;285;113;122;1059
082231958265;1;180;155;111;70;52;568
062928570039;1;100;267;141;65;108;681
087677319775;1;230;121;226;98;173;848
097015897904;1;190;172;93;115;161;731
073265707237;1;149;97;134;58;64;502
003020332199;1;119;90;267;89;172;737
042046430595;1;90;153;104;74;108;529
075422235105;1;237;225;200;99;163;924
042170775165;1;147;229;260;102;144;882
098191390116;1;250;232;182;89;84;837
046167975625;1;231;173;235;80;69;788
032441080453;1;86;149;118;81;73;507
012274484200;1;291;101;248;115;120;875
082760874285;1;126;147;264;104;75;716
058132407855;1;273;166;253;114;144;950
013651600564;1;157;244;209;56;104;770
042653342589;1;280;182;274;78;87;901
040626507982;1;83;169;123;109;148;632
084655968079;1;115;174;135;75;100;599
007149507049;1;244;215;186;79;61;785
049017353028;1;278;232;127;98;148;883
027975985523;1;161;266;128;105;78;738
060206157970;1;289;269;272;50;162;1042
081060509964;1;104;250;166;87;56;663
036231671206;1;246;88;180;101;97;712
048118718882;1;141;233;178;104;105;761
047487975429;1;237;259;176;116;139;927
065662040021;1;264;215;131;98;66;774
091928245155;1;166;277;257;82;74;856
097706948801;1;275;252;195;109;60;891
096017670101;1;285;168;161;72;84;770
051536759272;1;273;240;165;84;68;830
008174905580;1;152;225;298;92;99;866
073663089397;1;195;119;175;90;99;678
008667674823;1;260;190;116;94;178;838
009626101664;1;106;161;188;80;64;599
047501207108;1;284;80;156;69;118;707
088055070112;1;121;110;158;66;103;558
000255423655;1;276;121;112;87;131;727
031840984868;1;191;181;172;77;115;736
086072184285;1;234;178;223;66;68;769
011299699573;1;113;220;290;63;85;771
095210751848;1;222;214;107;55;88;686
080154740802;1;262;274;240;64;117;957
078062652818;1;168;227;158;62;156;771
062683771823;1;255;111;198;109;169;842
099629295616;1;134;138;221;70;104;667
079321527649;1;291;284;240;82;124;1021
026416531290;1;122;163;194;91;169;739
037209240260;1;169;162;192;107;155;785
020586683767;1;254;157;144;74;145;774
075793575482;1;122;142;186;67;77;594
064764679152;1;131;171;104;81;57;544
063810072277;1;228;259;257;94;92;930
021079854417;1;105;236;225;77;104;747
083903461573;1;250;245;283;115;145;1038
059252703164;1;178;174;189;85;139;765
077390229640;1;138;272;116;95;169;790
028410016820;1;218;170;126;92;81;687
033328234726;1;275;190;205;112;152;934
084511973030;1;146;153;115;56;90;560
030104916973;1;222;287;117;108;174;908
019342192245;1;104;231;194;69;154;752
065485562118;1;184;204;132;95;145;760
022891427103;1;286;282;227;109;122;1026
077803027961;1;116;167;122;52;134;591
076772767304;1;116;188;112;63;168;647
099361855376;1;238;243;180;90;146;897
008214507406;1;138;280;176;90;108;792
073534983238;1;228;184;184;78;52;726
023196379209;1;100;81;173;117;102;573
049284339738;1;231;154;136;68;52;641
067016287033;1;175;219;274;70;126;864
046274469663;1;101;188;211;81;70;651
011652443425;1;244;240;201;92;108;885
036531235949;1;199;112;114;94;170;689
008028387072;1;179;188;96;50;50;563
020871153762;1;140;257;179;57;144;777
058978496741;1;223;98;257;63;149;790
098806083284;1;185;252;179;91;88;795
047560922401;1;288;139;198;70;152;847
046738722808;1;133;129;286;63;84;695
082043494146;1;270;185;187;107;146;895
030859847174;1;213;205;145;100;147;810
012131306501;1;270;116;97;78;95;656
094059090793;1;240;108;126;63;103;640
087143452012;1;116;168;216;66;97;663
017655090251;1;205;99;252;66;85;707
056663447321;1;249;102;253;93;69;766
032483710198;1;92;262;259;65;52;730
019861908016;1;153;167;139;103;144;706
057801761214;1;258;258;164;57;128;865
077436633669;1;142;201;102;100;93;638
009190111023;1;256;184;101;103;146;790
084650056528;1;125;282;159;85;124;775
031796831026;1;191;239;117;72;77;696
022029366806;1;150;162;257;95;92;756
046004091076;1;209;268;214;83;50;824
056009269427;1;170;154;150;98;111;683
021204262863;1;203;207;237;100;143;890
005772471977;1;139;222;191;92;174;818
061543729835;1;158;259;91;92;163;763
019714368327;1;210;147;202;89;94;742
013810931595;1;273;177;180;77;101;808
011676927539;1;102;256;202;75;137;772
096898839155;1;251;132;199;116;94;792
022151207646;1;104;92;105;104;80;485
030735131907;1;163;242;266;110;96;877
042995227702;1;253;267;284;55;139;998
055770670822;1;207;90;121;106;165;689
028604424402;1;105;88;131;64;93;481
071316876740;1;135;196;129;61;122;643
047721955505;1;100;115;218;95;114;642
065553226949;1;152;236;128;58;68;642
026857580655;1;292;130;240;100;53;815
097878409187;1;170;119;98;120;80;587
004926975932;1;269;218;173;105;135;900
058829002778;1;132;210;179;60;159;740
011471806101;1;224;107;217;110;114;772
008674221958;1;190;127;98;89;80;584
068922074253;1;180;198;237;78;77;770
082863593164;1;116;197;103;63;113;592
093751318705;1;81;169;103;57;149;559
088877826604;1;203;188;215;67;138;811
057282954501;1;88;239;242;111;63;743
076439085016;1;84;243;155;69;131;682
095754206711;1;185;128;278;104;163;858
019820748911;1;222;274;228;55;97;876
051429754019;1;258;226;131;115;132;862
088292569372;1;101;232;176;85;57;651
069980612209;1;219;236;155;102;160;872
039095570418;1;161;264;186;120;107;838
097778146977;1;86;197;288;100;54;725
086967287597;1;101;170;166;106;119;662
076088022205;1;97;134;288;69;61;649
013469720938;1;274;94;238;74;61;741
035082893250;1;201;87;126;69;127;610
036598366820;1;245;244;299;74;168;1030
061508680933;1;195;123;238;92;73;721
004954139717;1;205;265;111;104;105;790
027259474033;1;97;132;250;92;169;740
041948259445;1;266;157;217;60;59;759
038949723282;1;141;213;168;80;143;745
077090197940;1;146;155;123;88;166;678
043881971916;1;132;273;233;104;118;860
040279550313;1;134;175;136;119;71;635
064873547075;1;247;216;264;75;137;939
038094978024;1;81;132;132;83;114;542
090812179125;1;121;109;135;71;169;605
056717026909;1;147;220;142;56;163;728
094231901044;1;216;147;255;108;77;803
022945074338;1;135;108;157;101;168;669
002382696376;1;185;220;167;118;56;746
008609610031;1;108;284;186;97;161;836
044928894838;1;251;168;115;59;73;666
036245065390;1;155;119;260;86;70;690
077981291366;1;204;178;293;77;57;809
086251671670;1;154;109;296;94;106;759
017774922120;1;279;180;170;114;79;822
022261140280;1;231;271;277;94;56;929
044875299820;1;142;241;230;63;91;767
064247679464;1;278;268;167;68;64;845
039447478454;1;273;102;264;100;109;848
026185982456;1;152;259;183;82;86;762
075461890505;1;124;113;266;58;153;714
010218864249;1;258;167;139;111;152;827
032409390337;1;226;192;127;112;98;755
019188628436;1;196;200;294;102;173;965
091504362254;1;91;128;124;69;85;497
096805333702;1;163;271;297;92;50;873
075286378017;1;171;175;90;91;50;577
010665259620;1;111;243;219;85;126;784
020830223105;1;250;240;121;96;96;803
009253665868;1;151;254;142;74;60;681
056241958560;1;99;95;271;78;53;596
009162376140;1;144;114;216;91;80;645
057636985488;1;167;222;247;90;120;846
048607024474;1;83;229;189;84;161;746
090394061031;1;99;211;247;97;114;768
044611807268;1;285;181;280;70;138;954
075092344320;1;242;225;172;79;69;787
074912525500;1;107;199;278;88;50;722
070329297281;1;198;148;277;73;129;825
009929922018;1;111;233;116;76;139;675
048814934992;1;205;264;237;99;154;959
087582912278;1;273;94;129;110;91;697
003007758558;1;210;169;137;114;108;738
076203323667;1;251;202;129;83;149;814
063428867438;1;98;99;197;84;134;612
026118700843;1;222;90;251;88;121;772
008462278045;1;232;132;148;88;57;657
071026845127;1;223;160;115;76;91;665
071441930123;1;159;182;245;63;61;710
025315567655;1;138;143;160;90;89;620
064131979485;1;271;251;290;85;67;964
060048620626;1;259;257;295;115;66;992
032087234856;1;147;239;131;64;97;678
019920461488;1;98;255;98;111;172;734
046312909989;1;134;287;263;78;71;833
022391694424;1;97;98;139;67;74;475
033914048149;1;91;185;134;99;145;654
094907537485;1;90;163;300;79;159;791
015191186907;1;223;110;262;63;115;773
038219245741;1;291;145;145;62;119;762
039810124841;1;181;187;148;119;91;726
034870718740;1;212;122;195;119;96;744
076471546006;1;140;276;222;76;126;840
045824184520;1;215;95;117;83;144;654
049863101048;1;272;183;100;71;135;761
048797690409;1;286;261;242;76;97;962
016917298260;1;111;259;225;97;176;868
046182698923;1;135;161;192;109;81;678
013350827945;1;84;156;247;86;82;655
006773775888;1;202;221;265;91;73;852
072265435108;1;258;251;177;112;132;930
003611892745;1;271;258;258;78;86;951
057188378013;1;183;256;101;94;86;720
078198496857;1;255;184;188;81;154;862
099061630456;1;212;215;243;100;141;911
030577987792;1;221;107;130;101;157;716
048446972497;1;235;254;294;73;121;977
091886629813;1;84;87;262;65;125;623
091476345708;1;189;185;290;64;76;804
086289683212;1;149;178;228;56;139;750
029881247906;1;121;231;200;84;79;715
024020848401;1;283;213;165;87;66;814
083795109658;1;151;242;100;76;92;661
048107053264;1;211;205;190;71;110;787
009922805003;1;99;181;134;100;115;629
067996537965;1;94;215;127;92;104;632
037895714907;1;248;104;290;88;96;826
089543810878;1;143;152;226;113;53;687
071291441056;1;272;185;90;88;173;808
095575426241;1;253;243;184;79;173;932
083340577487;1;280;205;174;71;103;833
061988052636;1;259;204;169;95;63;790
035561545294;1;197;207;97;80;162;743
035824605560;1;267;103;246;97;146;859
027902718057;1;87;243;156;54;86;626
042274051410;1;95;248;129;62;84;618
090601132375;1;185;172;281;78;140;856
036786409309;1;253;176;279;116;55;879
073789082520;1;227;244;248;84;54;857
015036016581;1;172;166;251;66;55;710
043010781224;1;133;110;216;55;81;595
006124633638;1;135;268;281;74;58;816
096036241446;1;248;200;257;93;88;886
025649846278;1;276;268;183;54;110;891
069910794024;1;88;165;244;114;91;702
041313192194;1;281;249;211;58;166;965
077551222993;1;263;171;204;70;167;875
047840900606;1;158;227;145;119;130;779
026392863015;1;290;186;118;89;115;798
008100631306;1;140;122;286;67;56;671
000878013792;1;190;182;137;70;57;636
019833001009;1;119;215;99;52;172;657
095311368857;1;264;116;268;86;102;836
071835014142;1;203;133;195;78;152;761
053004336897;1;191;165;139;56;100;651
030763855353;1;290;247;220;51;109;917
004083266195;1;95;265;155;86;160;761
024058868200;1;157;145;120;72;153;647
060911245137;1;253;186;218;112;141;910
080811292765;1;235;94;100;94;63;586
047364795222;1;82;249;93;62;174;660
028801006268;1;104;139;160;105;106;614
037191932276;1;282;274;203;119;57;935
095442831879;1;168;270;162;97;55;752
059551839146;1;159;226;231;94;70;780
057071652902;1;80;172;198;95;160;705
092603341632;1;241;131;277;109;60;818
075769086154;1;242;175;91;71;172;751
051793221543;1;183;153;103;103;116;658
028726517775;1;124;288;270;119;103;904
016621680275;1;219;157;293;112;88;869
034323411594;1;125;171;107;118;122;643
077546100849;1;138;199;215;62;105;719
098779349134;1;245;120;190;72;74;701
000218975541;1;157;173;204;102;80;716
034170170086;1;274;154;194;81;140;843
024216543353;1;148;214;121;68;136;687
011588436355;1;197;253;111;72;143;776
015473267467;1;107;199;111;111;60;588
005420101173;1;238;117;122;108;169;754
027706951576;1;211;276;144;88;124;843
041543958726;1;152;229;214;79;50;724
088356901843;1;255;138;277;69;129;868
074338262492;1;148;104;264;68;51;635
004120701326;1;274;128;259;57;128;846
025201109860;1;156;146;215;107;91;715
045657424163;1;93;230;135;81;132;671
046075740101;1;227;123;231;56;89;726
038769112277;1;171;229;157;108;134;799
057061026994;1;143;270;107;106;84;710
001846615934;1;238;233;268;72;118;929
070609235944;1;132;271;104;60;87;654
054032218222;1;150;165;131;113;87;646
074328875146;1;89;255;255;102;160;861
000094472190;1;202;198;266;64;109;839
022990166811;1;124;122;233;61;140;680
036930954844;1;123;90;220;68;65;566
020287102125;1;80;282;92;92;160;706
025872362921;1;226;226;203;75;170;900
014099920743;1;215;122;164;61;174;736
072021556677;1;96;236;210;101;78;721
067557728890;1;141;247;152;116;66;722
094036042910;1;232;285;223;61;164;965
045070341293;1;82;262;189;62;119;714
009889371118;1;219;117;229;115;124;804
069531403237;1;201;199;213;118;62;793
040248674422;1;270;201;121;52;53;697
095411167674;1;260;161;92;120;175;808
086289741231;1;113;117;153;79;68;530
074388067805;1;207;208;108;85;99;707
007878992304;1;263;144;300;53;106;866
043446235175;1;226;111;158;71;172;738
088462362817;1;167;223;108;115;133;746
060460434935;1;170;278;94;61;64;667
079346897208;1;186;257;229;91;108;871
010997994889;1;90;84;252;67;162;655
085672395450;1;239;229;275;117;128;988
036823869341;1;182;163;274;77;117;813
016329373347;1;273;162;118;92;148;793
090350677989;1;289;262;211;104;84;950
028016131713;1;223;174;144;60;99;700
004514004869;1;111;81;97;101;97;487
072343097281;1;283;126;188;104;83;784
099059675952;1;187;257;151;105;101;801
055723809625;1;95;81;256;86;96;614
072561695587;1;192;93;142;83;156;666
019022001784;1;158;156;263;100;134;811
054178651561;1;151;112;160;112;118;653
071865142799;1;141;231;227;102;52;753
085683025904;1;120;204;279;70;91;764
051363064175;1;189;248;264;98;69;868
022008233842;1;231;222;216;107;64;840
063319771122;1;187;217;235;111;87;837
013368960995;1;215;93;158;117;177;760
092284283251;1;166;166;227;104;154;817
097225735743;1;233;150;296;63;110;852
035593490347;1;210;103;157;108;57;635
053232171651;1;211;203;214;75;157;860
052531245186;1;210;204;213;93;142;862
094377290591;1;235;109;262;79;144;829
058440770340;1;118;129;177;75;160;659
071037771159;1;104;244;150;55;130;683
015911002697;1;165;228;237;115;92;837
074479737755;1;244;238;275;72;123;952
002355028772;1;290;267;288;61;128;1034
067338130805;1;243;242;112;107;155;859
093412512799;1;234;283;96;90;143;846
063964387914;1;117;261;121;80;137;716
030497170252;1;183;269;148;110;117;827
002719011195;1;216;260;261;52;155;944
005038228960;1;105;155;113;72;52;497
062939293523;1;124;137;231;111;130;733
084229822985;1;174;106;274;92;128;774
047236160278;1;194;135;205;82;100;716
010258150725;1;222;155;189;112;59;737
025179891566;1;86;190;161;100;138;675
053596445844;1;283;284;196;117;51;931
008677816378;1;179;233;219;109;141;881
050291752788;1;246;169;177;66;165;823
050368241197;1;275;268;202;81;136;962
074117634778;1;237;115;277;96;158;883
060333058887;1;231;159;112;52;131;685
061690710433;1;172;96;223;88;158;737
033563928316;1;191;239;149;61;101;741
081970422818;1;167;205;166;53;56;647
039876814241;1;151;228;191;99;97;766
063338935834;1;238;158;104;93;107;700
020711054689;1;289;111;214;56;70;740
019676676078;1;193;217;112;58;50;630
039369242393;1;116;241;154;67;143;721
020037116987;1;167;168;264;103;109;811
046800878694;1;199;82;189;117;80;667
058089084048;1;141;81;263;56;61;602
061193363172;1;210;222;103;64;61;660
038469017480;1;140;195;128;88;151;702
020411635591;1;128;169;282;72;75;726
030776083926;1;117;188;273;66;136;780
001923536650;1;157;129;107;82;122;597
012975529222;1;123;160;274;51;176;784
043922543874;1;188;120;291;108;161;868
070915445029;1;200;231;190;80;61;762
089319686965;1;187;127;208;78;110;710
029269903774;1;236;288;118;52;58;752
042105118333;1;236;142;248;94;157;877
048741191332;1;185;166;136;106;167;760
003572808621;1;206;216;196;117;117;852
025285012713;1;114;225;198;102;94;733
009741601002;1;265;287;213;52;106;923
030623477233;1;101;189;174;99;155;718
016518167288;1;258;110;232;69;137;806
062651146079;1;129;237;136;92;69;663
058001127000;1;112;211;194;84;129;730
004441889133;1;229;250;185;116;66;846
046179367474;1;259;89;195;80;104;727
078446021601;1;216;283;174;116;88;877
037460367334;1;156;122;116;101;128;623
098377101028;1;252;207;286;103;103;951
006422622272;1;268;188;127;103;60;746
066547839611;1;255;192;94;76;131;748
002212379037;1;269;178;226;117;116;906
095976727513;1;196;185;126;99;112;718
069522312657;1;248;97;105;60;110;620
074166579059;1;280;83;250;117;120;850
000983156835;1;230;239;114;103;51;737
028387912765;1;287;112;206;91;62;758
031061164706;1;102;179;185;100;115;681
098606417967;1;130;176;164;79;87;636
080312234779;1;292;111;278;118;127;926
069470672764;1;100;119;293;71;93;676
062645692848;1;107;177;102;89;165;640
049686099828;1;112;132;161;83;129;617
075635534508;1;140;216;205;57;69;687
099250119917;1;117;255;291;72;135;870
056950816468;1;112;237;295;79;148;871
053454363694;1;91;255;141;108;91;686
078309243521;1;278;174;96;91;140;779
068380176912;1;123;263;139;118;70;713
061184056966;1;89;242;101;94;117;643
026932786502;1;158;269;114;89;51;681
021377948956;1;106;236;104;102;112;660
073342576999;1;246;87;290;52;158;833
076663159891;1;290;191;232;68;83;864
073943453544;1;286;164;221;69;76;816
083469536208;1;263;209;99;77;82;730
008748710526;1;248;178;114;104;112;756
096009273673;1;210;186;212;85;115;808
019744394755;1;290;283;276;62;56;967
054558663591;1;105;99;299;104;164;771
030033376459;1;156;233;98;118;87;692
093135232638;1;155;227;114;85;134;715
042761633489;1;84;145;256;101;142;728
008423318302;1;189;173;213;82;102;759
094121069082;1;105;93;214;94;87;593
053739403751;1;250;153;276;54;160;893
046041459471;1;119;266;232;117;113;847
055897126264;1;164;222;131;71;89;677
079585169775;1;88;159;299;83;108;737
016936744709;1;209;140;97;90;73;609
067080036940;1;274;237;98;87;66;762
084404755513;1;278;222;221;86;131;938
099256151854;1;266;161;264;64;79;834
091710929005;1;110;163;279;102;78;732
068045528520;1;116;109;297;111;77;710
033363278692;1;292;139;175;58;112;776
077388135785;1;279;191;248;80;165;963
043907289112;1;90;281;277;102;159;909
034541723083;1;228;122;296;116;105;867
091753248770;1;235;264;182;101;87;869
019891863658;1;169;287;105;77;126;764
092533181147;1;290;245;202;103;112;952
074600537270;1;235;249;167;108;142;901
036593078176;1;231;228;134;118;163;874
050150742725;1;196;216;174;102;82;770
041073398698;1;224;193;263;82;125;887
031513216396;1;236;95;127;81;88;627
031801335795;1;82;234;294;91;75;776
062645884260;1;192;173;275;88;138;866
011262708714;1;198;167;109;116;140;730
091767935394;1;281;252;209;103;95;940
079681157094;1;235;186;259;105;66;851
046811666427;1;277;138;274;56;57;802
036444727469;1;177;90;139;56;143;605
021571685674;1;127;125;103;115;125;595
066988149010;1;100;234;126;88;122;670
024509140708;1;243;124;109;61;96;633
042004657811;1;248;135;182;74;102;741
085231557568;1;191;89;181;78;84;623
040172068914;1;209;164;120;98;55;646
077549590083;1;243;170;120;60;147;740
003739842778;1;253;149;238;119;147;906
099022745826;1;216;204;218;56;51;745
064174701164;1;275;185;254;57;57;828
052644659402;1;192;228;233;105;112;870
086548038642;1;90;262;107;85;85;629
026765075877;1;103;169;140;84;154;650
017213804878;1;262;178;119;98;119;776
092436816671;1;212;184;294;118;173;981
008760074565;1;272;194;298;94;62;920
057100228195;1;203;116;163;116;73;671
094956441871;1;191;253;234;71;149;898
035431530394;1;155;195;172;59;66;647
042637892305;1;247;142;261;103;59;812
030474843043;1;218;215;126;59;63;681
010762931782;1;234;163;220;77;140;834
001439856036;1;114;92;132;104;90;532
077495635507;1;101;163;215;109;73;661
005517904006;1;134;251;218;62;85;750
001034565154;1;147;241;250;98;96;832
031012757635;1;86;281;122;90;77;656
068474926422;1;145;147;299;55;120;766
049953920858;1;260;208;257;61;168;954
066720548627;1;248;222;187;109;68;834
020199284264;1;238;197;229;108;92;864
033422799384;1;112;119;220;51;85;587
047651480341;1;290;243;268;85;167;1053
087077405152;1;244;130;200;98;55;727
020368179420;1;122;141;104;88;119;574
046845938214;1;169;81;282;108;92;732
087477853301;1;261;91;290;85;152;879
087754637008;1;162;219;185;112;149;827
047361902929;1;146;169;224;64;111;714
038682497459;1;141;130;225;105;178;779
049480477377;1;182;192;115;115;129;733
091195040074;1;187;171;216;87;54;715
086344375555;1;182;230;118;90;51;671
010854641166;1;133;282;277;55;88;835
077284034159;1;240;112;186;115;74;727
068184641872;1;163;211;127;58;155;714
029567547377;1;190;195;294;78;157;914
076797059433;1;201;235;147;77;81;741
074657500950;1;275;207;119;53;156;810
090314544133;1;97;216;106;119;152;690
015604297148;1;182;118;221;86;108;715
035330475276;1;215;176;294;89;57;831
065302426714;1;244;133;187;113;163;840
010180235638;1;86;153;259;91;92;681
023258898581;1;129;184;244;88;113;758
040878160906;1;127;90;150;105;127;599
040603423533;1;258;106;162;74;57;657
022538572504;1;171;250;295;70;85;871
013508635103;1;156;223;204;72;170;825
004909612425;1;253;108;288;69;125;843
083994118951;1;167;168;255;73;52;715
087591234890;1;102;270;202;116;140;830
022106760571;1;283;80;131;120;135;749
032197302949;1;116;176;274;82;164;812
099978878658;1;124;193;207;51;101;676
074346448782;1;148;232;156;60;82;678
093889409022;1;101;105;268;89;159;722
022467736336;1;289;89;240;98;176;892
002552794593;1;229;225;173;107;149;883
096811469468;1;249;87;187;69;154;746
019270629823;1;91;178;248;93;50;660
001097854776;1;259;201;124;86;111;781
090496242085;1;286;169;115;100;117;787
078356461826;1;196;100;198;120;110;724
093871576126;1;200;184;289;118;90;881
050682929879;1;133;226;239;62;84;744
067116121721;1;89;274;200;108;103;774
045499313414;1;215;87;177;86;138;703
064437645543;1;176;230;100;95;122;723
005828410167;1;273;92;107;56;157;685
056327661848;1;120;121;203;104;160;708
012080673628;1;222;281;253;93;93;942
030677274753;1;246;130;91;71;120;658
062833012357;1;247;266;174;102;51;840
058169149168;1;197;239;195;54;104;789
063763389093;1;231;190;120;90;59;690
058135754296;1;248;186;94;108;61;697
052886694316;1;180;97;222;78;60;637
026837191463;1;188;263;117;65;102;735
028028031733;1;144;132;241;92;73;682
047793076098;1;278;121;192;59;172;822
077463030952;1;260;205;232;90;102;889
097197565415;1;275;138;105;83;118;719
070563505071;1;286;251;201;119;56;913
050610257842;1;135;239;285;67;173;899
017078006617;1;182;129;146;86;55;598
025826750117;1;264;190;158;99;101;812
051340445555;1;225;149;169;97;162;802
050815151471;1;273;270;179;84;89;895
039686280234;1;117;125;173;73;147;635
096602109818;1;112;188;149;51;90;590
046275530194;1;82;235;268;73;52;710
021002379927;1;258;105;187;92;54;696
069476355011;1;238;205;98;103;175;819
054048825326;1;231;94;166;74;125;690
078171909197;1;115;263;254;80;133;845
089714714489;1;122;214;185;97;98;716
066270579276;1;151;243;258;68;120;840
084035949959;1;146;105;269;74;55;649
094000627708;1;282;129;174;59;69;713
080442251393;1;194;84;136;83;148;645
069713546381;1;157;284;258;96;105;900
043354550844;1;198;201;283;114;120;916
060761654832;1;169;198;176;88;115;746
074128110080;1;162;222;261;70;138;853
023443830364;1;177;94;264;106;137;778
054199250001;1;229;233;178;89;112;841
018376215312;1;115;230;269;84;162;860
002658777870;1;174;160;111;55;166;666
067043376178;1;99;106;197;114;149;665
053616672376;1;83;184;124;77;107;575
039177669399;1;246;161;117;77;161;762
068607474370;1;95;101;277;69;160;702
041166446516;1;177;124;235;107;100;743
007466457066;1;175;246;229;71;62;783
044913965698;1;164;107;224;74;162;731
016504631275;1;290;215;271;56;142;974
017568891592;1;214;140;139;97;80;670
047275523997;1;234;113;280;84;86;797
020888163321;1;155;138;244;67;63;667
086928882922;1;136;209;218;80;145;788
081698563245;1;214;169;206;93;87;769
015993615632;1;185;124;131;74;95;609
022636163524;1;107;255;255;113;50;780
023741765942;1;149;271;297;63;81;861
010016064119;1;188;82;244;99;139;752
036239417514;1;257;105;199;111;83;755
034453957138;1;116;131;258;68;147;720
005078372365;1;291;276;157;110;157;991
064424414723;1;135;182;168;84;158;727
024323417719;1;232;155;270;118;53;828
074987558523;1;174;188;93;64;61;580
074959899428;1;117;101;244;71;178;711
005378196871;1;275;162;257;88;85;867
015051632463;1;196;224;254;50;60;784
035555911907;1;273;200;279;117;155;1024
091154016195;1;164;110;295;115;143;827
086856612961;1;283;182;204;103;176;948
040917437550;1;173;214;269;72;91;819
058899889905;1;250;122;252;101;154;879
078354785741;1;141;81;188;111;89;610
081434764559;1;154;83;238;107;156;738
025343043501;1;287;226;92;52;170;827
052576092141;1;124;276;217;68;62;747
094208812341;1;94;151;285;51;110;691
086422370854;1;232;105;277;79;92;785
067235027319;1;234;98;107;69;116;624
060120961562;1;204;280;227;118;91;920
036976166949;1;267;195;164;97;61;784
073977258806;1;141;206;196;101;150;794
057534594541;1;205;282;139;69;77;772
087539019062;1;146;238;144;96;139;763
007549003219;1;240;222;221;69;119;871
042613709019;1;157;154;135;108;76;630
035943927678;1;271;270;203;114;178;1036
041708379310;1;161;132;102;111;146;652
061881046376;1;174;119;187;100;81;661
051139398226;1;164;220;136;83;164;767
096579193280;1;259;171;220;101;79;830
034296644882;1;235;235;287;105;115;977
063210834093;1;237;130;197;64;143;771
023080812963;1;166;276;167;88;71;768
087171486288;1;261;186;208;70;59;784
023803612016;1;260;248;292;104;113;1017
000039096380;1;105;109;178;101;70;563
080583898133;1;224;110;172;108;59;673
089948487865;1;287;178;286;99;167;1017
067353396134;1;158;262;143;65;56;684
061321771708;1;237;114;98;60;98;607
083697914834;1;147;253;190;72;78;740
049700603214;1;207;212;129;65;175;788
064700334674;1;193;123;182;69;132;699
005248977089;1;212;205;141;71;169;798
019129627615;1;122;149;200;106;109;686
051907135072;1;286;257;123;56;76;798
004398900202;1;239;122;135;59;111;666
070683175156;1;163;270;233;65;95;826
068669660339;1;96;179;173;52;165;665
046302733900;1;185;94;286;74;99;738
001668697079;1;80;161;194;55;168;658
029492943746;1;125;112;261;117;122;737
026365041178;1;193;282;149;52;166;842
085314266016;1;129;156;174;55;54;568
005899829916;1;253;183;119;104;164;823
072845176632;1;134;281;214;69;175;873
015380339033;1;232;215;199;104;165;915
039103006894;1;174;190;129;78;150;721
085076132790;1;197;94;161;82;54;588
006683970698;1;259;227;113;73;137;809
043810031682;1;118;86;133;63;113;513
067930057948;1;146;191;94;62;94;587
038094607735;1;170;246;215;85;125;841
002742557410;1;230;96;179;86;121;712
017841802132;1;175;253;160;81;59;728
080244579596;1;229;224;181;111;69;814
021028664813;1;275;124;220;115;118;852
084156418596;1;96;181;219;114;136;746
071256146901;1;95;94;242;72;87;590
074651520385;1;149;160;210;111;137;767
034111524540;1;134;222;293;52;169;870
067303141219;1;232;223;160;102;87;804
042483141025;1;83;145;236;88;107;659
010394330533;1;247;247;286;118;119;1017
017250378912;1;222;100;243;55;95;715
091696564999;1;184;146;191;80;62;663
007456008631;1;172;264;150;62;151;799
019208612508;1;110;116;211;106;170;713
092784533082;1;124;109;119;54;155;561
016701429872;1;251;284;195;109;158;997
079187051162;1;147;116;188;72;128;651
043628278654;1;139;129;176;92;159;695
054267398229;1;135;155;204;85;131;710
067018816566;1;191;198;168;62;70;689
052388587462;1;280;139;294;56;78;847
023326389470;1;143;229;157;56;165;750
082432106026;1;157;178;132;63;81;611
071134523674;1;146;194;114;91;108;653
065939954438;1;276;149;298;71;59;853
000863282335;1;278;92;157;99;104;730
096224522328;1;158;247;215;94;92;806
057836469979;1;179;168;238;71;151;807
057271389831;1;104;179;94;70;103;550
058432396024;1;186;204;247;109;165;911
073743024834;1;185;265;96;75;155;776
046270131792;1;145;125;267;60;152;749
035704749865;1;139;117;258;62;71;647
056781066359;1;226;190;186;118;104;824
043229494337;1;179;210;262;57;90;798
000765525838;1;99;209;271;76;134;789
077061259025;1;268;278;283;67;137;1033
058995526348;1;94;162;261;61;70;648
087096418354;1;149;141;90;108;161;649
054298912404;1;146;255;181;82;54;718
016825852903;1;176;195;151;59;89;670
053866654047;1;83;190;230;51;81;635
032602493721;1;146;228;275;119;108;876
086406347795;1;286;188;134;111;95;814
020300275618;1;117;163;263;97;154;794
005728558407;1;159;232;144;106;148;789
067997775853;1;253;172;184;103;177;889
066968198698;1;100;168;218;79;110;675
048219351643;1;240;91;263;91;142;827
083704217121;1;200;236;149;63;126;774
058663202139;1;152;200;259;63;66;740
050224322556;1;132;229;205;66;117;749
015165928041;1;197;198;153;112;88;748
070754663220;1;268;283;105;118;80;854
054186062557;1;239;130;206;118;176;869
001445347867;1;262;248;174;52;134;870
015546873787;1;214;99;169;75;148;705
069992198999;1;186;265;298;87;63;899
099067857171;1;172;149;183;91;119;714
056710156710;1;120;252;289;86;142;889
009833690212;1;245;124;282;114;155;920
036844332288;1;190;114;147;109;153;713
032502231540;1;258;242;235;75;137;947
069232345681;1;153;202;149;108;156;768
009872627546;1;146;158;210;54;117;685
003368988220;1;159;111;159;101;93;623
086579469877;1;205;182;262;109;105;863
044579820211;1;87;171;209;58;154;679
095977525446;1;174;225;259;74;109;841
088374503885;1;188;247;283;51;74;843
050011704413;1;260;201;235;57;88;841
004958999521;1;129;227;289;99;175;919
006706675585;1;130;184;283;118;75;790
037332274230;1;277;80;141;76;135;709
086895616805;1;277;130;189;84;173;853
006390812960;1;131;243;260;119;89;842
083545225063;1;118;219;292;100;140;869
098810964811;1;99;202;289;119;77;786
051714563431;1;127;173;248;84;60;692
084568541945;1;194;181;118;84;137;714
052073148844;1;176;92;105;90;135;598
047945296211;1;212;123;213;91;145;784
092463642114;1;128;213;249;110;81;781
045926837705;1;165;126;179;97;149;716
003632229159;1;95;229;251;114;100;789
046818988398;1;116;252;166;115;61;710
058692463818;1;190;283;254;108;77;912
056619142133;1;251;184;163;67;139;804
018046657768;1;288;97;267;62;116;830
065917720894;1;207;277;170;97;76;827
001437617118;1;157;163;192;85;149;746
020997211799;1;234;242;129;106;70;781
085657927089;1;224;85;108;113;133;663
081470297489;1;276;163;105;114;91;749
020949377419;1;211;280;257;61;127;936
062988174577;1;143;237;251;79;92;802
057892227092;1;101;156;268;79;93;697
020837070976;1;115;268;177;63;137;760
044245267772;1;273;116;235;70;95;789
015945155227;1;112;196;274;81;98;761
082336219597;1;90;204;278;69;124;765
052656368369;1;229;140;265;85;172;891
049743963358;1;240;233;223;94;119;909
082642972467;1;208;207;278;99;56;848
010435551310;1;230;268;108;93;73;772
075200848837;1;248;178;183;50;126;785
038715605033;1;232;207;242;84;102;867
063864936723;1;191;108;287;81;163;830
036050612689;1;213;248;94;53;143;751
004629573576;1;160;256;113;79;50;658
054669470496;1;166;242;131;109;152;800
015226398513;1;89;258;169;81;115;712
012618387254;1;106;98;171;70;77;522
000248193753;1;133;105;217;60;70;585
000930495053;1;215;233;94;60;87;689
056749915954;1;239;176;148;103;137;803
038946832488;1;256;276;238;77;63;910
073196173363;1;189;166;207;104;87;753
004927405165;1;180;105;250;89;98;722
051818383317;1;270;258;212;80;85;905
085297404343;1;282;115;122;54;153;726
005859841610;1;195;235;107;108;96;741
042822118796;1;149;143;221;86;89;688
059649536778;1;285;224;163;111;134;917
081046960567;1;202;126;241;94;110;773
026280382539;1;220;152;216;76;156;820
028836352773;1;149;240;132;110;143;774
026712497635;1;149;156;188;61;98;652
069248723056;1;200;165;209;98;52;724
067075672651;1;233;280;256;67;121;957
060124234703;1;161;266;228;91;170;916
047935955506;1;91;96;193;67;172;619
023991171787;1;283;125;193;69;81;751
060994388314;1;277;128;245;64;103;817
026654735084;1;259;188;260;109;67;883
003036060283;1;204;139;154;56;143;696
069823169459;1;182;136;187;96;63;664
018406308822;1;169;202;255;85;96;807
020091732955;1;263;145;205;90;169;872
090674426674;1;96;199;240;99;59;693
017006143668;1;143;188;255;96;161;843
066972530732;1;246;93;157;120;136;752
071239722728;1;84;142;141;69;100;536
096777105168;1;223;204;166;86;95;774
005746938844;1;220;190;195;117;159;881
021702327301;1;219;222;246;105;118;910
014971795045;1;197;96;297;99;114;803
042870135336;1;120;288;241;87;79;815
019542719022;1;284;285;160;58;140;927
043461580841;1;235;185;140;58;136;754
046026540492;1;249;148;224;75;50;746
015526692149;1;276;113;271;107;156;923
058854193208;1;240;211;98;59;92;700
080523139421;1;244;191;141;51;90;717
013858834653;1;152;206;161;93;107;719
054563902212;1;150;217;293;75;106;841
002651851192;1;194;192;105;69;164;724
076753817060;1;188;101;238;74;81;682
084121652307;1;286;110;172;110;56;734
079915596380;1;202;94;154;60;117;627
002830678516;1;112;167;105;86;114;584
030610522100;1;94;272;189;78;63;696
082980375368;1;183;240;153;89;126;791
011495687680;1;192;187;98;108;106;691
058504937796;1;101;81;281;70;149;682
050604682892;1;155;182;231;83;160;811
042564876996;1;106;195;172;56;84;613
032123637717;1;269;167;189;85;109;819
075770868389;1;111;84;102;120;128;545
066555021354;1;282;283;119;97;102;883
084526284039;1;182;153;182;80;111;708
089156731774;1;280;271;283;96;72;1002
064146899659;1;86;244;164;85;160;739
001121354982;1;141;248;140;119;169;817
084722721321;1;227;155;147;100;83;712
075837702326;1;188;286;177;60;84;795
060951125017;1;106;189;121;78;104;598
012785228152;1;236;95;244;109;169;853
008870102371;1;263;200;285;70;92;910
073048373138;1;170;178;155;59;108;670
071868019099;1;254;165;213;60;80;772
019893688755;1;213;186;269;113;165;946
089458955043;1;113;129;124;66;131;563
073276288385;1;211;112;240;80;98;741
038482959026;1;188;89;151;99;52;579
087521813984;1;242;254;156;81;175;908
091802790684;1;129;244;214;50;176;813
001946721303;1;220;219;243;82;137;901
064145834528;1;224;256;198;103;124;905
082112409435;1;125;156;255;99;84;719
089113451946;1;179;119;114;115;158;685
095846512251;1;151;169;112;107;117;656
072456341150;1;264;123;294;109;70;860
098876735538;1;255;168;247;92;127;889
021044927356;1;211;96;161;106;176;750
094108781345;1;127;141;165;103;173;709
099764844331;1;155;163;187;107;90;702
036787959512;1;127;216;254;113;73;783
074086597879;1;227;288;272;111;88;986
039981060359;1;277;204;141;110;123;855
053638777828;1;102;197;220;50;140;709
033215200710;1;107;255;244;74;150;830
098272222615;1;139;208;164;112;65;688
015861941549;1;172;128;277;106;52;735
080310027466;1;244;205;117;86;113;765
091610850237;1;263;215;168;82;129;857
041313360862;1;192;191;178;87;98;746
034126120728;1;265;159;102;55;159;740
021966692530;1;84;135;109;95;90;513
081172157430;1;286;231;272;90;67;946
056176450272;1;151;194;221;104;64;734
000073271903;1;262;184;105;51;164;766
042091517121;1;193;184;295;87;134;893
007216350646;1;113;133;168;72;58;544
076755976215;1;120;280;272;76;113;861
026694220340;1;282;272;115;112;165;946
095821104225;1;220;80;212;99;118;729
015646218190;1;197;92;147;99;91;626
096611732424;1;85;239;197;84;127;732
061873529494;1;120;255;214;52;166;807
034535275283;1;156;95;106;78;169;604
038413693432;1;116;274;167;54;155;766
020062334901;1;117;226;290;66;79;778
019422797286;1;282;219;143;51;88;783
037558096939;1;120;133;270;113;172;808
052719055579;1;181;274;196;60;167;878
014575075925;1;164;288;96;95;157;800
001291256298;1;97;142;102;77;119;537
062555977630;1;204;262;272;98;126;962
055074460259;1;130;181;289;90;73;763
025243984641;1;280;261;92;78;161;872
033327546918;1;114;282;98;74;148;716
087571700215;1;276;242;234;71;144;967
010379387642;1;172;132;204;61;83;652
039237490622;1;174;155;143;97;154;723
007359841520;1;143;187;255;87;65;737
030172961905;1;254;98;229;81;64;726
078417101119;1;191;222;166;78;74;731
021289483609;1;84;122;284;74;104;668
045413679309;1;81;134;148;50;66;479
059264445342;1;111;278;137;115;72;713
050435073609;1;151;158;179;98;168;754
018804900212;1;286;141;216;106;94;843
033900706359;1;89;166;180;94;63;592
022244832467;1;271;113;185;68;175;812
075240800334;1;150;276;289;105;143;963
068441434643;1;133;247;174;95;128;777
077924114827;1;90;231;225;118;61;725
074740358812;1;233;173;136;114;109;765
064403708542;1;155;282;277;119;83;916
018950320710;1;131;267;174;62;50;684
057944529861;1;229;97;146;87;64;623
081730751860;1;210;260;293;97;61;921
094988299006;1;84;181;286;98;110;759
020174098074;1;197;143;136;53;84;613
097474119817;1;90;130;147;105;64;536
041190411602;1;186;103;142;86;57;574
095611862915;1;175;123;294;78;63;733
053165971159;1;205;171;182;105;95;758
017697016136;1;272;133;154;103;158;820
068608478148;1;285;121;138;57;54;655
009876671850;1;191;261;294;90;132;968
042182573776;1;241;273;135;62;159;870
006385057496;1;167;206;249;85;52;759
028944100478;1;228;210;271;83;138;930
090610175686;1;123;207;181;51;100;662
021784565849;1;248;200;116;96;171;831
057801484187;1;184;125;257;51;147;764
038002819792;1;82;87;165;87;105;526
095104930781;1;201;134;128;95;156;714
020557800988;1;215;125;193;116;110;759
050197637129;1;286;285;157;93;68;889
079417344688;1;233;222;222;86;148;911
059870126244;1;264;271;181;74;130;920
064559017515;1;144;172;244;54;113;727
047268687650;1;88;82;175;108;161;614
008905521278;1;154;110;137;55;139;595
042400564648;1;114;146;122;52;83;517
015538865116;1;152;218;212;106;77;765
046318580933;1;100;159;158;54;174;645
078378238283;1;109;271;184;116;96;776
084530085281;1;281;176;262;70;169;958
093980949175;1;124;113;217;98;65;617
022702194132;1;242;266;136;50;61;755
039331037996;1;130;175;283;113;63;764
063292587220;1;248;97;260;104;124;833
044965669116;1;208;286;141;53;53;741
067002505902;1;90;200;164;96;50;600
068101587401;1;169;215;285;109;84;862
042293674269;1;142;140;254;106;127;769
065564780047;1;221;286;108;50;59;724
060337688373;1;273;244;264;105;173;1059
038879813934;1;174;119;106;120;116;635
087884643881;1;212;244;281;71;93;901
022543270341;1;227;116;192;76;74;685
047737733037;1;149;218;279;88;129;863
034173816999;1;249;93;133;112;111;698
038386016026;1;209;269;170;98;103;849
015443392342;1;215;206;228;54;84;787
047031246717;1;180;203;163;95;140;781
001467162514;1;193;158;173;59;111;694
027623537757;1;136;199;163;83;141;722
085478123184;1;116;130;93;95;74;508
098841173503;1;152;236;214;96;167;865
094093444214;1;117;130;232;90;160;729
072390862969;1;267;194;221;70;128;880
014082223543;1;96;82;288;88;108;662
091670094207;1;97;99;181;111;172;660
071381395405;1;146;138;182;51;80;597
066733834124;1;88;124;233;77;107;629
093199246888;1;87;133;219;76;89;604
022884250238;1;215;161;159;82;141;758
011772211167;1;96;198;116;70;131;611
079220510102;1;242;143;291;119;102;897
064093942832;1;136;147;203;86;116;688
062539063757;1;149;283;100;84;71;687
004789308850;1;120;83;268;57;106;634
050397330795;1;241;154;201;85;153;834
090262784464;1;101;200;113;115;71;600
092340434390;1;229;204;149;88;92;762
052298533104;1;144;267;282;86;163;942
089790941530;1;270;85;134;76;88;653
036752869304;1;111;214;265;54;114;758
019507233064;1;145;282;249;90;76;842
019839343857;1;242;204;156;70;159;831
020430685918;1;180;164;300;94;132;870
022251262691;1;113;127;107;113;148;608
060527099276;1;185;179;269;120;177;930
068092706906;1;94;189;103;116;85;587
082228630762;1;274;187;161;117;56;795
065768706514;1;153;221;287;104;147;912
018974200168;1;133;91;215;69;159;667
011734369581;1;245;269;250;113;117;994
068824879454;1;292;266;92;76;156;882
067779012659;1;162;156;154;114;137;723
047409332711;1;92;96;234;55;119;596
007692822427;1;209;85;254;52;60;660
092067910338;1;211;205;159;71;85;731
079992589304;1;171;125;240;88;60;684
096451386837;1;116;147;172;67;145;647
090949808989;1;252;213;111;71;137;784
045942595212;1;83;160;211;99;166;719
029083221752;1;106;233;153;84;160;736
072047883980;1;234;279;169;90;72;844
064918668258;1;200;271;105;104;65;745
027166358396;1;200;183;250;89;54;776
073116878338;1;176;92;217;55;53;593
006131714611;1;282;119;254;50;143;848
036220098292;1;92;131;96;100;138;557
077988105461;1;92;161;269;102;159;783
007019159180;1;238;179;165;71;155;808
079189349926;1;150;281;117;106;124;778
016363023990;1;170;253;247;86;125;881
091077992937;1;88;259;237;89;83;756
014526763076;1;178;151;252;55;108;744
094431477701;1;95;147;300;107;58;707
029977787146;1;262;225;264;79;62;892
000044464754;1;180;276;111;88;102;757
064328753009;1;94;111;279;110;150;744
022264651224;1;238;242;203;63;51;797
080299827332;1;200;226;279;115;177;997
043608995054;1;243;172;180;91;106;792
062612969514;1;182;151;116;84;176;709
029391007390;1;127;221;226;75;113;762
000934369696;1;217;219;270;76;98;880
032902608246;1;185;106;220;120;103;734
000465021626;1;186;106;300;81;151;824
094313238384;1;104;229;251;81;106;771
056534347168;1;263;102;191;104;126;786
093317715292;1;252;175;94;100;52;673
012123228115;1;132;230;243;120;79;804
002398990415;1;221;173;200;51;142;787
068343951491;1;97;215;158;117;62;649
011318683017;1;113;284;189;101;74;761
021463688974;1;194;209;274;55;101;833
096669881459;1;217;131;98;114;69;629
062285180173;1;209;246;188;77;143;863
045986109078;1;249;118;211;55;70;703
005291168721;1;91;233;252;103;52;731
093423728646;1;107;198;251;74;151;781
040130770340;1;89;117;294;120;169;789
046778129954;1;226;235;159;66;68;754
093660357804;1;127;100;283;64;146;720
039737441660;1;264;255;92;78;147;836
010663775239;1;261;87;201;76;82;707
027710429789;1;105;148;192;103;124;672
027833203616;1;206;138;142;92;56;634
085233606720;1;148;256;191;104;175;874
015662809576;1;254;146;199;105;64;768
078708923985;1;173;203;186;53;154;769
024645411778;1;145;112;110;105;142;614
006649702924;1;148;91;159;77;137;612
043894595418;1;269;195;248;94;56;862
022294418225;1;178;266;238;114;64;860
029016169349;1;109;238;113;59;152;671
043749923116;1;251;146;246;113;99;855
044716416157;1;204;129;204;61;64;662
088432210814;1;83;252;107;97;84;623
096168379418;1;167;234;107;87;79;674
025648014964;1;176;246;278;91;71;862
028387234045;1;215;224;177;71;67;754
001036562968;1;184;219;227;69;102;801
040545520932;1;146;258;99;108;54;665
013380257627;1;133;84;176;72;75;540
087789999403;1;194;261;102;65;155;777
002422326588;1;256;287;229;68;53;893
070791152584;1;188;90;111;56;110;555
060543281646;1;187;105;236;75;125;728
019262185611;1;144;218;99;81;127;669
040202884608;1;228;244;262;63;107;904
050728793354;1;107;148;181;78;145;659
049126105959;1;143;271;131;56;78;679
060643494303;1;161;202;98;72;178;711
068351706783;1;204;125;203;51;175;758
057031567294;1;189;141;275;86;137;828
091334010774;1;242;279;265;104;134;1024
089996717465;1;121;183;217;111;143;775
003681677329;1;290;268;99;83;154;894
015740802451;1;219;229;251;56;164;919
005550293910;1;161;267;262;72;154;916
033839020127;1;242;229;285;69;89;914
096727117049;1;116;203;211;84;150;764
055770608088;1;156;224;223;111;111;825
060291550091;1;242;192;220;105;142;901
097137875908;1;126;202;262;71;99;760
058023614356;1;168;113;281;95;143;800
018152801975;1;161;177;267;53;153;811
088546928765;1;284;124;180;105;149;842
000247269231;1;218;170;108;107;162;765
069037381919;1;171;118;193;91;103;676
036418302095;1;113;147;195;77;62;594
081014783485;1;128;158;229;116;124;755
070413632841;1;110;223;204;63;141;741
007612998618;1;187;202;105;67;120;681
007718124701;1;111;137;145;77;161;631
053096898602;1;178;230;182;108;144;842
039756112379;1;108;139;211;68;138;664
005168730498;1;164;110;125;57;93;549
096107357611;1;101;261;117;59;95;633
052398903614;1;173;91;102;82;66;514
075143981450;1;271;223;163;85;121;863
037396187701;1;217;173;246;73;166;875
052425340246;1;110;159;180;110;73;632
089321366438;1;263;115;233;77;72;760
058315060084;1;105;191;226;92;171;785
025035092496;1;166;176;137;67;165;711
096362447971;1;142;195;124;82;85;628
039207303924;1;164;244;222;91;151;872
083018002004;1;257;208;192;56;68;781
016662542553;1;138;287;152;101;128;806
087350364331;1;226;172;182;117;146;843
080542617798;1;272;181;119;74;60;706
019883806227;1;116;89;252;72;74;603
051737903539;1;251;104;123;64;72;614
095475693450;1;232;117;192;97;169;807
050641732173;1;272;189;261;82;99;903
065900630692;1;167;152;268;90;61;738
064905833920;1;153;233;130;119;94;729
009333639858;1;235;214;138;85;141;813
090157951333;1;81;180;238;119;76;694
041601768828;1;118;109;97;101;168;593
035713501703;1;203;105;295;107;169;879
085492508420;1;167;218;295;88;164;932
072909036391;1;263;217;127;103;126;836
026154639482;1;157;238;174;85;56;710
090872507026;1;236;142;175;112;60;725
049951756612;1;261;201;149;50;160;821
040305703740;1;144;218;289;113;168;932
032374372544;1;201;80;241;106;113;741
012588554472;1;226;152;101;55;96;630
043039437114;1;224;130;195;98;83;730
098720607757;1;124;150;244;107;146;771
070503152869;1;238;134;151;78;155;756
084951861140;1;149;147;116;84;70;566
088829815367;1;127;236;107;102;124;696
031021619251;1;86;245;141;118;145;735
015966320465;1;244;177;242;61;122;846
083349203948;1;119;263;145;75;106;708
008126604605;1;253;119;123;91;146;732
093698453655;1;212;187;268;109;74;850
014859248668;1;241;164;293;53;59;810
040594327942;1;176;121;264;77;169;807
074289406712;1;187;244;101;116;116;764
008008178952;1;187;201;196;75;112;771
051028774906;1;273;101;205;51;123;753
043421511849;1;122;241;256;89;157;865
040782344922;1;231;283;138;77;127;856
018174145362;1;290;268;136;52;96;842
038367892511;1;273;213;203;84;63;836
058960290874;1;183;202;142;96;159;782
073461781677;1;102;247;275;117;62;803
003092893335;1;136;175;178;77;94;660
058678470723;1;280;151;286;52;63;832
079392228704;1;124;185;220;99;78;706
090599090616;1;244;231;175;120;65;835
061879319166;1;93;237;229;102;50;711
083703105924;1;150;210;167;61;71;659
033558443428;1;171;111;217;83;133;715
065003844211;1;220;273;218;107;119;937
001243592678;1;245;142;184;99;163;833
036386960570;1;289;126;271;51;84;821
061371667213;1;221;152;298;65;59;795
082177639132;1;166;287;182;85;85;805
063124208442;1;101;224;149;80;64;618
020267408716;1;147;165;173;69;68;622
082931208181;1;161;251;120;71;166;769
018719598746;1;118;151;140;50;64;523
009294645880;1;180;185;228;110;87;790
061705759485;1;84;148;268;76;126;702
016271141344;1;144;240;207;110;126;827
000335263521;1;166;120;135;67;104;592
076333407074;1;181;128;201;57;75;642
002159044017;1;106;209;90;81;117;603
023288762191;1;124;81;184;99;178;666
069792336485;1;185;185;262;55;144;831
092212411091;1;267;183;191;84;110;835
023771300123;1;108;171;113;69;65;526
082120289000;1;191;193;191;73;56;704
083102834528;1;186;98;196;74;168;722
015268114525;1;179;287;231;79;131;907
027415992137;1;82;123;109;99;53;466
060822641224;1;282;178;293;85;106;944
027769034986;1;193;99;224;119;147;782
035906362799;1;205;277;144;99;122;847
092591255253;1;110;98;299;83;72;662
075576916765;1;104;112;187;54;116;573
095814286179;1;208;101;286;87;143;825
026911485855;1;255;275;279;93;142;1044
093802971608;1;192;104;208;97;178;779
035202756878;1;163;182;279;73;82;779
053597679199;1;254;113;286;113;70;836
036564756020;1;239;144;198;81;142;804
026889601144;1;107;156;261;72;109;705
046413492237;1;157;282;218;88;114;859
013329505073;1;84;219;98;71;83;555
060081629115;1;89;218;277;75;109;768
041405815434;1;107;212;96;50;133;598
053655071257;1;89;107;181;82;81;540
061349729790;1;228;93;98;69;64;552
094509156468;1;277;282;109;61;78;807
091967085312;1;291;262;237;97;160;1047
042368396619;1;169;277;291;93;107;937
017661582851;1;206;280;292;88;140;1006
038874451707;1;285;143;193;70;117;808
038016620997;1;144;237;256;97;82;816
006152148186;1;155;137;206;103;93;694
089554711450;1;188;215;268;94;103;868
066759312906;1;197;143;281;111;97;829
021741373711;1;142;123;295;63;166;789
023042509139;1;223;118;247;103;102;793
087924564398;1;198;80;298;54;126;756
011745090016;1;136;99;90;65;65;455
031238756159;1;146;90;95;90;133;554
077219209204;1;285;102;92;53;64;596
068425002689;1;153;102;288;52;105;700
050787278068;1;247;200;101;59;140;747
010945020356;1;273;85;170;79;51;658
064577282850;1;137;141;132;54;95;559
066199461970;1;189;152;240;82;122;785
064308252141;1;99;117;292;82;114;704
074394162709;1;95;266;249;96;72;778
069494344293;1;157;236;95;104;58;650
017559726991;1;213;261;135;85;93;787
034118134310;1;241;275;151;101;85;853
049656957863;1;124;154;109;103;52;542
011949605497;1;219;149;105;86;61;620
031154470879;1;188;97;131;116;166;698
017553436804;1;256;131;274;119;172;952
041021117643;1;207;232;98;77;178;792
051866841438;1;245;215;160;118;129;867
046507944543;1;201;105;103;64;116;589
014106994838;1;136;87;135;80;159;597
046135458999;1;223;98;126;110;177;734
089992452025;1;271;86;290;58;69;774
062756337344;1;183;228;151;61;133;756
069728976633;1;262;109;269;99;126;865
051585805535;1;274;103;248;84;72;781
076980159651;1;181;200;230;54;57;722
071027130087;1;139;156;180;72;90;637
018351724204;1;151;85;131;60;107;534
084295189856;1;247;135;156;109;163;810
070658701103;1;101;112;200;84;120;617
044880142597;1;260;274;138;55;138;865
062869897784;1;280;274;175;99;51;879
057109061310;1;268;176;276;115;110;945
040843389311;1;161;252;255;60;128;856
049470529598;1;247;112;257;90;121;827
029503026594;1;284;186;210;85;58;823
022392280334;1;189;232;210;112;151;894
080474212559;1;252;282;163;104;160;961
031914525363;1;146;253;251;117;113;880
057186195425;1;116;188;164;84;176;728
094456200907;1;238;151;189;104;132;814
010077040963;1;259;90;239;99;106;793
056255289070;1;260;264;108;94;132;858
060857776402;1;215;211;183;76;84;769
037571831992;1;206;206;246;93;65;816
046050555939;1;270;87;279;100;164;900
027400958492;1;134;221;241;113;119;828
021153291479;1;124;220;167;105;75;691
040114941534;1;93;135;281;90;106;705
038100470347;1;251;246;282;71;74;924
059779730695;1;146;116;170;65;126;623
056091614338;1;261;177;125;101;148;812
055905442611;1;272;99;100;103;154;728
014698291738;1;219;241;166;60;169;855
003573532684;1;83;262;114;104;177;740
082948459031;1;267;93;165;57;168;750
059455873660;1;146;205;217;94;137;799
016994804896;1;108;104;181;115;66;574
069692307960;1;237;144;99;90;165;735
090872806420;1;112;90;181;101;128;612
003167066887;1;113;243;293;94;81;824
005764230845;1;99;278;137;96;94;704
037331620559;1;85;242;158;104;142;731
004332011447;1;105;135;286;100;88;714
012193471916;1;118;186;279;83;150;816
050577974766;1;275;245;233;112;97;962
065482751966;1;143;274;212;53;55;737
000958040122;1;138;191;122;85;163;699
095977391974;1;243;268;292;112;86;1001
037261186151;1;118;117;200;115;133;683
012831435741;1;92;139;108;74;59;472
022893487296;1;261;113;211;60;160;805
037975421468;1;249;118;174;94;169;804
004750984307;1;287;85;232;92;50;746
077786940989;1;88;149;289;96;171;793
033925008856;1;245;130;119;94;137;725
075004339120;1;186;178;246;71;106;787
036075485625;1;251;187;122;67;164;791
019112330889;1;244;287;268;89;136;1024
076868022884;1;168;243;93;87;177;768
002998152322;1;195;165;174;89;122;745
091134072632;1;137;185;259;103;88;772
018735710388;1;182;107;181;102;139;711
057828668916;1;239;91;102;68;75;575
047613081151;1;218;242;158;106;58;782
066312581066;1;118;257;233;66;53;727
034676134228;1;215;105;238;109;144;811
045707452181;1;102;251;165;81;142;741
051472458024;1;114;183;278;97;96;768
085048640060;1;205;138;293;119;106;861
056142815366;1;159;212;182;85;87;725
070025554710;1;260;122;292;91;73;838
070233034370;1;227;221;157;56;138;799
057156999133;1;208;239;95;77;109;728
043306943791;1;251;280;134;106;154;925
049867966061;1;145;146;123;95;82;591
099002721721;1;149;172;119;106;147;693
094536229095;1;140;207;272;106;66;791
091179244930;1;231;239;104;80;129;783
045262296602;1;272;156;138;120;167;853
061169830454;1;276;255;216;108;152;1007
021918570627;1;167;81;143;83;117;591
024082165008;1;249;194;288;116;136;983
021101068515;1;178;196;228;96;120;818
022516125961;1;212;268;94;56;72;702
010374463384;1;145;100;147;52;116;560
002562132298;1;105;225;211;70;62;673
006679384681;1;282;221;96;116;64;779
016802358640;1;278;86;154;70;91;679
068676433887;1;164;227;156;94;171;812
002438729115;1;263;213;93;77;82;728
014006664430;1;261;208;142;89;152;852
060746377908;1;259;167;238;94;108;866
065079656137;1;225;163;299;74;160;921
078924344850;1;202;103;198;79;151;733
049157790807;1;214;236;296;113;116;975
063510188855;1;214;267;238;78;59;856
095045358982;1;205;100;134;80;134;653
011629997210;1;107;210;124;99;137;677
010710101994;1;277;133;190;98;116;814
063849202249;1;215;141;258;63;147;824
044613889264;1;128;87;118;104;152;589
041469877185;1;181;111;154;117;136;699
040806945585;1;128;232;237;59;105;761
078704294271;1;191;168;150;54;52;615
012793236935;1;186;226;92;76;155;735
087602357928;1;90;260;134;76;91;651
082650045331;1;197;169;188;91;129;774
012647693114;1;212;288;211;91;51;853
020237687819;1;91;176;231;94;162;754
022312145071;1;118;234;168;91;126;737
075821005631;1;270;163;287;100;132;952
025461932138;1;256;243;162;84;128;873
086205458714;1;127;227;101;101;88;644
091054370275;1;223;141;253;55;50;722
080195274087;1;173;246;230;77;147;873
009145004752;1;183;192;245;113;143;876
065140995523;1;141;205;96;54;68;564
000169977822;1;279;271;173;94;50;867
048530961347;1;110;251;149;102;141;753
075096983190;1;187;91;219;73;95;665
049455261625;1;253;207;210;51;106;827
006870428549;1;102;280;249;119;140;890
099877263708;1;185;173;161;83;80;682
005435712661;1;89;202;212;55;53;611
056444870502;1;264;180;144;93;53;734
052629005715;1;245;196;191;103;137;872
095626791703;1;215;166;252;91;114;838
095211798921;1;137;166;211;71;147;732
006255291423;1;274;102;185;86;72;719
003568643552;1;242;139;296;70;82;829
082769584969;1;224;127;272;115;155;893
020962789697;1;164;255;160;115;92;786
012495827820;1;188;122;203;119;154;786
053348231323;1;157;147;190;72;121;687
048890266198;1;230;112;168;71;57;638
086003911507;1;175;113;244;53;121;706
098680798246;1;205;80;271;73;103;732
094003628967;1;197;100;216;66;127;706
098201504589;1;139;171;216;114;135;775
085138214206;1;279;258;133;100;67;837
057579945006;1;88;103;208;80;176;655
093018236259;1;255;194;282;84;137;952
036317832229;1;286;114;283;101;77;861
098144208253;1;148;95;242;89;63;637
010552463381;1;224;280;217;73;83;877
077898242632;1;255;211;185;120;154;925
001944730727;1;272;121;275;120;57;845
013119623303;1;227;103;194;74;78;676
069268396772;1;210;107;227;97;164;805
082899006712;1;137;98;151;88;55;529
078081006735;1;186;190;168;55;167;766
011497750786;1;123;141;201;111;147;723
010864465876;1;160;255;135;62;157;769
046636437414;1;176;202;252;84;98;812
079675116109;1;142;217;288;72;169;888
027287910223;1;167;141;141;110;96;655
062785313821;1;114;120;279;103;146;762
099900424991;1;216;272;121;89;123;821
059656236440;1;165;142;143;119;81;650
015579644776;1;197;204;187;67;149;804
045268952629;1;134;116;149;100;115;614
025774757049;1;240;227;159;66;130;822
047431576580;1;231;181;142;60;79;693
015787127046;1;251;122;132;78;81;664
038213712509;1;213;192;164;63;123;755
044587560625;1;146;91;268;120;123;748
075424281213;1;242;251;242;90;141;966
088996236632;1;87;189;131;113;71;591
023622507527;1;182;151;246;111;136;826
033526467988;1;202;207;100;60;124;693
028022170378;1;257;215;130;96;76;774
023389061348;1;245;224;238;114;139;960
097954526491;1;187;121;269;113;164;854
007361193967;1;241;91;162;71;56;621
082649264136;1;236;142;159;100;61;698
028403816749;1;241;229;127;95;76;768
052001864354;1;234;285;133;80;60;792
046160059725;1;202;270;196;107;86;861
098805278072;1;280;112;95;119;63;669
051410353613;1;230;88;206;56;113;693
043211636922;1;173;282;264;114;122;955
075724103144;1;232;228;161;57;165;843
043484826855;1;126;232;289;111;132;890
032305202645;1;255;167;119;94;171;806
091029356127;1;241;229;146;93;150;859
026671441446;1;215;102;124;116;50;607
053598840602;1;183;111;232;112;64;702
046679513141;1;143;239;161;72;120;735
025496220582;1;258;119;147;52;153;729
011983718911;1;143;87;127;115;140;612
069372144844;1;95;275;157;120;63;710
015930548688;1;124;97;293;55;143;712
056031767381;1;278;254;103;85;104;824
014288713441;1;226;163;140;69;171;769
039072808581;1;292;286;152;64;75;869
050725085343;1;285;133;153;99;129;799
050464837720;1;105;247;242;91;163;848
085950288543;1;165;186;190;60;175;776
040911004862;1;239;242;139;117;163;900
062346049751;1;178;181;238;117;109;823
066281107037;1;123;180;231;53;119;706
061547678208;1;133;232;225;104;97;791
081607654448;1;181;111;218;97;148;755
050420698459;1;167;235;241;58;71;772
027783611477;1;169;146;162;117;105;699
005398243688;1;88;199;155;93;85;620
021389681060;1;277;141;267;74;87;846
036979774385;1;218;187;190;79;153;827
063977538565;1;287;263;159;91;74;874
094355371663;1;287;239;238;104;59;927
058349024782;1;113;128;93;81;109;524
024099905781;1;260;130;153;89;61;693
007380610391;1;276;244;206;102;60;888
092699640679;1;267;199;144;115;136;861
035182207050;1;242;254;229;62;175;962
066393608700;1;158;95;111;64;111;539
052462754141;1;150;242;241;77;97;807
040393216439;1;128;95;208;74;71;576
000773972082;1;213;173;97;63;94;640
045787523200;1;139;284;131;93;123;770
027387490359;1;220;229;289;107;145;990
080433261490;1;210;193;134;56;110;703
060491871396;1;238;257;155;116;149;915
046368596675;1;122;224;122;61;66;595
082331015339;1;269;108;236;79;120;812
000080433475;1;292;108;123;114;68;705
045704437436;1;214;104;176;63;94;651
007755599077;1;141;277;299;111;147;975
057532070229;1;193;282;177;85;160;897
030650350048;1;133;82;295;88;104;702
078149406676;1;143;166;233;112;68;722
095604736779;1;169;236;180;73;123;781
012107742846;1;167;90;100;50;110;517
030652511992;1;291;259;290;82;116;1038
001802204337;1;257;94;150;106;62;669
093027964239;1;96;117;245;52;142;652
092601757284;1;151;135;296;116;68;766
088591930208;1;261;81;119;93;143;697
004566445517;1;230;185;158;93;105;771
014632709852;1;110;157;279;72;96;714
024957633023;1;291;276;185;88;167;1007
099579585766;1;164;82;260;63;172;741
040020507895;1;146;145;148;51;178;668
026481027681;1;127;252;151;66;88;684
064020032849;1;162;138;119;89;173;681
086761342044;1;281;174;198;70;111;834
025462819479;1;186;81;209;59;138;673
058018721793;1;244;280;239;98;75;936
067945746668;1;92;85;292;114;101;684
012046842303;1;207;97;90;64;117;575
069986637283;1;175;105;174;112;132;698
017219977949;1;102;109;200;96;165;672
050877771301;1;153;208;185;107;144;797
035423118835;1;115;158;176;60;174;683
072741110900;1;200;192;241;91;133;857
037232905687;1;179;266;155;72;134;806
078556224553;1;248;80;188;68;110;694
030550654581;1;105;161;180;120;81;647
089183456540;1;197;133;250;113;66;759
036407567260;1;117;132;122;69;133;573
007950872043;1;159;238;212;83;156;848
062627345754;1;188;98;164;109;148;707
026839760899;1;176;182;97;110;137;702
060042558038;1;190;215;114;75;166;760
055550343336;1;94;270;131;98;88;681
076873318180;1;113;208;164;68;158;711
030107831736;1;147;194;265;106;67;779
092743158354;1;285;170;141;70;70;736
051696317144;1;163;254;234;75;162;888
036748261148;1;290;160;115;101;64;730
010108032137;1;136;85;112;99;119;551
024549307217;1;214;144;163;53;119;693
052198773702;1;84;212;208;63;66;633
052850556043;1;91;288;231;95;99;804
017886632185;1;150;149;175;76;74;624
004290128769;1;224;209;265;120;55;873
046536247309;1;81;182;124;101;98;586
002258127502;1;116;241;153;70;62;642
010721495739;1;98;249;156;54;72;629
024896535866;1;274;94;283;110;74;835
000001740455;1;262;83;242;59;96;742
090392568971;1;168;153;161;69;106;657
092538847771;1;273;226;275;81;65;920
012152024331;1;100;116;164;115;79;574
040866393041;1;236;197;123;73;77;706
093198386134;1;280;258;269;111;178;1096
026634177752;1;207;162;186;115;98;768
006350482431;1;244;232;259;53;83;871
056422849387;1;85;212;225;78;118;718
099438438273;1;110;95;158;54;171;588
022693955945;1;290;172;93;71;52;678
037741381210;1;232;221;287;106;139;985
086906958363;1;163;117;158;59;99;596
063251962000;1;274;197;249;73;175;968
067923390442;1;267;82;225;56;52;682
070882035233;1;250;212;100;77;141;780
093220748797;1;101;209;126;71;134;641
034220295439;1;152;108;155;74;168;657
075122829008;1;282;134;258;85;101;860
065682317119;1;241;266;281;70;92;950
070313556033;1;237;247;99;116;167;866
020059646812;1;149;212;195;97;95;748
050167663155;1;117;271;215;91;101;795
014923550092;1;241;180;165;110;126;822
000219517244;1;148;121;90;88;70;517
062776788003;1;214;218;142;91;123;788
056556054768;1;96;279;132;104;166;777
034165059382;1;280;201;166;112;65;824
020508076700;1;246;179;258;83;51;817
065717061865;1;169;104;190;75;61;599
046699282745;1;128;89;165;113;168;663
017918488512;1;138;206;168;114;151;777
008505055784;1;264;112;274;67;154;871
057716875226;1;98;114;95;73;62;442
009549501570;1;290;257;170;107;152;976
013020335719;1;148;112;294;71;123;748
051497481681;1;151;273;198;71;62;755
016911513365;1;190;91;297;107;119;804
046044211677;1;86;111;248;67;178;690
046620332875;1;198;198;139;112;95;742
062356324316;1;168;283;119;50;123;743
042848395499;1;154;194;224;114;75;761
092973807016;1;211;227;119;79;57;693
063240536854;1;184;104;119;92;144;643
084790762495;1;197;151;206;53;94;701
064149958295;1;277;123;156;103;55;714
000407523116;1;115;127;287;56;85;670
099103056431;1;92;204;216;113;156;781
099129847142;1;266;216;127;71;165;845
018755621418;1;143;232;277;85;70;807
066118205202;1;88;127;213;68;173;669
054649072975;1;224;83;247;79;173;806
014188906452;1;193;206;151;97;91;738
002157406764;1;255;212;248;115;115;945
062936582807;1;196;187;171;100;126;780
068632628859;1;140;149;233;113;173;808
017015645463;1;267;207;125;105;134;838
052256082714;1;185;236;243;79;165;908
046802881291;1;170;275;281;87;90;903
012857740806;1;119;155;112;93;74;553
028260813840;1;263;132;239;97;142;873
085978196444;1;149;132;109;71;100;561
007824739644;1;128;172;198;62;74;634
064623149177;1;134;188;181;77;137;717
004017690856;1;183;158;192;106;73;712
089419848387;1;224;170;242;80;98;814
014758950092;1;139;147;159;113;95;653
018305640652;1;166;111;248;111;94;730
037265925459;1;200;128;237;114;115;794
085365750478;1;88;184;144;95;150;661
023830390283;1;118;270;136;91;78;693
001541690923;1;163;244;263;95;52;817
060828089631;1;243;223;201;77;87;831
065045909228;1;86;124;181;93;178;662
075949988217;1;83;279;267;104;107;840
002435544944;1;164;107;242;113;168;794
092937988270;1;216;255;210;52;95;828
061944579040;1;196;105;121;109;175;706
089591842595;1;175;148;164;113;129;729
035009741637;1;291;162;173;63;109;798
026138722141;1;187;180;154;106;138;765
091161438398;1;197;175;279;101;137;889
073993040378;1;286;84;150;99;86;705
095855947676;1;210;85;196;80;132;703
062452826294;1;275;152;171;66;162;826
000391131560;1;162;244;145;95;121;767
001060363286;1;284;157;94;106;50;691
080872065670;1;151;201;230;100;92;774
008186997829;1;161;81;92;120;168;622
061423646264;1;267;160;271;83;84;865
046357194808;1;170;156;222;113;111;772
075343973130;1;196;206;150;98;71;721
077961416338;1;100;145;237;87;150;719
032225105609;1;93;199;154;58;177;681
089168766002;1;146;189;245;84;72;736
051593201525;1;174;109;256;55;74;668
065529112867;1;263;241;134;114;98;850
066890483550;1;219;172;230;64;90;775
011245285423;1;182;132;249;58;116;737
004508952290;1;240;189;251;114;177;971
036275785196;1;228;254;247;70;128;927
035580495317;1;153;180;189;79;81;682
087571411550;1;198;141;297;63;82;781
005073128671;1;86;90;183;98;96;553
013124536993;1;101;201;223;93;161;779
092494153665;1;285;161;253;55;143;897
041086509801;1;272;252;275;50;55;904
083406942753;1;130;211;117;52;81;591
021779788975;1;124;186;225;105;150;790
011442024371;1;94;178;294;54;175;795
084766855777;1;149;219;296;57;119;840
040764131452;1;224;246;229;93;170;962
074362775076;1;253;208;163;65;159;848
089270018400;1;182;223;228;60;86;779
040602847124;1;175;118;166;110;173;742
056221726799;1;210;260;194;73;74;811
037842881687;1;199;246;139;60;143;787
028517796996;1;284;82;219;101;76;762
074911687210;1;134;231;130;50;54;599
011529155365;1;210;127;179;51;82;649
092060033322;1;123;140;211;79;75;628
083151636777;1;291;244;287;97;161;1080
025745164585;1;259;204;256;77;164;960
043413976931;1;150;273;192;104;132;851
082619166371;1;80;124;276;50;84;614
048788793729;1;86;111;299;116;73;685
041221036523;1;147;173;268;97;137;822
006880715887;1;278;96;165;80;167;786
081368752276;1;93;126;131;66;62;478
011061108424;1;98;209;229;68;129;733
098307127195;1;178;155;299;77;103;812
065286635514;1;210;265;100;108;166;849
068583503970;1;219;218;194;110;136;877
066277273679;1;186;126;107;117;94;630
083154713168;1;145;158;230;119;113;765
003472731175;1;162;283;160;67;128;800
035082176585;1;268;87;121;100;116;692
078657374032;1;249;136;212;113;99;809
032789257512;1;129;200;299;58;138;824
044333236646;1;201;210;283;83;150;927
027473649596;1;192;89;197;98;88;664
025447350895;1;185;287;110;63;167;812
008356819277;1;166;230;187;56;103;742
025122548091;1;243;131;118;85;139;716
037152523949;1;281;196;99;64;110;750
027327571095;1;141;281;227;92;175;916
057272263169;1;160;285;105;115;131;796
090028934799;1;288;204;174;118;126;910
098506960525;1;172;231;267;85;146;901
012483844320;1;194;121;133;57;65;570
056367114574;1;149;197;111;65;104;626
073655856691;1;214;272;297;53;68;904
035637352875;1;144;85;297;111;130;767
012461681556;1;238;191;300;102;164;995
067772798901;1;147;208;259;82;160;856
090276099648;1;254;237;222;68;58;839
008626584485;1;263;257;143;80;160;903
083419046268;1;165;268;269;82;140;924
040085139122;1;193;239;125;58;91;706
081483132976;1;268;116;215;77;79;755
027591546016;1;178;195;273;110;160;916
005909293734;1;85;262;266;52;159;824
092300217713;1;228;95;289;75;153;840
012373731514;1;105;124;111;101;100;541
004163615665;1;168;186;184;79;120;737
098597619061;1;121;103;192;57;158;631
055483528566;1;195;85;100;104;96;580
071765524403;1;209;87;298;88;114;796
054895087265;1;158;140;291;102;67;758
064825896269;1;263;201;208;65;60;797
098963557234;1;87;272;231;94;118;802
016758162226;1;288;167;227;68;134;884
078107970349;1;206;82;187;63;91;629
099960452396;1;121;129;120;64;161;595
004879287280;1;139;237;126;94;63;659
049763782199;1;255;252;187;78;162;934
019919465057;1;156;92;105;86;91;530
044543580251;1;142;222;267;81;154;866
053531110605;1;149;248;240;104;131;872
075254183318;1;276;207;274;79;51;887
069623329722;1;257;196;268;54;150;925
083798193277;1;98;276;287;64;54;779
028887853555;1;190;266;169;68;98;791
068468332342;1;253;233;102;73;54;715
018748969738;1;154;149;246;112;97;758
029541827649;1;120;99;286;57;103;665
014163339598;1;123;90;138;53;52;456
046854678609;1;220;155;159;60;178;772
060773511130;1;193;266;277;96;157;989
046836774543;1;241;107;113;93;165;719
030732983980;1;217;112;225;78;116;748
044332180979;1;287;268;139;74;145;913
078030747994;1;249;85;286;84;171;875
035421085892;1;215;223;147;113;163;861
001563531647;1;148;111;283;97;78;717
072417481560;1;123;106;150;119;117;615
065585193213;1;245;84;192;108;108;737
093732716513;1;186;110;253;78;108;735
045207277803;1;257;160;197;69;115;798
042945864796;1;168;270;204;76;109;827
005313639809;1;244;96;203;101;162;806
058464983420;1;254;87;286;86;84;797
040705392362;1;240;124;276;79;132;851
099345555458;1;177;81;247;67;169;741
094688545359;1;151;93;284;69;108;705
012775586555;1;235;209;280;65;96;885
091365975022;1;289;117;168;114;54;742
085894374325;1;140;100;267;107;87;701
049291597950;1;241;229;139;94;105;808
046160240635;1;122;92;94;119;89;516
039730234025;1;147;219;153;66;164;749
042434297046;1;82;186;126;88;130;612
015485150024;1;279;100;295;89;86;849
021842950650;1;161;140;275;100;116;792
041855320260;1;171;245;298;59;115;888
089711808293;1;117;201;272;62;118;770
081803535188;1;284;93;97;77;151;702
018835761380;1;199;270;210;71;126;876
008873711381;1;141;284;169;99;93;786
052635886992;1;168;216;232;88;63;767
024762645125;1;215;93;159;89;131;687
052999521080;1;187;265;216;76;157;901
036905482103;1;221;274;148;57;85;785
022023862572;1;278;151;217;56;144;846
008127044934;1;133;166;272;100;172;843
090600058167;1;271;126;176;101;88;762
047779341473;1;286;137;94;71;172;760
060808792113;1;281;207;106;120;62;776
013881360351;1;197;211;112;66;72;658
069437620200;1;143;257;130;52;128;710
020658396584;1;284;256;177;93;162;972
051464451845;1;194;256;154;81;172;857
094437419810;1;122;283;170;115;151;841
054755143204;1;82;230;110;119;101;642
063028003816;1;216;274;250;113;95;948
008633521379;1;247;169;171;54;65;706
008075960671;1;241;261;258;111;128;999
072295222122;1;169;199;184;50;50;652
085362992108;1;164;248;235;54;178;879
082434344761;1;136;207;155;111;85;694
049409373325;1;83;231;232;80;125;751
099166245262;1;179;174;253;110;167;883
013821630113;1;207;154;135;64;174;734
047280710494;1;177;89;285;73;60;684
019440103793;1;138;161;216;68;151;734
026632927954;1;120;260;230;104;160;874
039257594461;1;283;166;291;50;104;894
050262844765;1;225;261;264;76;51;877
034319744690;1;247;199;187;116;160;909
057917558851;1;236;231;298;87;144;996
064756362812;1;281;115;152;69;143;760
006687061153;1;241;235;279;76;130;961
056490450531;1;98;259;274;50;109;790
057976236012;1;287;181;256;103;154;981
016433111608;1;216;236;104;108;135;799
004568065126;1;220;238;276;78;167;979
099578479637;1;216;111;107;93;129;656
001716079654;1;274;197;238;63;88;860
094919987553;1;204;161;236;65;76;742
093050590010;1;223;96;211;75;175;780
021441725192;1;270;246;227;111;153;1007
054497189890;1;249;229;265;108;144;995
096631871003;1;166;286;216;93;162;923
006108447988;1;273;240;259;70;158;1000
018059787943;1;269;260;245;118;87;979
014031912366;1;107;226;260;79;66;738
006521153144;1;158;90;234;55;59;596
020654376210;1;211;141;237;113;123;825
053546224510;1;144;83;116;79;170;592
023481451592;1;82;193;149;107;105;636
012213803873;1;103;248;173;101;119;744
015035124494;1;226;195;117;104;169;811
094245267213;1;127;225;97;72;126;647
054683724800;1;97;182;243;60;60;642
010438848447;1;285;80;210;101;154;830
083537866060;1;140;242;130;90;164;766
005153227139;1;255;272;258;62;126;973
008973862587;1;136;147;115;86;68;552
061468907220;1;149;134;116;72;123;594
038429850706;1;264;253;188;59;55;819
033463604162;1;229;163;231;71;142;836
061307870425;1;121;205;92;85;118;621
002035685501;1;284;101;162;76;59;682
065134570270;1;240;114;132;117;61;664
063061631394;1;132;180;97;109;103;621
054534298922;1;277;83;177;89;172;798
085881757860;1;167;123;276;60;52;678
075908503164;1;204;229;282;81;86;882
043804224481;1;91;164;194;82;55;586
001652170046;1;270;132;197;85;104;788
089645302690;1;252;116;266;64;78;776
094339116358;1;247;268;291;63;121;990
090588123514;1;92;192;178;117;154;733
019222325227;1;88;197;227;73;111;696
007921714572;1;187;267;235;103;71;863
022969296129;1;276;156;142;80;65;719
051069668832;1;181;160;98;113;134;686
077650780675;1;174;115;297;73;131;790
054713547345;1;264;195;267;91;164;981
031308654734;1;110;283;210;51;170;824
067162837982;1;97;258;148;85;63;651
017322688821;1;232;99;249;78;151;809
032716594982;1;175;94;268;114;103;754
065324727429;1;257;261;201;95;128;942
097282623637;1;258;142;104;68;61;633
022558273951;1;271;288;123;112;95;889
001351437185;1;283;265;254;62;57;921
083065940302;1;160;135;152;78;105;630
062010188651;1;174;237;134;114;146;805
081678871699;1;101;134;132;94;107;568
003101173328;1;104;194;244;65;63;670
004683095844;1;144;225;91;68;73;601
014862332574;1;190;173;257;53;157;830
019630471887;1;290;174;269;94;74;901
023684391935;1;89;128;123;55;104;499
067055781334;1;225;156;262;79;105;827
098479768828;1;236;126;134;53;143;692
098121720619;1;169;180;277;106;120;852
044432532596;1;211;170;187;61;161;790
085146587775;1;228;84;214;98;162;786
034265968208;1;241;224;228;73;107;873
017460667560;1;244;190;166;106;144;850
065157070103;1;159;145;199;87;163;753
086662074843;1;244;181;172;56;150;803
081393570286;1;180;159;241;104;176;860
073519103190;1;279;225;118;55;92;769
070460701211;1;274;244;195;73;65;851
031620719973;1;254;254;126;72;146;852
036674406360;1;159;180;265;97;88;789
053648078732;1;116;99;197;52;159;623
042936274380;1;199;168;205;96;120;788
055418764888;1;274;111;217;63;86;751
076073199169;1;202;276;289;57;65;889
059493895331;1;119;166;104;119;90;598
098410254254;1;225;87;164;119;150;745
076053852478;1;102;93;141;94;60;490
058635391471;1;141;105;139;73;108;566
045050596533;1;216;116;206;115;119;772
031871942193;1;271;270;227;114;118;1000
086195077155;1;233;191;261;108;113;906
038910320813;1;116;190;175;53;98;632
037537783215;1;236;192;278;74;162;942
091798961354;1;248;262;138;101;54;803
011299042571;1;89;220;232;113;103;757
016972625759;1;290;175;183;115;78;841
046462805224;1;259;228;90;72;170;819
036299323342;1;171;82;264;89;80;686
004245791259;1;85;182;147;76;155;645
041960378312;1;277;201;297;117;51;943
082582694853;1;274;201;277;83;152;987
051964059176;1;201;231;100;87;83;702
010303559662;1;149;163;206;79;92;689
013286676224;1;213;131;213;77;133;767
068400753347;1;170;95;227;76;84;652
046558153131;1;103;198;130;120;114;665
038105253291;1;230;131;139;96;95;691
036252809058;1;292;104;214;86;64;760
023443113525;1;162;194;258;108;171;893
031565359357;1;193;165;142;74;73;647
065131317710;1;263;106;206;83;178;836
075483105152;1;87;86;296;105;68;642
002292013442;1;285;261;185;61;116;908
088240946607;1;136;116;294;108;124;778
092954359816;1;171;271;213;80;121;856
099174179040;1;136;202;171;86;86;681
055313970073;1;99;84;238;112;172;705
061353819344;1;276;259;116;64;87;802
013317055160;1;193;119;184;89;159;744
074866018731;1;106;100;151;67;71;495
055172879504;1;126;247;260;84;121;838
016729755208;1;207;233;217;54;84;795
086649087964;1;94;179;154;50;177;654
036735975288;1;234;91;263;86;155;829
050693357582;1;216;97;228;75;84;700
055741792068;1;248;224;222;114;113;921
028164945008;1;272;144;161;69;163;809
049745868916;1;263;228;246;100;115;952
095230336164;1;103;114;206;60;87;570
031937576642;1;221;244;219;65;136;885
037308896838;1;217;264;296;72;112;961
043925475257;1;282;237;284;90;152;1045
037924028473;1;101;90;274;61;118;644
015018995540;1;241;259;279;93;147;1019
040000572297;1;185;91;107;99;82;564
007834196358;1;208;184;139;58;66;655
064394295878;1;172;97;258;61;128;716
003971465053;1;191;264;232;85;138;910
020139367334;1;185;171;263;120;102;841
054646434706;1;150;81;99;95;99;524
083606958632;1;219;192;249;101;120;881
087140190550;1;234;264;107;118;100;823
062796544705;1;231;96;182;104;169;782
011853674232;1;154;271;211;108;126;870
093544815639;1;97;91;251;120;74;633
015775718746;1;255;118;136;96;116;721
019753967310;1;186;153;91;81;82;593
027944960352;1;257;184;218;103;104;866
052070924681;1;206;164;199;50;119;738
083856854649;1;290;199;152;108;177;926
032132330535;1;258;128;121;76;140;723
017158577740;1;265;178;237;103;71;854
087190621148;1;118;117;90;114;147;586
099111620394;1;117;113;138;89;151;608
016265520105;1;176;283;135;55;76;725
097145584300;1;223;89;132;74;158;676
064661955698;1;216;276;182;73;62;809
043500299555;1;204;175;201;108;125;813
098398183844;1;143;101;292;74;78;688
079522653639;1;265;150;240;120;128;903
007248156114;1;268;199;243;66;107;883
099435957733;1;159;259;139;72;176;805
057057322284;1;258;154;242;105;69;828
033532094650;1;125;89;285;118;176;793
046641366021;1;176;269;142;76;170;833
001946725627;1;285;239;177;101;51;853
066706914610;1;233;107;171;102;150;763
036393795121;1;256;190;280;66;170;962
074055913750;1;108;82;153;60;87;490
020243065545;1;225;84;154;61;69;593
077626129847;1;286;147;289;55;87;864
069162122564;1;222;189;96;120;165;792
010497530952;1;274;266;210;98;99;947
093807800751;1;80;212;114;96;92;594
001854278387;1;112;80;203;56;137;588
043051747873;1;99;80;210;69;99;557
075448508753;1;283;167;109;97;52;708
051847533959;1;108;262;134;101;72;677
031699718175;1;251;277;97;50;78;753
083134550167;1;250;216;145;115;156;882
080056302895;1;287;243;266;55;85;936
020820767395;1;167;226;159;100;104;756
023702209019;1;279;247;207;93;104;930
017588436848;1;153;144;200;113;122;732
062717732598;1;100;133;189;52;102;576
073380698450;1;92;159;264;106;93;714
024937158830;1;152;108;226;61;158;705
058921857301;1;141;170;228;85;80;704
059841043037;1;161;282;220;63;108;834
076176045586;1;123;231;175;79;162;770
038490590414;1;169;179;208;111;67;734
036738851078;1;240;172;212;118;141;883
033209063739;1;220;176;170;89;86;741
032976354253;1;177;207;119;55;94;652
020111958377;1;146;264;173;97;136;816
091798619244;1;105;103;128;93;130;559
070422821041;1;204;105;202;84;118;713
072194398989;1;148;135;171;103;138;695
060749337476;1;237;249;217;53;122;878
015689259299;1;133;148;107;119;95;602
095338573035;1;276;184;181;81;160;882
085738165847;1;192;156;256;102;98;804
090323937038;1;172;246;159;82;168;827
085655104950;1;228;142;263;78;163;874
012346453887;1;234;164;201;109;175;883
035294981585;1;171;282;260;113;129;955
068909630594;1;160;94;263;85;102;704
053260939813;1;224;198;272;53;164;911
074945557682;1;149;155;186;78;74;642
024501629073;1;279;236;145;98;73;831
038947057412;1;178;113;149;88;70;598
094621178989;1;255;205;166;119;72;817
021041930577;1;236;246;222;78;163;945
090089771979;1;176;275;177;52;77;757
073724705180;1;99;128;168;97;61;553
036319463086;1;134;166;193;74;52;619
090672341299;1;291;180;140;101;82;794
073645308061;1;283;120;298;87;132;920
005920064726;1;198;85;292;80;99;754
053806103697;1;109;153;138;118;148;666
097643855060;1;267;163;231;85;159;905
091371499878;1;90;206;241;107;106;750
049646567091;1;120;128;199;113;138;698
012812100366;1;171;219;179;62;130;761
056058107460;1;149;135;273;98;84;739
024206100978;1;262;242;222;73;106;905
038081344627;1;170;211;289;83;122;875
076594154078;1;213;264;118;99;58;752
083706502963;1;266;148;101;99;115;729
066725988473;1;236;256;247;100;99;938
011786540592;1;130;85;128;50;106;499
025637576958;1;114;171;280;73;134;772
068389221920;1;176;191;194;63;172;796
056968794600;1;90;197;291;50;70;698
005152636015;1;279;239;291;67;127;1003
020933770359;1;281;118;162;102;169;832
083081866088;1;140;106;158;60;81;545
074808962482;1;203;200;231;112;65;811
000028464013;1;113;283;132;104;56;688
006371640067;1;80;99;130;102;84;495
099060839332;1;288;267;203;55;93;906
059051049537;1;238;198;291;111;124;962
078726074364;1;214;140;174;59;170;757
000747532029;1;238;214;269;85;55;861
000554267360;1;150;247;180;101;103;781
041826533418;1;165;138;242;91;168;804
048043937969;1;172;199;191;115;104;781
070824878673;1;182;232;270;101;157;942
041971256732;1;211;105;90;104;148;658
056229600038;1;123;115;136;56;110;540
013819290649;1;184;187;281;110;71;833
080718735237;1;238;186;158;57;64;703
090221189812;1;102;104;255;118;164;743
074008026648;1;163;255;239;99;99;855
071589522723;1;237;222;203;104;107;873
056818801596;1;232;207;277;64;118;898
025591758979;1;110;161;264;50;105;690
040122648412;1;109;172;165;101;149;696
021754663516;1;275;226;91;112;71;775
087521909631;1;170;163;243;98;164;838
024676786966;1;236;242;159;105;163;905
054215795425;1;162;271;254;108;58;853
040942392512;1;123;98;132;90;118;561
045096400491;1;176;87;220;105;160;748
054409990909;1;151;161;253;51;89;705
014544328680;1;236;262;208;114;129;949
017905702837;1;209;94;272;117;119;811
048389331900;1;226;218;167;108;166;885
038537163010;1;222;228;95;120;110;775
023133414170;1;86;158;249;75;137;705
076684581284;1;107;283;289;57;105;841
095372282723;1;87;286;238;69;124;804
065370287401;1;122;207;283;62;159;833
028493880316;1;153;254;165;101;147;820
065147652645;1;236;99;209;110;137;791
072972239194;1;134;142;270;116;129;791
091593890516;1;131;145;203;101;81;661
066057277279;1;117;242;261;82;163;865
098544048278;1;80;144;120;59;54;457
079767717605;1;190;155;241;76;149;811
039992190430;1;211;123;130;61;93;618
084457427070;1;210;184;212;99;140;845
086613286339;1;226;119;125;84;110;664
055052421841;1;83;264;176;96;97;716
004811234443;1;235;221;261;109;60;886
002683974409;1;289;269;277;75;75;985
032339103762;1;251;172;146;119;99;787
063947411376;1;115;125;147;73;67;527
073284445467;1;229;126;111;61;152;679
075792472365;1;153;221;132;78;82;666
082552239620;1;211;209;296;103;87;906
044257471070;1;163;189;174;52;159;737
048349646841;1;201;165;246;109;107;828
059615091793;1;119;189;241;117;79;745
054286328722;1;224;153;208;119;108;812
013134415765;1;168;264;224;97;151;904
065551092067;1;92;150;165;62;112;581
021624108428;1;148;286;152;74;88;748
056070988069;1;111;287;181;52;128;759
005577044090;1;174;96;226;97;138;731
062084266118;1;133;245;218;96;63;755
083953529809;1;123;244;278;74;176;895
097379864999;1;168;268;299;64;123;922
053394057481;1;84;113;247;111;132;687
054709938191;1;288;86;176;107;54;711
013113584268;1;172;117;162;83;99;633
074343171075;1;249;200;190;83;54;776
054510849752;1;141;135;168;89;126;659
064292125849;1;185;175;144;110;97;711
030811136784;1;158;278;167;56;178;837
063147428156;1;277;275;273;77;177;1079
066466213024;1;141;160;288;95;99;783
049480979889;1;240;223;197;103;142;905
057743549849;1;213;84;234;95;99;725
028529542946;1;289;187;121;114;94;805
055642669140;1;262;149;115;99;74;699
044291996782;1;166;151;229;65;101;712
041320008992;1;104;225;287;57;56;729
069663829335;1;103;112;228;116;117;676
076702992642;1;225;162;159;74;120;740
048082381765;1;216;127;229;50;162;784
056885523062;1;206;215;96;76;93;686
009015120873;1;164;214;252;118;116;864
075587835379;1;139;148;130;103;161;681
096979485851;1;172;101;165;94;139;671
051880270556;1;279;156;111;73;113;732
046202662198;1;217;146;216;68;112;759
096748924750;1;226;191;175;55;70;717
018489725143;1;122;260;129;52;130;693
050190585807;1;185;143;153;73;141;695
043437722928;1;229;132;170;103;155;789
025979544038;1;183;205;195;98;148;829
039870134747;1;180;284;243;70;163;940
060822489908;1;184;200;236;109;82;811
031190336373;1;80;254;174;93;124;725
057806516018;1;95;180;146;96;113;630
025060638772;1;249;94;132;114;62;651
077441679779;1;208;216;92;76;102;694
078807161029;1;136;245;101;56;87;625
081393648495;1;263;223;276;83;155;1000
085958352515;1;240;111;232;100;71;754
089240063023;1;171;155;269;66;172;833
038342991343;1;171;183;239;75;83;751
095137884671;1;256;252;252;119;173;1052
076674038043;1;264;184;222;73;63;806
069741700414;1;223;134;281;61;119;818
031303946859;1;115;166;134;112;119;646
027545846560;1;136;113;127;53;72;501
040780743510;1;198;113;164;85;80;640
067867384572;1;244;111;95;109;82;641
049343910944;1;240;114;104;86;173;717
020398627860;1;153;259;101;65;161;739
048652369052;1;221;97;256;69;116;759
028503445089;1;109;278;134;73;62;656
025645574935;1;228;85;191;103;71;678
062648449543;1;127;256;281;56;82;802
079352926603;1;125;183;154;116;171;749
005058606770;1;167;162;133;90;94;646
010503314540;1;257;208;190;65;101;821
017516292545;1;215;81;231;109;126;762
060392478640;1;235;247;112;115;139;848
025950038229;1;132;105;153;103;109;602
013164235574;1;171;177;106;101;123;678
075476881242;1;171;214;174;88;115;762
007871064314;1;141;230;255;119;160;905
036421325034;1;265;207;172;86;141;871
032707519879;1;154;152;212;65;160;743
079087784284;1;239;171;142;119;106;777
084917678733;1;218;208;201;66;76;769
033591929865;1;292;149;213;110;130;894
082214406621;1;98;254;143;108;52;655
048414886207;1;85;149;298;52;78;662
084392728398;1;199;163;181;90;114;747
087251131724;1;83;101;96;104;142;526
075631787715;1;238;261;275;76;92;942
065125087216;1;200;226;175;91;91;783
030423697637;1;233;212;190;58;121;814
057668565539;1;148;275;254;65;123;865
099489085368;1;167;118;175;63;152;675
024747438051;1;123;144;251;86;66;670
007237541954;1;127;138;175;109;102;651
014310744172;1;182;130;273;51;66;702
017769726939;1;176;270;247;114;144;951
019580370115;1;249;151;294;113;99;906
022467078211;1;261;219;237;79;133;929
026518293865;1;269;85;151;109;71;685
021124683946;1;237;168;272;67;60;804
069255379142;1;151;281;116;82;93;723
062336975373;1;137;161;128;82;95;603
096280303725;1;158;140;176;62;110;646
098308635707;1;225;247;170;57;99;798
053685842161;1;288;106;198;69;89;750
057318846639;1;283;160;102;55;175;775
071204958354;1;198;211;203;68;149;829
033500058496;1;288;152;249;104;81;874
019863998384;1;114;283;236;93;50;776
070623812059;1;181;88;296;68;120;753
048596649167;1;238;275;182;61;110;866
067675571773;1;261;216;206;83;172;938
092051837630;1;80;280;173;64;166;763
068527923648;1;129;253;219;54;128;783
016178301642;1;247;163;226;94;164;894
042604897639;1;134;172;264;61;146;777
000246871099;1;179;198;221;79;78;755
068306254061;1;248;172;207;111;79;817
076460516204;1;115;221;141;89;126;692
046267689205;1;106;226;156;113;81;682
079942058394;1;146;197;219;79;58;699
033680025148;1;144;134;131;57;92;558
021817352067;1;82;258;125;107;156;728
018002987138;1;182;149;181;50;80;642
038023138047;1;133;153;114;66;130;596
025403910707;1;227;255;113;50;77;722
035096696533;1;224;165;240;112;148;889
052187528015;1;252;139;134;102;110;737
089698568230;1;164;180;98;86;172;700
064170716295;1;283;220;263;120;72;958
055120155103;1;232;148;161;69;175;785
077531371077;1;208;176;291;112;140;927
066055533092;1;223;253;171;73;86;806
082849989780;1;225;195;131;98;115;764
058911677505;1;265;120;133;91;147;756
023317649829;1;290;213;197;101;87;888
094044301788;1;118;287;268;97;51;821
080145357411;1;280;277;129;53;171;910
063079957392;1;210;139;103;120;59;631
053240974327;1;246;95;293;61;126;821
030789793476;1;272;126;255;119;61;833
055570219234;1;157;84;184;100;91;616
048410235309;1;126;214;193;92;165;790
094158554417;1;231;196;255;110;106;898
084279302298;1;289;262;222;61;177;1011
001312460038;1;227;98;153;74;148;700
046634981448;1;149;127;221;74;116;687
013556917687;1;250;252;204;70;68;844
085715327625;1;254;113;272;84;119;842
066965835138;1;144;276;209;113;96;838
041176305919;1;244;225;250;85;169;973
025746535778;1;248;219;205;57;130;859
058696964795;1;137;84;281;75;168;745
085949888726;1;202;196;235;52;98;783
049409047028;1;116;115;295;109;69;704
000759988631;1;243;278;220;94;169;1004
012860241560;1;145;268;230;50;162;855
089085745862;1;217;162;103;117;76;675
054579019339;1;260;174;188;92;54;768
032835663060;1;290;191;112;56;175;824
002845733273;1;213;93;124;108;144;682
031960720743;1;182;169;290;119;166;926
090835490697;1;213;188;260;103;155;919
089900627134;1;162;92;172;110;106;642
071058410298;1;89;184;160;69;137;639
053333608300;1;238;88;199;93;50;668
024516519650;1;224;270;276;89;78;937
045419180062;1;285;213;195;69;137;899
057641851972;1;139;188;264;75;84;750
031942670223;1;160;163;220;55;81;679
051506261445;1;87;258;242;77;101;765
054013288020;1;152;131;282;84;68;717
071193955291;1;218;207;118;118;124;785
094701575284;1;208;104;145;60;163;680
095784449217;1;190;257;240;63;171;921
084331953788;1;87;149;118;99;159;612
000411115343;1;248;94;168;109;107;726
024632103457;1;269;257;256;78;80;940
075088331881;1;106;248;135;97;144;730
065519842955;1;138;209;267;92;95;801
000055938272;1;269;275;169;107;101;921
067623297684;1;173;118;157;105;139;692
053500490182;1;223;235;261;66;78;863
049374064262;1;81;234;124;84;60;583
098612950353;1;238;269;223;79;73;882
022502459233;1;283;118;296;63;100;860
086662304711;1;264;204;126;93;137;824
069361581466;1;261;162;207;104;142;876
078005419754;1;125;253;215;51;60;704
079744638676;1;87;97;244;62;133;623
011688029534;1;117;198;232;69;83;699
081040663231;1;190;157;210;55;59;671
011440707993;1;169;154;123;96;174;716
085140460551;1;248;86;180;102;145;761
054468725992;1;97;167;284;92;142;782
044507632935;1;140;95;137;106;119;597
034991785698;1;203;120;261;100;171;855
096566957872;1;150;100;182;73;118;623
058183227281;1;102;93;220;107;75;597
064638355609;1;280;229;287;79;82;957
003112487483;1;127;262;119;95;162;765
038186788038;1;123;186;114;100;50;573
040860885626;1;189;283;146;120;84;822
010164169217;1;218;160;245;51;55;729
061436973309;1;210;171;199;117;119;816
075481645628;1;102;168;124;91;113;598
067168853189;1;256;230;283;62;52;883
032855479355;1;162;176;209;117;134;798
066642800623;1;249;82;125;109;70;635
012831136196;1;268;239;94;57;88;746
007154141513;1;270;98;107;92;66;633
038771845478;1;89;116;268;105;166;744
099346743750;1;274;141;225;61;129;830
023285320548;1;193;81;297;92;105;768
015145262086;1;204;108;155;60;146;673
074224866514;1;144;284;143;109;129;809
005034624299;1;92;189;243;77;88;689
017414929375;1;185;158;211;111;127;792
014739161476;1;276;180;190;50;170;866
068582504844;1;267;279;269;75;75;965
011602159448;1;236;143;185;83;124;771
024341366653;1;273;236;222;66;81;878
064284567237;1;261;226;185;66;166;904
018835533344;1;229;236;216;78;62;821
084965931078;1;248;151;112;102;50;663
054060196307;1;241;99;91;98;171;700
032202855129;1;238;134;153;64;159;748
002528974497;1;174;278;186;65;160;863
015667481096;1;199;222;232;116;141;910
069870178540;1;193;208;136;62;55;654
037108245925;1;167;92;104;57;158;578
099134628704;1;116;271;181;86;59;713
019378066738;1;245;174;205;72;62;758
083685843707;1;157;89;257;67;148;718
022524143768;1;91;149;274;69;132;715
060478954000;1;113;208;173;83;54;631
090154993994;1;131;221;159;96;178;785
098112866865;1;133;209;247;87;135;811
035701499684;1;154;80;182;55;172;643
001070218584;1;199;258;238;94;50;839
088264557270;1;206;252;129;85;139;811
048040576139;1;104;107;212;93;60;576
094391969692;1;289;233;250;75;136;983
045643665580;1;277;81;272;77;70;777
090422207336;1;207;171;171;86;146;781
099309276102;1;252;250;282;116;83;983
060401176432;1;89;135;138;89;50;501
033947069083;1;273;111;244;89;167;884
064595932900;1;208;280;102;99;76;765
012031641354;1;81;114;237;97;104;633
082629029103;1;136;98;172;112;109;627
060010109598;1;227;202;188;97;129;843
032534925570;1;176;268;269;80;116;909
070707719184;1;173;238;135;94;112;752
044500795461;1;188;133;182;50;81;634
034330116886;1;106;205;157;89;102;659
013638526066;1;220;271;229;96;76;892
019268167639;1;283;214;117;101;67;782
069203255254;1;110;140;101;68;59;478
060071512384;1;239;145;90;56;67;597
035509063963;1;233;239;198;68;103;841
038523555245;1;275;154;214;60;105;808
081838898411;1;105;211;265;73;133;787
054068058232;1;228;250;245;111;161;995
029858645996;1;252;187;184;111;88;822
035652513422;1;160;154;175;76;136;701
084170318732;1;158;210;94;103;166;731
031423245296;1;154;112;240;74;168;748
008788937959;1;155;170;172;84;66;647
023598110166;1;274;280;171;103;93;921
063374054492;1;213;224;113;95;166;811
011100125492;1;227;227;269;100;152;975
079461527741;1;244;164;141;108;91;748
068119091048;1;285;197;118;63;93;756
089800264675;1;87;127;204;108;72;598
038458365733;1;284;104;135;72;69;664
001062383152;1;202;212;232;96;174;916
040807120781;1;162;160;113;89;66;590
012655909495;1;219;100;175;66;76;636
057653793950;1;209;172;275;62;65;783
048315107159;1;190;212;207;59;64;732
070289913504;1;213;143;299;117;93;865
090362154067;1;137;93;258;97;66;651
070413136039;1;181;138;299;108;99;825
014856802481;1;215;265;248;62;109;899
045650986947;1;139;259;92;74;92;656
012579528465;1;80;221;99;109;141;650
061992486841;1;199;243;117;51;79;689
071024449794;1;142;161;98;58;157;616
047400712945;1;122;141;139;91;165;658
028465344185;1;123;181;261;78;156;799
032304422031;1;205;141;251;66;105;768
097996308929;1;126;252;219;79;163;839
045788643517;1;280;83;166;93;72;694
056835690916;1;102;216;93;78;162;651
062327233137;1;230;161;181;84;160;816
096644297720;1;146;239;296;86;98;865
018688598922;1;286;271;222;67;75;921
021622714674;1;84;170;277;119;123;773
098836334434;1;151;225;197;52;106;731
054523420216;1;132;105;99;115;50;501
068520487038;1;139;85;119;90;120;553
040916508664;1;176;116;249;98;144;783
023108912682;1;103;285;295;72;84;839
098923536424;1;183;155;213;114;57;722
010923298359;1;129;86;202;74;166;657
025378850202;1;168;154;122;56;130;630
083773222222;1;220;113;169;110;69;681
078602998265;1;116;86;130;85;94;511
016411236653;1;252;215;288;112;51;918
002583452481;1;247;230;134;53;120;784
042095914343;1;196;101;211;117;84;709
085118319273;1;124;195;290;57;117;783
006394997455;1;98;94;114;80;88;474
088462436781;1;245;269;263;70;140;987
086134514682;1;264;280;294;71;148;1057
073665953062;1;182;287;184;105;63;821
009964644481;1;150;88;157;107;115;617
087378334606;1;188;279;122;118;55;762
034241244919;1;204;275;106;52;93;730
031029295231;1;274;113;291;77;119;874
017989718212;1;265;190;201;99;112;867
006761759742;1;175;261;147;83;99;765
082938723680;1;138;281;265;100;99;883
068168451233;1;187;210;213;73;154;837
058434337785;1;95;112;169;85;140;601
080124655345;1;251;136;294;78;148;907
032705251619;1;106;124;259;82;71;642
037678165237;1;126;136;224;97;167;750
097173487665;1;263;146;172;119;165;865
073793187032;1;182;170;126;75;117;670
006041309445;1;116;98;300;116;86;716
096224555937;1;231;172;213;73;71;760
098879115110;1;83;156;101;52;61;453
043443906009;1;183;211;121;104;59;678
057051160181;1;279;138;91;52;156;716
065262134610;1;123;117;212;67;143;662
046805202532;1;142;162;112;53;100;569
031638231951;1;243;227;229;73;75;847
073276325074;1;148;173;285;89;107;802
066429197379;1;129;260;218;70;72;749
069997025170;1;130;149;296;53;52;680
007232748232;1;169;276;247;50;51;793
046530066614;1;152;156;197;73;60;638
099557147053;1;102;117;300;64;131;714
044425886321;1;95;231;106;117;157;706
081222773996;1;291;193;205;103;128;920
010857110611;1;127;82;245;82;99;635
052041174308;1;142;177;161;114;151;745
007043573480;1;118;93;113;70;75;469
098601110739;1;191;284;256;116;90;937
067549444048;1;240;170;140;116;74;740
066299968811;1;159;139;186;85;158;727
024211838426;1;126;126;109;64;113;538
081045564911;1;156;225;154;72;109;716
051587286828;1;226;87;298;118;117;846
044429266866;1;260;165;127;112;107;771
005231987441;1;122;86;283;103;148;742
085767616757;1;193;286;172;76;114;841
052620747903;1;119;190;224;95;111;739
034623530876;1;166;110;262;86;161;785
086606254225;1;200;288;219;87;63;857
072461374977;1;107;275;179;119;142;822
018859132985;1;154;248;218;61;154;835
009017070784;1;86;257;187;88;105;723
054611349771;1;214;115;164;119;177;789
007235018685;1;95;206;195;104;86;686
095191146921;1;277;225;104;105;153;864
060245274465;1;184;87;216;57;136;680
033748928503;1;181;145;173;84;71;654
034508695640;1;251;276;248;83;162;1020
042827279425;1;105;208;249;74;74;710
030713815466;1;102;126;230;99;109;666
096116376573;1;285;83;129;101;138;736
018324574087;1;204;176;157;50;64;651
066999072658;1;268;285;186;101;157;997
064088763567;1;115;253;196;54;141;759
076551105469;1;242;85;169;98;166;760
081961981791;1;156;160;211;69;177;773
097116944308;1;156;114;259;75;106;710
089976358623;1;115;86;124;58;86;469
067751647858;1;264;125;229;54;106;778
009879033194;1;138;121;190;78;113;640
027648120552;1;112;105;246;53;98;614
004078684206;1;127;162;163;79;92;623
054602530003;1;133;188;272;120;89;802
007778889570;1;150;140;113;91;129;623
034425816349;1;291;213;132;61;91;788
090829208286;1;86;122;295;106;102;711
097768837283;1;84;229;210;99;159;781
095496128804;1;109;282;130;63;72;656
096876626880;1;162;183;300;117;147;909
085568350945;1;179;215;238;116;160;908
068303814143;1;147;246;169;95;127;784
071468951235;1;238;93;219;70;177;797
059706175426;1;212;84;97;79;170;642
035459966604;1;200;199;290;71;62;822
080337971705;1;226;133;103;117;147;726
083659143847;1;172;141;117;61;73;564
093027462111;1;168;80;108;109;89;554
007299976578;1;106;198;227;89;86;706
049253252965;1;132;147;103;106;95;583
035904994681;1;125;271;286;86;159;927
023553080632;1;95;120;259;99;149;722
012043266951;1;289;252;255;98;107;1001
006369016675;1;272;206;96;100;70;744
051447325647;1;164;185;202;113;62;726
088717411237;1;140;159;126;65;59;549
029501747383;1;271;126;274;103;86;860
045002013757;1;181;150;257;120;63;771
031156566492;1;137;88;240;67;147;679
078263905415;1;274;220;272;91;138;995
064398750469;1;154;157;169;83;99;662
007599778551;1;218;140;209;67;165;799
047493172579;1;277;243;114;81;117;832
088634258188;1;235;167;252;120;107;881
012863194181;1;92;287;115;76;99;669
061671494867;1;130;159;100;111;150;650
080853887295;1;81;129;225;91;154;680
078613008403;1;157;89;268;96;124;734
095043227119;1;286;244;216;94;71;911
042387238159;1;177;226;139;57;131;730
057615462366;1;190;190;120;96;153;749
081288595877;1;170;214;268;90;86;828
004084539217;1;165;247;220;80;152;864
028862963485;1;182;108;176;69;55;590
094060546677;1;160;106;160;78;151;655
072272653216;1;80;194;232;80;123;709
078127251936;1;177;264;219;120;57;837
035926485645;1;211;260;100;60;111;742
095708584735;1;202;133;130;113;159;737
052491613481;1;85;240;268;55;132;780
088362641499;1;242;287;195;107;51;882
068310241576;1;289;264;213;64;116;946
030616168982;1;110;197;104;75;169;655
067686847346;1;146;123;273;98;127;767
043257494227;1;285;101;176;97;59;718
031549156456;1;277;173;166;115;130;861
029243212553;1;221;109;112;62;57;561
075164487443;1;211;267;152;72;114;816
071595919423;1;218;115;294;114;133;874
086989568360;1;254;82;288;67;106;797
025248000252;1;109;209;291;63;120;792
082371270231;1;149;104;103;104;73;533
040219130186;1;218;285;197;90;86;876
014613780348;1;156;153;96;88;68;561
024486370550;1;233;172;249;61;50;765
050678619088;1;203;281;173;71;86;814
030490635550;1;210;278;131;104;167;890
091252973295;1;131;170;136;73;140;650
091312653457;1;188;192;247;65;81;773
000954684173;1;146;167;228;87;72;700
098744768296;1;114;197;106;73;92;582
094772997670;1;263;250;228;115;90;946
070230547071;1;200;182;261;70;170;883
076667801799;1;192;157;120;103;126;698
053574700632;1;254;255;227;74;98;908
050881876980;1;170;139;224;53;157;743
038336709504;1;177;99;115;92;130;613
075015744734;1;285;109;186;82;114;776
021201303296;1;127;163;145;119;173;727
044985777007;1;248;156;92;94;168;758
024231837502;1;85;237;101;89;125;637
070089181511;1;219;186;248;81;130;864
001388194622;1;170;137;127;100;83;617
010551937168;1;153;101;195;70;69;588
018681700060;1;143;281;296;77;102;899
015072380527;1;149;164;248;102;73;736
054389835374;1;147;280;183;118;69;797
050928465458;1;145;168;255;51;167;786
084786020920;1;103;252;239;100;52;746
093479569393;1;255;98;171;63;165;752
046982727811;1;127;117;173;52;92;561
014284790197;1;153;244;264;50;170;881
065678599739;1;82;230;290;100;89;791
090108762040;1;261;183;243;100;77;864
049625530714;1;273;128;102;98;134;735
093260042711;1;192;288;277;90;56;903
011113833523;1;259;196;185;105;103;848
010025268959;1;229;98;145;107;59;638
060192587954;1;236;271;136;120;84;847
057153492902;1;262;253;243;63;100;921
022809050600;1;253;249;289;113;83;987
062108268602;1;116;139;241;116;101;713
004581300700;1;169;89;263;82;96;699
095775272991;1;227;143;258;51;87;766
045709301669;1;195;257;282;68;106;908
045852596977;1;234;287;163;79;173;936
016207309573;1;166;161;105;82;133;647
067207448602;1;248;188;188;79;164;867
000013411659;1;245;203;225;68;96;837
073057621720;1;280;207;211;69;121;888
096051267970;1;198;82;292;91;71;734
012180476351;1;210;148;256;112;132;858
050045418929;1;173;265;229;84;175;926
081728878325;1;164;245;229;58;113;809
054410272066;1;250;259;116;84;59;768
071965419756;1;249;256;288;119;171;1083
089289695459;1;120;179;258;52;130;739
059302495153;1;80;231;233;112;86;742
086641129426;1;290;196;281;101;139;1007
041356663770;1;270;135;90;69;88;652
087789534640;1;215;119;217;53;109;713
038173404679;1;141;164;283;100;164;852
059644346042;1;175;106;108;54;154;597
082077304550;1;140;113;291;78;154;776
025521082256;1;80;279;147;84;64;654
003929041813;1;206;183;201;52;116;758
044728588311;1;105;225;220;111;145;806
007347179090;1;271;247;249;114;125;1006
012954587021;1;180;185;225;55;166;811
073365755306;1;285;154;178;51;58;726
091326337484;1;262;198;106;60;68;694
089290045965;1;185;80;90;52;173;580
073536210826;1;212;109;261;108;104;794
052010113226;1;243;165;156;67;155;786
090157653269;1;124;152;197;66;54;593
014443632149;1;172;96;255;102;85;710
092396104028;1;231;195;121;96;166;809
094996396863;1;171;256;289;99;161;976
063844794320;1;183;173;160;102;51;669
070741185075;1;116;101;226;71;55;569
075093243132;1;108;216;186;70;172;752
007615182289;1;223;279;277;64;134;977
080192136409;1;135;219;100;55;60;569
014137394870;1;272;167;178;98;92;807
074107216505;1;273;136;284;88;162;943
069869588272;1;138;88;210;92;104;632
025882299551;1;224;103;298;109;70;804
019409554278;1;159;259;213;106;62;799
002414928322;1;263;156;151;71;156;797
000992874741;1;164;107;203;57;101;632
098937030019;1;230;182;105;50;117;684
018253549757;1;101;121;211;82;108;623
000155088812;1;180;89;285;106;77;737
001076690291;1;128;212;157;59;156;712
004236079202;1;207;127;194;58;53;639
041358871954;1;108;234;298;84;150;874
041948361734;1;142;163;285;96;94;780
005960511537;1;108;212;118;118;138;694
007624242513;1;237;110;223;56;136;762
022247503393;1;122;185;192;104;100;703
029289826227;1;163;178;253;115;155;864
007095724042;1;155;98;251;73;168;745
006182451918;1;239;286;183;90;144;942
089185170526;1;263;210;237;68;115;893
063557035625;1;190;119;258;79;177;823
054126691996;1;241;168;219;110;127;865
082109700155;1;124;249;112;78;72;635
021456569758;1;176;231;263;57;145;872
042342549194;1;277;106;178;91;132;784
007207107486;1;132;119;161;115;82;609
053400939256;1;279;275;278;116;81;1029
036344225525;1;176;141;115;89;169;690
097191284138;1;168;185;224;81;144;802
028425758360;1;276;253;141;57;119;846
097756562015;1;202;233;237;50;133;855
092444209955;1;130;264;160;110;125;789
099908923229;1;175;88;110;80;78;531
006957770851;1;97;162;257;117;139;772
051118641545;1;225;105;201;83;64;678
094557438892;1;154;243;178;57;77;709
027443824755;1;181;84;237;99;84;685
007053622072;1;218;106;178;111;153;766
068889744851;1;158;202;103;106;153;722
005905022753;1;85;124;268;65;65;607
054626761184;1;263;275;225;60;132;955
037572195841;1;84;118;284;69;119;674
007729409054;1;239;202;112;76;107;736
056166067880;1;138;199;298;83;162;880
003923251042;1;263;271;240;109;117;1000
045475447568;1;146;180;144;64;133;667
096387995856;1;142;184;141;76;146;689
033304466530;1;123;81;266;117;151;738
054723716325;1;240;114;180;76;67;677
092794603275;1;108;110;167;100;163;648
058079791550;1;123;241;134;105;122;725
084610382985;1;100;215;115;59;63;552
091901764010;1;130;273;233;109;162;907
040334019252;1;273;117;232;73;148;843
002305667311;1;274;189;91;84;136;774
077495518145;1;106;254;283;99;101;843
032113458528;1;210;113;284;107;56;770
030268843616;1;254;243;210;91;131;929
059121534676;1;117;110;205;81;115;628
062061668298;1;199;142;257;84;104;786
039447798820;1;213;252;260;76;62;863
073375356216;1;81;180;150;98;118;627
043539320137;1;205;185;149;54;149;742
038652669033;1;129;211;178;93;95;706
013087254399;1;190;141;249;108;70;758
022074048962;1;251;152;160;81;123;767
058465342337;1;242;198;192;96;61;789
086713261751;1;254;169;285;116;70;894
097084605338;1;144;133;110;114;165;666
094263893440;1;248;124;176;86;170;804
021579026660;1;221;135;102;60;56;574
017068545903;1;239;107;138;102;168;754
077492607620;1;165;271;199;61;142;838
058134241657;1;102;110;134;56;150;552
060273363209;1;255;256;249;75;144;979
028181640779;1;167;92;240;54;51;604
025778063334;1;118;144;174;60;160;656
064754164111;1;169;278;176;108;170;901
055057057299;1;155;200;212;84;168;819
014852678574;1;220;248;107;113;62;750
031589234141;1;283;153;158;104;140;838
096402506579;1;210;128;108;78;110;634
012341092970;1;157;240;274;50;132;853
048319400138;1;248;135;214;82;54;733
016113708411;1;201;243;242;52;151;889
057634871255;1;156;166;184;63;169;738
057236071449;1;111;145;121;50;133;560
073484511237;1;276;154;94;76;103;703
029387462951;1;231;224;165;116;110;846
034643097529;1;225;114;219;108;99;765
061792561675;1;179;99;237;117;129;761
071345429998;1;156;102;124;102;168;652
034626916103;1;155;279;170;100;57;761
085099104822;1;199;168;280;51;168;866
061100053584;1;251;166;115;67;178;777
062049948120;1;178;252;228;61;94;813
073223610517;1;247;253;120;105;68;793
045859327891;1;177;189;256;102;105;829
045217777638;1;232;92;262;76;132;794
023262094123;1;106;143;163;112;129;653
025896421341;1;218;109;252;103;157;839
011152666354;1;112;248;198;71;64;693
045482247820;1;206;94;238;57;144;739
052049471998;1;167;137;143;82;100;629
060307197985;1;214;191;166;58;161;790
083262394025;1;102;191;156;66;117;632
003587909286;1;193;214;247;74;171;899
079761733941;1;111;90;294;70;165;730
093180502028;1;286;183;165;52;52;738
010016452174;1;190;254;173;92;159;868
099528859191;1;232;105;215;50;135;737
044546528712;1;179;102;95;69;86;531
017989221626;1;138;255;194;101;156;844
003955161139;1;125;274;125;112;108;744
038873894408;1;224;121;176;111;51;683
050870561415;1;213;216;243;73;144;889
024156106666;1;181;109;93;75;70;528
035323226770;1;252;108;94;113;78;645
064164061154;1;273;219;111;79;65;747
047528698979;1;224;193;279;79;165;940
038033243095;1;116;281;147;65;122;731
066820672798;1;193;233;107;83;160;776
092728071334;1;111;191;287;108;169;866
028571857353;1;85;168;217;75;115;660
049835279821;1;191;288;186;75;149;889
040119569464;1;129;158;114;73;86;560
067722489541;1;291;205;283;90;114;983
078414400646;1;199;105;162;101;58;625
073833633010;1;85;83;286;90;78;622
046398752412;1;127;101;242;90;97;657
094404523913;1;229;147;109;105;74;664
018668005702;1;249;103;246;74;92;764
044384960719;1;213;259;248;101;105;926
002283993662;1;167;218;275;65;153;878
094263900176;1;276;283;213;65;124;961
011246774317;1;172;142;262;108;164;848
089224889686;1;116;255;92;63;124;650
004081394707;1;120;180;181;75;138;694
007563366280;1;152;117;234;93;105;701
067187450141;1;190;151;144;81;169;735
047134959798;1;262;106;201;89;125;783
026070825752;1;241;117;125;73;143;699
081935014672;1;89;228;249;64;81;711
086256211557;1;206;139;263;74;58;740
058665728776;1;284;197;155;114;149;899
064561963391;1;279;175;289;111;65;919
004798346863;1;254;265;252;84;176;1031
044838075692;1;221;152;127;88;91;679
001739389296;1;147;262;299;120;163;991
066048600648;1;144;287;115;97;90;733
052609176533;1;273;205;126;106;76;786
063026301533;1;83;251;247;65;53;699
099356163498;1;113;168;98;93;57;529
089374491796;1;189;107;157;120;148;721
017142937508;1;189;287;190;98;104;868
015360639602;1;177;272;159;103;54;765
018083340282;1;287;112;250;57;174;880
085931974709;1;252;210;118;62;121;763
068689975348;1;142;86;134;116;177;655
051022554871;1;238;251;133;106;68;796
001009954257;1;180;241;297;89;109;916
058364843812;1;261;253;221;106;138;979
041616037284;1;84;121;166;66;64;501
018012393769;1;122;220;220;90;138;790
078192965130;1;123;169;218;84;150;744
016244675053;1;189;149;232;116;84;770
042425286096;1;208;273;176;100;168;925
077464868317;1;121;91;186;84;64;546
038345962968;1;122;90;152;62;112;538
081364303595;1;220;274;260;92;111;957
092665670030;1;262;129;207;94;96;788
005425992190;1;206;237;174;66;50;733
086718908927;1;280;191;263;96;86;916
080840814777;1;220;119;215;96;139;789
024454611791;1;198;157;134;85;173;747
055321943782;1;236;112;190;118;135;791
008289808366;1;233;120;111;69;80;613
051110627843;1;197;207;196;96;165;861
059818491739;1;87;170;159;120;157;693
074859318036;1;97;148;211;80;60;596
067890302815;1;168;172;286;68;119;813
029378674923;1;134;175;245;66;82;702
049938213482;1;217;105;236;59;76;693
092726302415;1;153;119;147;83;133;635
001303760287;1;80;185;183;75;62;585
090459750282;1;85;90;148;101;66;490
048183324752;1;108;261;197;104;165;835
058262137473;1;224;221;93;120;96;754
038469877933;1;90;251;216;96;109;762
068601963784;1;145;218;109;102;158;732
041801264875;1;290;128;166;74;83;741
077570560993;1;274;268;220;107;121;990
062112358996;1;251;220;176;119;122;888
015124609925;1;161;226;196;58;171;812
082670925274;1;280;240;151;72;116;859
029060652281;1;207;142;109;61;65;584
030111570044;1;178;132;249;107;122;788
024901023383;1;106;154;131;118;143;652
013749006886;1;238;275;224;66;115;918
031531110774;1;171;161;262;79;177;850
080112619143;1;218;235;238;89;178;958
031310630850;1;255;111;270;119;91;846
000368532555;1;290;112;212;89;149;852
057979654868;1;110;96;262;116;77;661
037725846650;1;142;235;291;51;106;825
007056271842;1;108;244;93;120;103;668
004827456923;1;255;130;138;52;62;637
012868603664;1;142;213;105;61;116;637
075212782185;1;175;210;164;55;75;679
098774898966;1;146;276;251;111;152;936
004097942651;1;278;268;178;120;62;906
040555894148;1;108;114;96;78;71;467
050452773263;1;230;162;196;104;152;844
090486306209;1;256;88;194;84;154;776
052471643462;1;155;288;236;106;89;874
087567795506;1;283;268;160;64;72;847
059832325159;1;257;99;130;101;95;682
044296093143;1;100;182;287;88;94;751
046196006711;1;210;283;151;93;62;799
018694845748;1;261;192;268;68;150;939
014266304209;1;193;110;141;89;90;623
087784454907;1;283;207;181;96;131;898
041664398911;1;269;265;211;76;171;992
087825419382;1;212;112;214;91;150;779
056383088019;1;263;130;166;104;161;824
030051846017;1;241;279;290;52;101;963
002574541818;1;146;214;172;59;157;748
066709842745;1;206;181;104;95;124;710
096013945332;1;189;198;170;66;133;756
011824254365;1;268;123;108;67;96;662
013651694596;1;238;236;255;64;129;922
067081511688;1;147;170;101;88;66;572
001272595480;1;272;148;232;67;63;782
080877653036;1;205;153;172;114;50;694
023201510780;1;156;107;182;82;95;622
042604557700;1;202;102;255;113;53;725
031509444140;1;256;168;273;58;130;885
020053384132;1;267;99;188;94;142;790
070065392634;1;80;218;133;51;93;575
033554506325;1;179;247;105;62;165;758
081971707391;1;271;132;136;54;160;753
066787253181;1;173;261;111;83;153;781
005442468723;1;247;257;242;68;164;978
074987288212;1;112;202;93;54;84;545
009954650665;1;172;180;186;110;152;800
091878091995;1;90;99;279;93;76;637
069321916619;1;107;138;247;69;90;651
005746749907;1;85;285;171;67;171;779
012601416758;1;168;120;206;120;117;731
019123729573;1;243;115;211;78;56;703
027283609107;1;161;91;163;70;124;609
056456116395;1;212;170;232;101;141;856
002333025326;1;164;169;183;78;174;768
045175495383;1;213;100;159;113;50;635
008672373083;1;277;225;93;93;83;771
005132392434;1;175;179;119;66;176;715
019556753812;1;226;210;136;97;96;765
078532523842;1;87;229;196;71;119;702
045658657106;1;159;198;103;105;164;729
055309844569;1;168;95;261;71;168;763
009071753863;1;88;128;251;88;131;686
013000918289;1;114;238;123;93;67;635
014915035761;1;155;104;230;91;134;714
077938849097;1;133;276;178;65;103;755
002766642042;1;92;205;153;61;144;655
093763459246;1;150;100;202;95;103;650
053206426656;1;267;259;198;89;77;890
031736787909;1;187;172;141;99;154;753
082873987169;1;113;88;215;111;52;579
095854206557;1;194;280;121;54;69;718
073390028495;1;252;90;233;108;177;860
053396970794;1;291;246;100;79;172;888
002312165888;1;96;246;186;55;137;720
027750117062;1;157;136;248;118;149;808
094325288778;1;224;267;228;81;116;916
081178310259;1;125;249;148;92;74;688
049700177802;1;127;214;229;56;159;785
087737232338;1;136;267;214;99;62;778
020383010985;1;119;260;246;76;127;828
066615863471;1;159;223;241;89;72;784
068109691636;1;168;240;179;80;151;818
039701582619;1;132;117;254;108;160;771
088798247093;1;256;193;151;73;136;809
043437514572;1;182;122;226;75;96;701
004806871300;1;146;119;109;57;167;598
031333835103;1;202;280;162;119;140;903
088134010852;1;291;234;276;101;71;973
058967451995;1;258;221;146;73;108;806
050537853071;1;91;242;226;115;153;827
004448709396;1;205;281;195;84;143;908
025722619319;1;217;207;139;118;131;812
066037865562;1;230;122;255;64;163;834
096382351296;1;105;98;129;113;55;500
039762137520;1;245;276;118;52;113;804
046224917727;1;173;82;191;88;114;648
088749047001;1;149;87;210;91;120;657
065323071984;1;162;129;209;61;72;633
059243667399;1;205;232;198;96;169;900
015164904409;1;233;251;106;84;159;833
068614866344;1;147;93;137;89;160;626
076228441896;1;245;152;182;64;100;743
011018553570;1;279;140;149;119;156;843
097335169479;1;179;234;95;59;105;672
043319358143;1;247;122;144;57;93;663
012085852047;1;234;172;273;59;162;900
013741177460;1;111;91;291;88;117;698
015371889982;1;169;118;272;119;163;841
091624225968;1;96;209;246;64;67;682
011701880012;1;95;248;198;80;53;674
000036369145;1;261;151;280;52;122;866
096898220136;1;165;104;142;73;84;568
070362279848;1;244;254;137;103;90;828
067251800395;1;279;244;239;76;142;980
052603675499;1;80;134;292;92;146;744
046501213003;1;258;208;192;105;80;843
072958463029;1;187;198;115;67;165;732
003495050433;1;133;166;148;110;125;682
050568547266;1;155;281;291;72;163;962
087575218078;1;87;227;117;86;125;642
074992072134;1;151;252;181;89;104;777
063500832478;1;114;172;168;63;113;630
022659451555;1;194;129;117;99;167;706
037613822313;1;105;142;227;109;166;749
037830360430;1;202;186;236;102;56;782
080262036979;1;117;164;284;58;78;701
099836918179;1;176;85;271;74;53;659
018045134515;1;264;170;163;117;175;889
066311047574;1;110;226;161;106;143;746
087548361498;1;210;242;123;71;162;808
038708324723;1;249;149;252;57;168;875
013129677165;1;166;221;271;104;69;831
065487728927;1;197;141;188;111;130;767
058866137952;1;176;207;256;75;108;822
076534600864;1;192;83;155;72;164;666
051778270390;1;145;133;229;79;68;654
074675775344;1;112;105;285;95;56;653
090411306024;1;216;206;248;66;141;877
001963989052;1;237;114;209;50;65;675
068259665172;1;220;247;124;52;92;735
008384118345;1;256;212;223;100;112;903
075616904774;1;134;90;215;77;62;578
062133070127;1;216;159;187;118;144;824
000791572533;1;261;215;100;109;177;862
018330595070;1;126;95;212;100;155;688
003144098332;1;200;122;220;90;113;745
002842617690;1;254;192;132;72;55;705
052411266260;1;279;97;127;82;175;760
095790467750;1;97;128;136;57;127;545
020952908438;1;118;265;114;105;164;766
003757244933;1;283;207;103;113;101;807
028529293164;1;221;197;256;104;89;867
098971186933;1;165;126;227;90;153;761
047901499933;1;141;210;211;69;110;741
013848416302;1;136;213;144;74;77;644
012545473205;1;209;124;255;69;107;764
084837541408;1;168;274;109;116;53;720
046193783770;1;89;139;90;71;132;521
031044516854;1;209;171;91;82;121;674
010775624728;1;154;268;132;77;157;788
000534588673;1;104;92;219;84;96;595
062463011972;1;138;148;121;96;164;667
074837374119;1;185;234;299;89;113;920
046603094586;1;198;194;222;76;140;830
032155843528;1;273;119;156;63;50;661
029067903912;1;188;207;105;89;53;642
061171694595;1;94;285;292;50;104;825
035908173342;1;99;248;176;54;164;741
096962363522;1;275;250;168;66;56;815
023608920719;1;218;249;113;82;101;763
096961849741;1;275;93;258;107;88;821
076861117375;1;195;201;189;84;170;839
031713477220;1;231;278;259;95;147;1010
084591324672;1;133;91;244;107;149;724
047721323909;1;177;250;100;76;131;734
035926030850;1;153;112;136;83;150;634
076121218064;1;125;109;272;72;69;647
049374903956;1;97;99;246;96;113;651
073322100086;1;244;196;203;50;113;806
057123065491;1;143;97;274;68;95;677
084979646238;1;217;228;107;94;138;784
034535874108;1;202;282;279;91;174;1028
030068860508;1;189;103;222;98;146;758
050217410618;1;276;208;113;103;125;825
035100984018;1;94;147;133;104;61;539
085422271483;1;227;112;206;57;140;742
044149260227;1;103;88;180;89;72;532
088319371508;1;86;141;273;116;173;789
098785566448;1;150;228;265;80;156;879
085718577431;1;106;85;173;107;141;612
051513321458;1;250;155;291;80;77;853
069880241017;1;177;259;239;54;151;880
018530255697;1;279;183;165;59;144;830
070909642401;1;257;247;259;69;76;908
002083175109;1;80;247;252;102;177;858
051506431326;1;123;87;91;98;62;461
051105336655;1;150;190;207;111;94;752
062902893189;1;116;283;97;67;98;661
027145220865;1;145;268;174;83;136;806
054319632487;1;212;136;164;89;109;710
037308170839;1;283;124;272;56;89;824
023373172273;1;125;162;280;120;96;783
090235979143;1;181;268;156;62;128;795
017802451861;1;128;280;226;52;142;828
022816095203;1;124;208;216;61;136;745
072977772944;1;188;288;98;96;155;825
060716105620;1;166;231;171;119;58;745
056691624841;1;228;274;162;72;100;836
051729834442;1;230;84;95;83;122;614
013590765799;1;266;121;147;91;160;785
003804354410;1;263;126;147;58;59;653
015354316860;1;139;281;190;58;133;801
002668787185;1;93;177;175;89;77;611
075147568692;1;99;83;230;113;87;612
009628160078;1;235;134;189;80;162;800
047224241565;1;236;90;100;82;78;586
079382615835;1;201;82;234;74;99;690
026336517219;1;233;286;137;101;122;879
041446927744;1;95;148;225;74;174;716
094817764000;1;136;263;285;63;75;822
094485288595;1;107;277;299;112;68;863
065830948352;1;175;286;229;110;140;940
051006555716;1;194;212;198;89;95;788
016694719849;1;89;132;129;68;65;483
076575153773;1;218;97;124;117;56;612
012039598784;1;282;146;127;107;94;756
049211159963;1;207;287;187;103;168;952
063069351175;1;215;277;142;81;101;816
005091561833;1;143;171;285;50;140;789
043416631820;1;86;211;131;96;84;608
009250861525;1;169;279;297;107;170;1022
089432663116;1;87;124;172;104;99;586
060252555315;1;240;176;292;74;88;870
052698068788;1;265;259;106;81;62;773
041217857916;1;150;208;228;105;161;852
087154987078;1;290;228;136;78;62;794
043412738803;1;81;98;172;97;92;540
041825133315;1;106;236;248;64;124;778
041237921747;1;225;266;109;101;124;825
009489097639;1;94;275;244;108;91;812
077076530271;1;256;146;267;58;102;829
078805910008;1;274;151;264;67;178;934
091985616376;1;242;281;98;114;161;896
045919937768;1;217;125;124;68;60;594
067293530585;1;166;105;125;67;92;555
071891868572;1;173;282;181;58;93;787
004578550527;1;80;241;177;96;114;708
042284476335;1;111;150;277;115;143;796
084693921812;1;131;105;138;77;178;629
077454051046;1;158;204;151;54;89;656
089232137798;1;188;250;232;103;112;885
011342315088;1;127;112;102;51;97;489
090234204563;1;283;143;246;62;141;875
081712943538;1;184;254;228;61;108;835
079125829643;1;284;158;154;73;128;797
053660840338;1;168;264;172;104;119;827
006251821576;1;281;247;123;114;127;892
056674600719;1;225;152;268;119;98;862
024402462475;1;286;234;112;90;90;812
005642719126;1;159;230;271;119;152;931
069565341732;1;234;153;206;65;54;712
016756822589;1;292;89;128;98;64;671
026310847265;1;162;263;270;59;112;866
030383749759;1;131;237;230;101;141;840
062164617223;1;267;193;212;109;113;894
067846701142;1;120;246;259;78;148;851
001448828231;1;113;288;121;104;173;799
016874797757;1;228;124;91;67;92;602
012193465387;1;143;152;103;54;158;610
010836710942;1;222;158;250;85;52;767
073286952583;1;280;222;170;105;155;932
049692996178;1;283;122;178;97;131;811
015608667394;1;187;157;185;80;55;664
026654735926;1;289;248;124;51;178;890
056910029158;1;240;141;103;56;71;611
094820098016;1;125;176;121;67;143;632
075644282650;1;256;173;146;98;153;826
048934151362;1;164;170;194;118;169;815
058447792543;1;145;99;270;90;93;697
040203130204;1;185;143;102;83;124;637
079981516731;1;156;199;214;86;154;809
007901174558;1;214;143;123;107;75;662
096742999444;1;246;239;271;70;74;900
028980609503;1;242;122;244;109;87;804
027025342821;1;204;200;240;74;133;851
084766779783;1;179;108;300;67;131;785
044019163938;1;107;124;169;109;71;580
072844713663;1;188;260;286;86;95;915
001988203854;1;218;110;292;61;66;747
084108870853;1;270;199;214;79;53;815
066502967270;1;163;175;247;54;110;749
070392377355;1;261;193;225;87;142;908
025398430973;1;153;176;229;73;108;739
028813437112;1;149;123;158;56;144;630
078412367999;1;172;233;252;81;168;906
009466720813;1;231;280;283;63;70;927
036130314815;1;205;161;261;106;87;820
083282230227;1;165;280;125;78;163;811
041478108751;1;207;146;160;94;108;715
084276278737;1;197;231;213;111;105;857
094380267380;1;168;281;149;108;109;815
038494426476;1;268;233;120;82;61;764
087522712720;1;167;281;201;53;129;831
091553698045;1;208;236;128;60;121;753
080984217460;1;182;256;265;82;78;863
089426606012;1;244;268;236;104;175;1027
097065837110;1;254;170;155;102;68;749
059730768702;1;169;131;162;54;101;617
071586172068;1;132;235;232;95;58;752
081042175456;1;147;192;210;79;172;800
096730416445;1;214;245;205;74;133;871
018649486808;1;144;145;106;54;103;552
084386729459;1;83;93;144;85;128;533
047702182653;1;220;236;195;76;132;859
073732801275;1;280;204;251;81;69;885
089300578286;1;264;181;171;57;71;744
039793053854;1;268;244;200;83;104;899
015535760813;1;217;236;223;62;96;834
024397014543;1;140;92;133;60;63;488
086355002606;1;233;93;275;56;57;714
080035785307;1;267;152;194;92;142;847
036884963181;1;280;127;128;70;161;766
081543982263;1;289;285;112;69;174;929
044098209285;1;146;218;298;55;69;786
054728488269;1;130;177;174;81;51;613
084382004987;1;96;85;143;112;77;513
076972619726;1;112;233;112;70;98;625
044282389975;1;164;241;114;117;112;748
033970537168;1;155;263;293;108;94;913
005432169122;1;244;128;169;94;101;736
066309996103;1;126;235;257;53;136;807
018224625365;1;243;113;236;101;50;743
084405363132;1;212;136;221;86;122;777
022333736904;1;229;174;275;95;146;919
039120666464;1;156;262;289;99;146;952
031128879857;1;158;138;177;87;65;625
049540169614;1;88;162;247;81;171;749
016721751795;1;182;257;145;118;90;792
020158608393;1;137;250;183;52;124;746
090686420379;1;233;128;172;64;60;657
061098733130;1;240;115;287;110;143;895
000051758449;1;184;222;238;54;125;823
042425788615;1;140;172;277;97;146;832
009849485553;1;114;226;108;54;91;593
088613564242;1;163;199;150;78;143;733
008180233753;1;257;89;235;90;172;843
039904668375;1;186;275;93;115;178;847
074185859119;1;218;216;225;80;94;833
064577579757;1;171;244;107;61;113;696
063707070770;1;272;188;164;84;73;781
000131628996;1;98;116;222;64;117;617
057076012290;1;203;108;106;50;145;612
069482280065;1;125;176;105;91;176;673
043308686107;1;117;82;119;71;117;506
067882156181;1;132;118;161;64;68;543
074329774644;1;188;142;169;70;165;734
015770876619;1;117;127;161;51;87;543
076580549429;1;102;151;263;78;150;744
063157889496;1;275;230;166;95;89;855
017323499704;1;202;133;133;109;115;692
094729642967;1;228;164;129;118;58;697
034369401406;1;119;128;96;52;97;492
034040376712;1;229;94;246;54;60;683
018277291424;1;205;199;129;55;147;735
094421142921;1;116;120;142;104;79;561
014812402904;1;218;148;287;68;169;890
002435168487;1;222;234;100;110;117;783
052232451553;1;86;137;173;70;111;577
083171409553;1;182;208;287;72;75;824
041607729751;1;134;159;268;91;130;782
056777698249;1;226;244;120;107;151;848
028940849087;1;135;198;266;50;171;820
026805367788;1;178;192;170;99;158;797
052464186377;1;116;239;271;84;107;817
061192520764;1;162;118;241;61;125;707
051186483941;1;146;88;244;90;164;732
017437069716;1;283;85;267;104;54;793
091796358896;1;136;223;93;94;153;699
056042650204;1;156;121;98;52;92;519
021500072641;1;177;115;111;64;149;616
004269965239;1;156;167;112;82;52;569
062668228257;1;198;247;211;81;78;815
026155400222;1;283;281;192;84;139;979
005038619719;1;194;132;193;84;65;668
053652931619;1;80;198;112;80;73;543
074002701496;1;208;133;153;99;161;754
080240956710;1;245;202;93;119;151;810
092569615887;1;251;213;184;79;156;883
026796675255;1;122;126;151;96;144;639
055368028245;1;156;147;131;118;98;650
038756714503;1;103;138;250;82;97;670
037633637333;1;134;113;238;78;65;628
013556096951;1;149;231;274;57;72;783
037576658900;1;158;287;225;50;57;777
028937791013;1;195;123;190;53;164;725
077622665405;1;286;158;145;106;124;819
076470312178;1;255;237;97;54;169;812
048604460773;1;243;279;213;78;114;927
059140876299;1;186;266;249;116;162;979
071029426146;1;149;283;137;71;166;806
039816656133;1;123;163;298;100;102;786
089072626714;1;175;227;188;97;68;755
099206471729;1;224;199;111;101;99;734
030658698954;1;152;224;106;108;175;765
052388397074;1;234;156;147;110;99;746
099555122494;1;92;179;155;113;144;683
038758110307;1;96;81;184;60;132;553
036801887086;1;219;117;135;50;67;588
010229802351;1;138;131;221;51;141;682
021886615920;1;224;109;215;112;54;714
025557732020;1;264;271;202;73;148;958
084732392144;1;189;158;198;98;62;705
038807418504;1;101;185;166;68;59;579
085213560117;1;255;236;137;99;110;837
033207363604;1;292;179;270;69;135;945
039432430219;1;166;149;119;92;64;590
060327061557;1;188;211;220;67;139;825
008532956993;1;231;227;239;68;53;818
097331237729;1;92;90;211;96;66;555
079444520875;1;264;177;288;64;150;943
073189106366;1;251;222;110;90;53;726
043661163536;1;151;225;141;61;167;745
032037581286;1;156;214;198;67;68;703
052154147817;1;167;223;182;94;140;806
083168536002;1;264;136;93;86;95;674
044889046262;1;164;100;158;107;177;706
071307924445;1;189;190;262;75;109;825
079151153058;1;131;89;156;102;157;635
078945010415;1;105;142;161;111;116;635
064556842186;1;138;95;240;61;100;634
097756721282;1;121;241;287;76;54;779
097274275939;1;194;196;237;113;65;805
019423669197;1;153;83;188;105;120;649
087303577216;1;285;260;281;104;61;991
035291839278;1;264;255;101;78;58;756
060663717373;1;229;123;103;87;100;642
024217313279;1;183;273;272;104;165;997
023702608814;1;291;96;141;90;59;677
046971710394;1;95;244;247;93;172;851
026270123005;1;94;204;236;69;73;676
061456903245;1;115;240;195;56;134;740
088719700088;1;267;243;198;100;121;929
033239327183;1;267;90;283;85;96;821
000020417185;1;280;146;215;94;152;887
044120052304;1;158;256;91;64;51;620
077781090726;1;289;139;138;57;73;696
032806383192;1;196;138;134;114;173;755
040451987212;1;163;177;113;54;63;570
095051745561;1;273;126;94;119;94;706
039595854260;1;145;155;165;104;120;689
089489231622;1;275;165;294;90;74;898
053136871456;1;180;169;145;72;73;639
073692472893;1;81;271;224;109;73;758
031039103331;1;198;111;277;105;120;811
077727970108;1;262;121;263;112;168;926
076800146573;1;87;261;167;78;136;729
076873672660;1;156;118;299;89;87;749
050574219983;1;185;256;191;66;78;776
079905640448;1;285;243;215;54;78;875
084721130809;1;163;285;270;90;74;882
010672697598;1;240;102;158;101;61;662
053149695533;1;85;235;183;53;101;657
020201468060;1;271;128;142;105;154;800
072597191664;1;208;263;170;85;133;859
023361655617;1;132;131;164;113;151;691
060799858784;1;109;120;150;98;168;645
094813780232;1;120;286;192;95;81;774
043718146027;1;189;163;165;81;96;694
071040002900;1;247;83;208;58;63;659
016186668290;1;173;166;119;98;169;725
070905501767;1;131;237;270;74;127;839
049932288186;1;222;83;191;111;53;660
084559898966;1;106;285;122;95;56;664
003460087228;1;227;178;289;98;57;849
081525173309;1;150;206;253;111;160;880
092502951082;1;106;201;222;113;97;739
047886641443;1;118;80;129;75;156;558
077449186702;1;168;270;281;61;85;865
074793802875;1;224;188;211;55;178;856
041578475108;1;138;265;182;112;162;859
006277115752;1;211;151;194;50;165;771
006594292669;1;131;283;155;86;100;755
047496474888;1;292;244;284;64;146;1030
051524193600;1;123;233;241;57;76;730
023952555554;1;292;174;282;50;115;913
016863528204;1;93;106;203;63;90;555
062787097102;1;105;274;285;61;76;801
077711750210;1;186;279;289;60;52;866
015740707351;1;233;229;167;99;169;897
018481544114;1;251;114;271;94;58;788
015095749424;1;247;202;281;79;122;931
072708843184;1;232;140;272;94;112;850
049134322367;1;86;84;94;115;175;554
088113114643;1;123;189;101;93;93;599
053490406575;1;285;172;207;84;128;876
047755375970;1;198;212;196;61;156;823
063610735586;1;276;125;253;107;122;883
070869881446;1;159;239;289;56;87;830
011347673900;1;101;106;227;78;111;623
072930919654;1;234;165;112;85;174;770
004235885894;1;263;270;160;108;76;877
025805071247;1;176;207;297;72;128;880
082362374599;1;216;183;212;114;175;900
035989241298;1;150;252;112;116;120;750
008655721841;1;173;208;164;83;113;741
047710981328;1;237;87;145;83;103;655
091766295102;1;245;124;252;64;50;735
099272679564;1;236;215;148;64;56;719
081843996369;1;144;276;101;70;112;703
081382531136;1;232;141;111;96;135;715
059115294450;1;105;212;291;112;61;781
025797396116;1;199;219;191;81;158;848
026163757351;1;201;156;279;81;99;816
050093441828;1;137;155;112;62;115;581
040660516813;1;115;106;131;68;64;484
055212990711;1;167;144;100;116;59;586
013211541199;1;214;193;235;95;108;845
083911207524;1;272;168;242;66;65;813
025270884575;1;261;178;286;117;65;907
084135233263;1;245;169;249;73;167;903
021082040872;1;114;99;131;100;110;554
071864852714;1;279;185;287;72;160;983
068836907010;1;210;85;262;73;151;781
013777919177;1;162;183;183;59;80;667
061645773721;1;289;187;161;90;51;778
019841961609;1;269;202;194;114;105;884
077739669901;1;244;258;223;74;79;878
080927323964;1;160;237;93;82;84;656
010768564238;1;94;221;242;83;131;771
028319240078;1;179;95;295;90;126;785
027171377338;1;282;284;165;108;75;914
048136260359;1;247;156;241;110;95;849
004798986548;1;186;255;235;66;158;900
084804332468;1;239;227;154;66;119;805
083853181163;1;261;80;215;78;162;796
099242628592;1;147;247;262;115;151;922
045432256828;1;288;192;230;109;96;915
066215008519;1;218;163;229;89;159;858
000391489721;1;115;123;274;109;169;790
038367476950;1;261;200;236;56;120;873
089083221902;1;277;89;188;56;79;689
075702136031;1;162;192;212;54;93;713
070502799753;1;197;145;227;73;92;734
026395950809;1;89;150;144;92;139;614
075778360452;1;274;227;184;104;150;939
018264673771;1;132;209;282;60;113;796
001849726740;1;118;170;141;63;78;570
021690000091;1;85;81;120;77;130;493
076205898106;1;82;142;256;93;55;628
011262503073;1;248;128;182;109;103;770
089982387685;1;222;235;285;101;88;931
078043329313;1;231;167;193;76;75;742
074633290880;1;223;248;215;83;127;896
032934318705;1;235;281;142;95;116;869
095902234524;1;214;132;141;73;89;649
021293765856;1;231;145;166;58;175;775
069546792791;1;184;192;121;86;99;682
083600158832;1;224;217;190;81;70;782
045595541848;1;148;101;120;59;117;545
029325467477;1;292;140;100;85;109;726
042844470218;1;136;82;214;65;155;652
003052949377;1;85;186;202;78;176;727
050276814106;1;226;137;231;51;69;714
011130380735;1;280;180;294;101;65;920
060517920045;1;219;155;221;66;133;794
050116902889;1;93;174;158;99;141;665
063882595214;1;187;205;181;61;72;706
099905813087;1;274;273;212;80;166;1005
082089633353;1;282;155;187;50;51;725
023581390527;1;182;276;120;69;89;736
059563571737;1;249;207;218;84;79;837
040070505371;1;117;266;272;108;118;881
075450447162;1;138;190;202;61;140;731
059716670605;1;93;191;217;71;121;693
031904240152;1;182;82;140;84;165;653
009509813348;1;231;274;207;54;121;887
004080757130;1;158;126;229;94;71;678
064166810346;1;276;207;204;58;134;879
079555164518;1;257;175;175;85;126;818
067562332721;1;227;180;109;77;55;648
063099048538;1;91;187;274;74;88;714
047023980355;1;279;274;174;88;125;940
003960297343;1;258;117;92;96;125;688
015612833706;1;214;131;159;92;172;768
065956862563;1;108;255;247;119;60;789
069553288299;1;283;229;162;97;127;898
041508403576;1;111;185;124;55;123;598
062465151756;1;89;236;278;96;159;858
043664505055;1;270;225;224;100;76;895
090716059982;1;158;115;97;108;100;578
073725569692;1;119;89;134;87;164;593
063633211231;1;117;170;288;112;158;845
089220870530;1;143;276;299;84;116;918
064084137374;1;230;115;153;81;96;675
017144288682;1;265;199;171;106;114;855
099862472009;1;243;93;171;97;99;703
084915385224;1;219;144;190;73;145;771
059262995665;1;181;87;151;97;159;675
095846049083;1;204;150;153;117;130;754
051202765628;1;97;106;234;57;168;662
068862853610;1;256;192;149;51;138;786
092490656666;1;221;265;94;93;111;784
084042998502;1;81;220;292;91;159;843
051238860597;1;104;255;182;89;93;723
093073625647;1;108;234;120;100;115;677
028912777409;1;197;216;224;120;159;916
017883153939;1;163;116;152;87;176;694
027327002598;1;213;91;222;108;88;722
015175877254;1;161;111;248;59;175;754
088105912082;1;165;243;211;60;136;815
036303387823;1;164;162;290;83;84;783
038924517767;1;199;174;270;57;80;780
072612074701;1;130;102;101;97;123;553
066685848546;1;168;173;228;56;163;788
062945850199;1;168;149;103;67;148;635
066179655281;1;89;80;229;104;78;580
059072472948;1;288;241;206;103;125;963
006558699702;1;161;195;191;74;143;764
000715600629;1;217;80;259;61;147;764
056924790413;1;197;133;188;63;158;739
092655408381;1;105;154;270;82;158;769
007485746399;1;184;250;174;110;52;770
022310624317;1;110;185;145;116;142;698
093506213317;1;206;112;145;86;105;654
061815049707;1;87;201;125;78;165;656
092433900598;1;264;245;277;89;111;986
056960476096;1;221;232;268;70;165;956
070969308928;1;244;232;111;76;93;756
088988134926;1;155;109;196;70;100;630
081274677283;1;224;163;251;65;57;760
024253747748;1;171;261;240;82;138;892
068026184301;1;231;145;131;116;91;714
076823135098;1;83;236;261;103;91;774
037538712455;1;255;102;100;51;173;681
073993731850;1;142;241;163;85;57;688
004882051092;1;270;120;251;83;97;821
058527160082;1;281;103;224;62;84;754
004635324298;1;135;86;155;71;103;550
010180066075;1;193;241;228;113;117;892
092316602829;1;149;169;224;95;173;810
085474639631;1;97;263;298;86;124;868
031824300685;1;195;160;220;70;175;820
048917687316;1;103;250;280;83;131;847
063684176082;1;235;157;298;61;131;882
091133657759;1;266;287;293;82;60;988
079702704015;1;171;256;206;86;108;827
072017274430;1;151;246;214;70;150;831
047758892813;1;283;101;175;69;82;710
082740004427;1;285;125;156;51;149;766
025364149848;1;175;194;249;91;74;783
028473399938;1;152;98;95;120;173;638
041654204688;1;115;228;139;56;137;675
087445817822;1;195;94;260;62;154;765
023511937375;1;107;181;247;117;130;782
018697952624;1;191;91;193;69;130;674
079144393421;1;157;273;169;82;160;841
019681962629;1;270;269;247;85;98;969
027840050737;1;246;132;163;71;56;668
060033116802;1;116;275;278;104;52;825
067479906082;1;284;247;178;116;85;910
085909550116;1;196;173;147;92;66;674
089051821383;1;289;206;219;120;120;954
008356053186;1;292;82;165;81;89;709
072634017406;1;91;275;296;114;72;848
029936157875;1;196;159;278;111;135;879
050310008869;1;160;210;274;56;71;771
037692851852;1;169;219;165;106;153;812
090274665760;1;252;163;211;79;78;783
044975938914;1;85;281;293;105;173;937
079396250140;1;193;277;257;99;113;939
047228831557;1;159;193;144;73;67;636
053980738679;1;285;228;106;54;173;846
063403848581;1;85;136;221;119;90;651
075582355207;1;285;283;259;80;134;1041
006118466731;1;221;236;220;54;147;878
009981719814;1;205;186;162;96;95;744
052958066447;1;218;120;247;81;83;749
085207746200;1;175;166;132;98;104;675
059298047758;1;131;210;235;118;121;815
073509061867;1;87;237;240;113;106;783
029457664717;1;156;213;246;63;153;831
057182065423;1;161;250;263;51;177;902
080114251040;1;178;233;129;93;168;801
005315531750;1;214;132;125;91;75;637
066428161716;1;259;232;160;56;72;779
036215212027;1;121;214;130;120;177;762
084256403254;1;239;182;287;59;131;898
041719680870;1;173;126;296;69;50;714
007168314261;1;285;203;197;111;98;894
052552725623;1;170;220;109;91;61;651
036453467666;1;184;206;200;82;123;795
037080103565;1;230;282;137;102;155;906
082683616065;1;289;237;123;75;147;871
003259060464;1;282;90;240;53;79;744
014270479947;1;248;155;252;103;150;908
011423952294;1;202;193;117;96;164;772
003251780980;1;247;125;255;79;83;789
095883338517;1;190;212;210;60;102;774
057209566310;1;231;245;164;107;94;841
075360069307;1;82;193;261;64;164;764
008424205389;1;148;102;198;98;56;602
091506756706;1;266;281;142;68;60;817
075137256926;1;155;159;214;119;61;708
072584714622;1;169;144;108;79;143;643
052694073812;1;213;229;138;59;65;704
000908600371;1;135;138;204;118;144;739
048925106497;1;171;106;298;56;91;722
091244064752;1;187;236;279;51;171;924
078755787320;1;92;170;198;63;104;627
043743756193;1;80;282;195;109;121;787
090371407583;1;266;170;144;88;74;742
006336862208;1;282;286;144;83;84;879
096257669928;1;286;179;144;117;166;892
034352236517;1;155;103;249;81;163;751
089111365123;1;99;196;125;54;114;588
001343793343;1;84;112;98;104;127;525
077123601187;1;273;209;122;103;98;805
036049868371;1;96;120;159;105;161;641
066307913503;1;142;190;128;53;81;594
073720581477;1;158;228;98;93;151;728
046889106786;1;166;156;148;112;145;727
013714887079;1;251;104;118;111;163;747
018601833617;1;204;262;252;78;169;965
024794654863;1;223;171;296;94;84;868
066446188311;1;173;136;112;88;132;641
045872620017;1;143;105;118;55;127;548
018306974968;1;240;226;216;86;74;842
040373103002;1;94;232;116;109;101;652
042352787086;1;220;97;294;60;141;812
054362631316;1;142;206;109;71;127;655
045244193163;1;143;88;275;64;172;742
043945263310;1;89;259;261;85;113;807
076049894804;1;289;175;148;88;66;766
082718173409;1;96;149;254;112;105;716
009060212038;1;231;238;111;119;105;804
006368996309;1;88;151;111;74;123;547
018732840723;1;227;83;95;80;159;644
095257797477;1;156;234;161;89;138;778
008008249144;1;106;153;282;88;167;796
036249988676;1;181;208;233;60;62;744
083751563455;1;162;169;290;63;153;837
077496790814;1;99;260;273;109;143;884
012986584148;1;210;240;95;94;104;743
090150758937;1;229;128;272;84;83;796
067046637953;1;272;223;147;106;58;806
055055376961;1;207;256;250;75;123;911
075698974917;1;90;223;299;52;106;770
053180062896;1;194;109;263;100;86;752
045926148900;1;115;285;114;116;69;699
023443062559;1;142;153;255;84;126;760
012988889000;1;208;172;192;59;110;741
020721805269;1;226;116;148;50;177;717
093585128655;1;277;150;150;68;90;735
066392307881;1;256;157;203;113;56;785
060618936562;1;217;187;182;76;58;720
069522518615;1;250;156;259;83;127;875
032062927932;1;110;241;194;57;96;698
047539845744;1;230;166;254;95;57;802
014629400444;1;199;139;183;108;160;789
062463954764;1;169;218;267;112;158;924
075668380965;1;200;182;247;114;138;881
096623529027;1;178;234;156;92;69;729
099114335681;1;131;247;243;120;156;897
087759083846;1;114;172;116;94;80;576
032399632277;1;97;277;200;90;126;790
096154880892;1;146;286;257;62;93;844
099320602729;1;229;222;291;76;88;906
032400928117;1;278;262;170;69;138;917
036736535873;1;97;287;284;64;135;867
089472585680;1;193;273;134;98;103;801
086424838412;1;192;191;221;79;151;834
061171522106;1;273;125;153;97;121;769
081515617051;1;218;256;284;110;172;1040
048215994432;1;109;187;251;62;160;769
083452903709;1;97;119;260;75;95;646
019661110195;1;277;118;253;55;56;759
077592512361;1;271;215;293;96;90;965
084578603722;1;160;239;119;60;52;630
057472145580;1;92;122;268;58;68;608
083271141420;1;99;130;221;120;176;746
027847672681;1;126;127;151;103;145;652
044283182921;1;228;114;118;91;116;667
002581260421;1;99;249;139;51;89;627
038713823871;1;290;188;93;115;99;785
037457758353;1;202;202;210;107;57;778
030763079186;1;119;90;119;83;165;576
056711970423;1;123;171;105;113;63;575
078088699982;1;204;181;127;90;73;675
048945996786;1;132;102;280;66;131;711
023958810125;1;248;250;184;80;153;915
045566842047;1;81;230;103;94;135;643
021456766543;1;236;164;222;95;59;776
073715987165;1;149;255;92;77;53;626
099262225252;1;284;239;119;112;139;893
030767923357;1;207;204;272;85;109;877
087109526880;1;261;202;99;91;99;752
030828769338;1;226;188;238;90;60;802
093826274398;1;132;198;285;96;132;843
006681187767;1;104;269;182;108;93;756
093950282089;1;144;88;97;93;61;483
032209608556;1;103;279;124;118;157;781
055829557506;1;108;167;92;92;91;550
040452544827;1;280;80;199;67;97;723
037254811171;1;146;87;268;97;58;656
015179541277;1;136;220;154;107;163;780
099809879936;1;252;114;300;77;87;830
001645348711;1;154;112;252;68;84;670
051419605601;1;80;148;238;56;141;663
020808215547;1;80;226;116;69;127;618
050335247741;1;218;199;106;97;168;788
024135567556;1;221;161;222;70;165;839
009908287371;1;254;229;211;66;103;863
032424498147;1;83;86;174;60;101;504
014626513336;1;209;169;127;118;127;750
057923569965;1;285;248;192;83;160;968
056296110931;1;153;275;203;99;137;867
073458281920;1;171;134;161;94;114;674
094223633705;1;240;285;283;110;53;971
043618439169;1;222;189;131;70;73;685
021125468595;1;166;121;222;114;168;791
003671420579;1;120;110;221;118;170;739
052722391140;1;154;165;208;100;162;789
095953716971;1;191;145;96;111;108;651
066459373829;1;116;254;98;63;147;678
074043346705;1;173;117;97;108;125;620
035188907220;1;278;146;213;56;155;848
028953842342;1;165;210;128;61;77;641
036309215807;1;254;283;181;59;123;900
001231755323;1;177;268;220;77;55;797
099827284394;1;171;161;165;67;98;662
023729512785;1;149;186;103;111;161;710
040985334681;1;169;152;247;114;147;829
077195456064;1;134;283;251;100;124;892
032540734575;1;204;258;128;90;162;842
022677059635;1;292;113;289;75;159;928
080210770006;1;268;122;295;83;147;915
072033735460;1;137;164;245;69;159;774
020868500194;1;117;160;230;102;114;723
022484918001;1;126;238;265;114;164;907
023368308397;1;182;124;245;90;134;775
038719865369;1;252;237;94;101;158;842
093721573300;1;276;250;175;80;152;933
000831635651;1;281;124;298;104;74;881
044443242444;1;116;105;264;80;148;713
010246357282;1;87;81;118;114;156;556
077863868103;1;113;134;207;57;87;598
084509162155;1;92;154;264;98;107;715
008926054773;1;101;266;211;85;145;808
077016908490;1;120;218;216;71;76;701
049815706032;1;148;280;289;77;57;851
066933485415;1;82;154;239;116;96;687
012096723279;1;189;130;224;107;135;785
031112052246;1;267;92;217;67;105;748
000673208549;1;280;114;137;68;75;674
099057658978;1;268;274;150;120;121;933
025035034259;1;114;126;222;68;148;678
007678050402;1;292;136;132;118;117;795
035798335994;1;82;95;260;118;167;722
081529875589;1;203;246;100;110;135;794
038058394718;1;99;277;108;116;163;763
083534894442;1;271;223;113;65;134;806
070095354980;1;269;203;113;80;155;820
048305157638;1;84;98;257;84;60;583
045509091516;1;179;218;256;95;143;891
052669351436;1;270;175;162;110;114;831
081843817575;1;200;246;95;77;123;741
044755766622;1;213;87;205;69;155;729
010122386741;1;207;245;250;80;116;898
095906543038;1;286;82;159;70;120;717
041640084441;1;216;228;300;63;171;978
006186949415;1;209;113;222;69;81;694
049625157982;1;178;148;123;108;151;708
043629100196;1;149;163;122;52;122;608
008024463041;1;240;175;156;87;177;835
096313287078;1;177;89;130;79;127;602
036864879804;1;177;104;197;96;113;687
088196212620;1;232;278;130;70;118;828
079499363834;1;236;144;244;112;108;844
038879720363;1;109;189;218;57;88;661
001349638872;1;167;243;174;73;71;728
073970616250;1;167;81;92;108;172;620
041853246980;1;118;287;274;93;65;837
002743423129;1;96;148;292;65;110;711
098229481717;1;242;90;93;91;104;620
094623846458;1;82;218;251;67;167;785
005615375163;1;256;110;147;111;51;675
035068368480;1;99;271;268;99;129;866
069459886105;1;112;86;297;111;101;707
012840261602;1;244;221;234;61;156;916
000452231759;1;107;215;143;80;71;616
006149932558;1;234;108;224;59;69;694
055573289060;1;269;159;238;51;58;775
064612935401;1;166;173;150;65;173;727
046398397128;1;164;153;114;77;133;641
057007735497;1;88;117;244;87;64;600
099420734694;1;267;92;269;57;157;842
096050728536;1;91;220;254;52;166;783
068389595827;1;162;251;299;82;85;879
014343650500;1;134;223;246;63;131;797
063532978545;1;108;258;116;117;88;687
010662441706;1;102;246;114;51;53;566
027156240224;1;176;164;252;51;169;812
010542632273;1;183;152;161;71;52;619
006773785140;1;197;95;156;56;177;681
016655859590;1;80;172;223;51;141;667
058956476341;1;290;109;103;69;81;652
059598247012;1;149;118;251;85;173;776
094881669549;1;179;179;128;104;77;667
041679902683;1;195;230;203;100;168;896
095738855978;1;155;209;282;52;173;871
034549608207;1;165;101;223;111;173;773
087961942746;1;167;155;97;69;97;585
098910363319;1;122;214;285;90;93;804
005146249495;1;159;241;137;62;85;684
000828424842;1;285;103;124;85;64;661
032852121340;1;134;255;153;81;115;738
088424820527;1;232;288;102;86;77;785
020516899390;1;231;240;153;105;61;790
076813161710;1;161;222;278;84;63;808
032490682367;1;92;198;261;58;61;670
074341914791;1;142;129;248;78;93;690
023806511511;1;286;235;296;56;170;1043
025335124203;1;186;194;119;100;110;709
014573968569;1;95;205;97;110;131;638
085006069800;1;162;205;234;102;95;798
018225310379;1;157;94;213;89;52;605
070413536411;1;180;197;292;57;70;796
099479300580;1;290;115;190;80;158;833
052333949229;1;148;187;191;100;166;792
022202952453;1;179;120;103;85;80;567
028369357268;1;123;253;128;112;65;681
049947553548;1;249;191;161;52;150;803
084008183717;1;243;250;285;77;154;1009
067386772024;1;112;286;166;98;69;731
098069594543;1;142;219;116;94;120;691
005752634195;1;105;115;157;93;95;565
043085343668;1;245;214;247;84;76;866
053842064675;1;173;177;262;59;55;726
020041802114;1;121;250;109;120;136;736
026662498329;1;248;190;206;57;109;810
081234507980;1;162;143;277;110;59;751
069795956708;1;115;229;150;70;59;623
072121774312;1;241;190;147;99;126;803
025486893825;1;249;97;107;118;55;626
071001295128;1;127;113;96;55;157;548
017306683475;1;207;120;254;118;132;831
060854894163;1;251;210;239;74;178;952
039595389917;1;237;229;127;116;154;863
044674564638;1;188;83;111;82;137;601
092129748333;1;181;221;166;112;164;844
047664031374;1;237;226;94;85;148;790
015340828490;1;184;217;213;72;172;858
099641053458;1;134;224;186;71;160;775
016348208591;1;171;144;144;57;62;578
063686697736;1;126;82;244;75;171;698
061679768077;1;139;272;142;115;78;746
098808710353;1;276;268;129;66;57;796
035927507429;1;244;218;228;93;104;887
001371864130;1;163;247;281;74;92;857
077857004034;1;90;251;167;88;132;728
092042762959;1;228;98;95;78;160;659
057522262123;1;105;103;111;88;99;506
023062105557;1;256;145;99;111;122;733
009061679162;1;244;279;108;99;131;861
045068208984;1;264;141;116;96;74;691
053404082622;1;183;109;171;96;160;719
047472065336;1;115;285;111;76;56;643
053585690019;1;148;173;252;117;50;740
033066996261;1;191;130;225;105;77;728
080646360220;1;150;274;299;118;165;1006
086973425315;1;135;86;296;55;123;695
034706049531;1;133;114;112;66;86;511
057670246890;1;232;133;206;57;153;781
007827088994;1;213;166;122;71;65;637
071353543045;1;115;166;176;97;126;680
090675998040;1;292;118;249;104;141;904
026033056593;1;203;153;296;111;115;878
035287043058;1;155;267;187;97;127;833
023006788880;1;245;257;269;84;159;1014
066452362553;1;98;196;294;117;138;843
005250198292;1;248;88;132;80;102;650
029390239844;1;290;121;233;50;159;853
026587261552;1;176;84;299;108;121;788
061333891073;1;190;157;157;95;116;715
049285902497;1;246;232;137;91;101;807
069159427311;1;114;174;95;111;82;576
013194855204;1;89;80;255;96;165;685
049868432620;1;268;258;251;119;90;986
063011654885;1;288;242;228;95;100;953
082351521170;1;243;95;221;89;147;795
045077883242;1;210;157;135;68;173;743
010451853368;1;196;81;194;52;105;628
061491624643;1;168;88;165;99;79;599
086288298018;1;283;127;244;117;55;826
032756474589;1;244;120;98;112;154;728
059468962386;1;145;258;206;75;128;812
062312538308;1;259;122;225;119;142;867
035540061798;1;138;203;140;116;91;688
091157575504;1;121;198;201;114;103;737
068940080585;1;245;273;158;57;50;783
094505578921;1;251;227;186;99;53;816
032037997084;1;161;194;105;90;71;621
039885027206;1;107;218;110;120;102;657
081244085496;1;279;130;183;101;61;754
093615145473;1;145;175;162;120;90;692
023443500977;1;171;216;106;94;51;638
048370883228;1;98;246;157;77;84;662
098046172122;1;103;135;272;116;104;730
063663751217;1;259;129;118;85;160;751
023545381996;1;283;111;222;52;75;743
074395901619;1;199;154;157;57;89;656
044734534020;1;135;198;193;118;65;709
054731386383;1;181;174;299;107;159;920
044744745014;1;184;85;275;66;64;674
094755842637;1;270;178;279;56;177;960
037905113286;1;249;257;238;95;107;946
021246160370;1;174;161;123;55;102;615
079248539357;1;260;251;296;105;57;969
086519226454;1;238;146;164;82;107;737
071438279790;1;142;230;126;64;62;624
071075019017;1;153;240;259;95;153;900
077294384478;1;193;200;162;112;131;798
041989143285;1;272;145;150;96;109;772
011877168964;1;251;147;228;58;126;810
078887137369;1;226;116;148;105;140;735
039684664796;1;220;226;122;87;149;804
076161384972;1;97;225;130;111;61;624
024727326523;1;110;147;277;82;142;758
056337131307;1;170;235;152;60;68;685
095334522623;1;114;144;156;102;51;567
072642935402;1;86;254;250;68;141;799
002953183893;1;210;113;166;95;143;727
029846129866;1;160;282;162;62;175;841
084566219990;1;247;255;190;78;167;937
028437911729;1;280;83;159;85;63;670
098147536784;1;177;225;163;119;53;737
016200286781;1;262;268;275;93;93;991
081699786455;1;127;248;116;113;113;717
045590464219;1;118;127;115;60;81;501
018918252244;1;276;111;194;54;142;777
064760767853;1;132;209;159;51;172;723
076973329999;1;180;198;203;92;72;745
070102060040;1;153;85;251;63;174;726
082857776890;1;146;118;146;62;61;533
099275559114;1;241;195;207;85;142;870
021533347691;1;242;169;285;50;77;823
059459438759;1;109;172;113;104;69;567
086053315800;1;213;125;124;66;122;650
003176327642;1;265;91;157;65;116;694
084891834638;1;122;107;264;81;94;668
057161976634;1;285;91;256;88;168;888
098173146115;1;280;214;151;77;55;777
078761772306;1;177;256;145;76;79;733
024579632508;1;185;80;246;58;62;631
082687739583;1;91;123;195;99;140;648
042596665241;1;98;285;287;63;98;831
066790898368;1;178;277;236;115;114;920
006122026537;1;248;152;240;110;171;921
078359394140;1;180;124;248;59;170;781
067520795485;1;195;251;209;93;159;907
080713574331;1;290;243;191;54;96;874
060651930770;1;232;97;236;115;54;734
003193840801;1;250;90;218;116;113;787
038486147491;1;235;208;103;93;130;769
092369368968;1;188;169;148;107;57;669
006518640108;1;140;249;183;84;80;736
083689336794;1;84;286;274;72;99;815
043152369750;1;256;183;135;108;170;852
096340947309;1;220;254;177;56;162;869
065932551517;1;189;219;197;115;136;856
078092100180;1;83;228;263;79;171;824
057399967190;1;292;84;189;50;95;710
042820928148;1;84;157;186;70;90;587
097403790691;1;243;81;226;66;89;705
012697911199;1;217;262;147;107;144;877
079452166896;1;194;249;238;105;123;909
008047628207;1;164;254;278;80;109;885
024157686941;1;255;116;112;109;70;662
076517348365;1;160;153;181;54;133;681
044428114725;1;146;283;107;117;111;764
015177186888;1;226;129;187;107;148;797
084676387709;1;197;276;164;118;96;851
066854614013;1;210;173;109;117;141;750
083508977845;1;187;182;192;55;74;690
062118974300;1;199;84;294;68;124;769
029615984715;1;135;132;151;61;57;536
046223177370;1;242;119;239;108;84;792
004823177040;1;144;244;123;112;80;703
044395963421;1;182;167;247;77;110;783
033079163137;1;215;250;244;96;92;897
082704626750;1;90;102;168;58;64;482
095202935717;1;123;166;182;67;168;706
021435441811;1;263;162;127;74;108;734
018001256844;1;195;178;205;66;57;701
029528199955;1;252;105;210;84;124;775
037932292007;1;214;114;117;74;72;591
022656795059;1;91;187;282;78;115;753
087953966033;1;198;267;171;82;106;824
011328766098;1;269;171;176;63;160;839
089645556301;1;143;276;179;105;156;859
018489977720;1;162;129;188;54;61;594
058407515729;1;270;80;140;77;110;677
081963105538;1;250;134;282;106;126;898
062961225397;1;81;207;176;112;147;723
089923377676;1;164;167;276;111;134;852
068980443514;1;103;222;253;101;164;843
031979370378;1;289;246;109;117;131;892
031214045772;1;89;218;148;78;64;597
000824582023;1;273;256;161;59;106;855
049834949546;1;267;281;180;109;126;963
088069373482;1;224;168;189;119;168;868
099519116384;1;191;124;268;106;128;817
081264292232;1;154;205;180;54;56;649
061821874509;1;189;168;216;119;79;771
053131857588;1;245;208;230;112;174;969
061656283667;1;189;143;293;66;112;803
024281288537;1;168;269;196;97;72;802
022272666101;1;132;198;177;64;138;709
023796161459;1;288;157;217;111;97;870
036557177202;1;207;257;291;72;111;938
004175534781;1;87;253;172;67;71;650
064009576265;1;95;199;97;97;144;632
056750614119;1;246;194;154;110;171;875
038892774128;1;97;279;279;74;177;906
062852338923;1;191;191;218;52;124;776
060167313973;1;266;100;106;101;93;666
041862683062;1;152;164;259;96;141;812
078938959499;1;105;146;232;97;93;673
044669444913;1;278;282;111;60;154;885
068771764520;1;134;270;250;106;60;820
047352356453;1;257;84;159;99;129;728
030630519162;1;145;100;182;77;78;582
004635092159;1;143;102;218;82;103;648
056084313147;1;245;211;172;66;72;766
065481585739;1;282;269;211;66;173;1001
057641606435;1;267;277;178;61;144;927
008952976199;1;90;274;209;67;178;818
000172180860;1;189;287;225;85;60;846
095117254449;1;236;152;138;89;122;737
099187484989;1;281;138;153;88;60;720
000171864380;1;104;283;146;114;170;817
058350969121;1;200;169;143;84;164;760
086211164289;1;273;127;174;113;136;823
071882627242;1;280;237;185;67;96;865
058457450509;1;217;177;112;100;176;782
025620366595;1;244;108;265;113;176;906
069481215609;1;163;242;240;71;118;834
071243615130;1;124;132;245;55;60;616
039577753863;1;179;260;245;86;56;826
047051702491;1;96;219;197;114;109;735
012234310903;1;240;150;96;105;167;758
040753060847;1;195;116;96;97;145;649
091321907072;1;210;108;211;111;106;746
080660181337;1;238;260;242;59;152;951
048449541021;1;217;109;200;55;93;674
010475947449;1;254;127;200;104;147;832
010421383204;1;290;266;95;76;95;822
023443730970;1;100;86;108;100;133;527
043411426282;1;203;267;244;77;72;863
099911747600;1;135;232;281;87;108;843
066340008544;1;92;175;282;89;129;767
060544880034;1;184;265;166;104;117;836
009422104613;1;198;185;154;101;117;755
088831435583;1;262;195;208;79;136;880
068926867323;1;209;108;111;54;85;567
044995423055;1;90;247;218;50;172;777
020172275932;1;140;178;129;119;147;713
057415793296;1;273;244;97;63;132;809
087415187689;1;135;105;185;111;162;698
033878796468;1;167;245;153;52;174;791
060423091794;1;269;187;236;94;63;849
094442815016;1;152;245;100;72;177;746
050736589377;1;269;144;200;91;136;840
052513465845;1;287;113;202;115;59;776
063281820434;1;281;192;92;80;63;708
090286635827;1;286;133;153;109;112;793
014988640876;1;92;180;159;71;105;607
065755120734;1;194;181;172;87;74;708
061353728786;1;167;250;187;115;54;773
094001191178;1;193;268;244;97;76;878
037197327357;1;122;276;123;87;146;754
098140731109;1;199;137;134;104;157;731
095467350170;1;85;235;122;96;105;643
071816259267;1;243;234;239;67;158;941
067679688009;1;257;211;255;101;100;924
096722559847;1;276;111;171;82;156;796
027381747435;1;133;251;260;75;158;877
067983772107;1;269;206;281;70;60;886
099135962791;1;278;126;283;116;166;969
041049860277;1;235;237;186;67;135;860
011450687550;1;123;81;127;88;107;526
092024309159;1;195;271;292;104;145;1007
055475579204;1;291;237;182;52;99;861
014443250666;1;152;199;243;102;141;837
036658257229;1;283;159;126;107;93;768
022510175117;1;159;241;211;116;151;878
070781437328;1;182;230;171;104;67;754
039525240515;1;125;99;260;82;171;737
013433035602;1;279;185;142;61;93;760
005020384564;1;161;237;175;77;92;742
061405166738;1;153;134;100;57;173;617
051567633818;1;116;161;266;112;172;827
066542764938;1;164;285;169;53;170;841
056086134983;1;126;285;274;102;133;920
080965013373;1;229;241;285;71;105;931
003696759801;1;217;257;152;90;155;871
021706484551;1;216;159;113;96;66;650
016491270683;1;167;204;258;89;116;834
010963377444;1;128;250;211;103;164;856
000626774188;1;138;115;181;119;77;630
007258527008;1;162;139;276;112;134;823
050318920343;1;91;92;205;82;76;546
045853934020;1;126;288;230;90;63;797
069640659386;1;212;228;193;86;144;863
030383829185;1;148;244;107;65;91;655
002283058798;1;98;141;247;97;94;677
038991640322;1;85;287;132;78;68;650
011856030493;1;154;166;264;103;176;863
027987558523;1;120;93;154;87;86;540
089968063519;1;264;226;109;70;64;733
079097000055;1;144;90;240;90;68;632
067241632947;1;284;94;214;58;71;721
090333216030;1;230;272;204;90;83;879
047976317372;1;93;185;241;109;87;715
087102531968;1;116;286;215;77;76;770
014260476265;1;199;111;122;71;106;609
039968002975;1;255;126;127;103;153;764
022448646229;1;180;248;230;72;166;896
042092615021;1;201;218;133;92;76;720
083971800997;1;114;101;98;109;161;583
040518119047;1;191;88;142;111;164;696
045733174350;1;241;231;99;65;58;694
032319819075;1;107;184;274;79;97;741
027538704944;1;130;177;216;68;95;686
090775129848;1;280;167;133;67;79;726
040962610724;1;273;156;191;51;174;845
069172083974;1;253;174;254;119;174;974
079242726902;1;191;243;109;108;107;758
027427340924;1;171;223;123;97;101;715
096539280918;1;85;186;262;85;80;698
074857709499;1;218;145;270;78;95;806
069332202196;1;159;218;123;100;153;753
022379302041;1;281;200;137;87;153;858
014206227948;1;203;249;265;96;117;930
019214971358;1;113;275;229;98;157;872
033300638982;1;143;264;280;77;167;931
085910855785;1;191;284;93;63;131;762
033588991119;1;218;226;132;117;145;838
058154579447;1;234;196;256;102;108;896
074408887576;1;235;176;145;56;115;727
054532267570;1;101;260;263;72;75;771
051335855688;1;275;174;290;59;86;884
068802907174;1;138;146;233;53;152;722
065452283016;1;260;148;97;112;85;702
075271541901;1;276;281;168;102;113;940
045637041608;1;221;272;129;107;114;843
059873900817;1;263;228;200;95;155;941
038334899122;1;215;236;94;95;105;745
070804388818;1;125;156;125;60;169;635
065881225792;1;268;247;105;71;112;803
015079444963;1;207;121;259;66;118;771
040314733585;1;154;246;229;72;116;817
080391819222;1;112;261;189;90;51;703
047525093330;1;139;238;135;98;70;680
052423432217;1;247;283;260;114;178;1082
070837204621;1;201;246;239;105;176;967
053077521405;1;146;132;184;65;92;619
044812204174;1;99;180;150;113;136;678
049570306540;1;180;100;221;51;86;638
068352669780;1;184;147;227;90;153;801
072224615030;1;222;226;174;114;76;812
018872488819;1;183;124;148;59;160;674
058718309598;1;170;193;229;60;104;756
022826791763;1;120;137;153;116;91;617
021727245365;1;236;150;184;88;75;733
031950353867;1;186;241;227;90;81;825
086727118911;1;246;287;127;88;134;882
050124457320;1;251;288;183;103;68;893
025820008668;1;258;83;295;57;103;796
021314259741;1;100;118;123;102;93;536
017751394988;1;169;182;270;92;124;837
059241565106;1;272;165;131;104;84;756
060164689816;1;213;169;202;75;117;776
039466620832;1;280;261;222;52;151;966
058479855026;1;157;92;138;76;63;526
073057656727;1;91;250;124;82;161;708
067332453140;1;124;224;94;55;132;629
017427008812;1;216;257;285;64;82;904
040746804692;1;281;254;92;86;70;783
054761633515;1;252;173;231;109;117;882
088182619512;1;147;213;100;60;169;689
001044959706;1;115;247;236;79;66;743
065353355844;1;173;244;230;75;146;868
085446731701;1;153;100;123;112;69;557
060212089363;1;150;89;190;56;86;571
032734285072;1;253;127;136;79;53;648
090286669255;1;189;234;145;71;150;789
042406394459;1;107;276;102;60;167;712
085006410785;1;152;85;138;118;60;553
039940670187;1;222;281;114;82;132;831
034664471372;1;228;149;277;89;158;901
036722405048;1;177;134;168;116;152;747
082842208964;1;113;82;165;68;131;559
091463748107;1;169;195;295;104;177;940
083716308664;1;80;147;264;66;143;700
002225093936;1;125;80;219;93;153;670
000955066702;1;287;101;181;110;75;754
057359939738;1;197;248;227;117;107;896
040968220372;1;147;209;274;78;147;855
073365778310;1;209;266;225;61;176;937
072411213515;1;142;107;237;80;151;717
059250204717;1;291;217;201;79;73;861
076389104485;1;222;269;191;79;111;872
050250075128;1;190;117;115;93;69;584
084242779783;1;234;96;278;100;157;865
077056151129;1;228;219;214;108;119;888
081542986171;1;235;118;189;57;69;668
029505643696;1;167;124;132;83;93;599
033940553356;1;250;277;244;98;151;1020
057552664259;1;94;162;149;97;110;612
007813176563;1;240;111;158;94;149;752
061812390376;1;270;231;208;104;160;973
067627862310;1;82;166;288;85;124;745
011118490554;1;275;99;103;64;115;656
059431702031;1;125;241;148;72;105;691
033692621859;1;107;110;210;62;106;595
022160150403;1;180;110;105;74;110;579
048096454589;1;94;85;124;93;95;491
017299094155;1;172;178;257;64;135;806
061701312717;1;220;244;119;117;76;776
029480772854;1;270;230;222;97;121;940
062314190665;1;131;279;213;109;141;873
098136545663;1;143;85;195;58;178;659
029678941288;1;112;100;93;65;176;546
069694138929;1;215;251;258;54;54;832
026842358003;1;262;110;156;58;134;720
004543711887;1;93;211;130;67;76;577
026648918640;1;286;90;167;89;165;797
053022909222;1;201;189;184;84;150;808
072819944586;1;280;96;258;72;101;807
070306690334;1;90;96;225;58;139;608
008257401105;1;108;268;237;80;137;830
049872445695;1;101;283;134;110;157;785
046378319533;1;93;269;145;85;138;730
099977996627;1;243;87;231;86;101;748
093873448586;1;192;84;112;51;93;532
087822889728;1;95;85;140;56;129;505
067750783137;1;247;119;268;117;118;869
029472560442;1;262;261;113;107;82;825
074325097819;1;290;106;156;86;138;776
034137827671;1;86;163;215;118;154;736
043822193867;1;187;209;99;57;101;653
058380412399;1;237;252;107;57;83;736
078690009492;1;227;171;169;79;123;769
047519725639;1;281;200;173;63;134;851
075547726289;1;136;196;293;66;58;749
083715655108;1;86;196;176;81;160;699
086815776544;1;134;157;205;117;116;729
008249609002;1;124;253;221;52;58;708
056982554212;1;137;251;106;80;145;719
079005991839;1;198;266;234;117;162;977
049193758100;1;291;246;163;78;70;848
080678946347;1;145;224;159;80;73;681
073767316365;1;273;257;239;103;173;1045
048553095952;1;287;204;127;97;122;837
020687182254;1;276;262;107;108;52;805
039649405585;1;176;262;230;114;176;958
034739115067;1;205;179;141;50;135;710
094501950146;1;157;196;235;64;115;767
078172280153;1;226;244;261;102;63;896
054652864143;1;95;243;170;70;73;651
021744046759;1;80;179;125;63;177;624
077371584939;1;117;154;276;96;117;760
057107204291;1;225;241;189;84;62;801
065800627104;1;264;120;236;51;133;804
096536965650;1;183;263;98;77;107;728
082852615503;1;166;110;169;78;78;601
009830040628;1;225;229;123;57;171;805
060178213083;1;185;104;158;63;61;571
018570202411;1;153;170;119;88;170;700
004243189590;1;226;282;146;115;153;922
036411640680;1;229;99;94;72;168;662
097869869340;1;266;136;265;71;153;891
053942168024;1;152;245;185;97;170;849
008556624038;1;172;135;284;103;83;777
001953659647;1;235;231;210;95;154;925
041970453648;1;88;206;108;98;57;557
032987337836;1;179;183;184;105;63;714
085708948062;1;106;212;277;61;119;775
079038291569;1;100;219;220;117;146;802
073536106660;1;176;212;180;75;89;732
012289296803;1;141;142;103;102;50;538
047550517174;1;152;117;94;103;68;534
055594701663;1;226;283;286;80;93;968
078763285383;1;229;172;181;102;149;833
073771470307;1;89;134;163;57;138;581
051982945801;1;137;274;179;54;91;735
087799016494;1;248;181;297;59;125;910
069121484779;1;182;266;116;55;176;795
043989977799;1;103;101;218;73;80;575
064968333516;1;141;202;197;70;112;722
051074520028;1;107;215;160;86;51;619
064664799360;1;100;267;105;55;171;698
068000832383;1;205;84;198;101;93;681
071868527669;1;108;132;223;79;90;632
016645675446;1;176;131;216;96;128;747
047758816067;1;125;182;298;55;51;711
069350692650;1;201;161;96;61;70;589
052064626604;1;269;97;101;50;132;649
062677184796;1;176;200;231;95;63;765
029850190744;1;190;285;109;87;168;839
053407074148;1;180;271;251;81;127;910
052899859283;1;186;155;116;102;70;629
047675636755;1;136;195;134;72;104;641
014205940002;1;164;110;222;60;73;629
067145630702;1;154;173;262;100;76;765
056954236882;1;151;121;91;93;128;584
082749850729;1;251;164;263;113;164;955
018578775227;1;233;133;280;69;169;884
038285114911;1;83;212;227;117;65;704
084268417134;1;123;212;111;85;134;665
003445453473;1;251;273;218;104;168;1014
080097317813;1;292;224;153;83;55;807
067933760378;1;274;148;291;87;64;864
028109183886;1;139;199;157;120;122;737
030900861748;1;281;204;289;52;73;899
075617136307;1;269;161;136;82;158;806
050878828841;1;179;109;93;81;104;566
089299270837;1;209;205;257;91;139;901
035920546946;1;216;107;250;62;106;741
027529294090;1;256;195;106;59;171;787
004111165292;1;275;113;108;73;163;732
093597134561;1;133;168;146;118;141;706
059069856897;1;85;141;255;85;168;734
087837253997;1;251;163;239;89;142;884
036291453814;1;270;150;142;55;93;710
084055056240;1;161;232;169;89;78;729
001583324420;1;218;128;191;78;57;672
028919730481;1;272;208;182;75;67;804
050308656740;1;96;170;183;94;168;711
038968740461;1;130;158;228;94;67;677
068662461388;1;156;252;189;55;133;785
019117752193;1;153;116;276;118;120;783
056398248043;1;107;157;101;82;128;575
066640748494;1;172;269;99;90;125;755
024426480305;1;109;81;112;72;165;539
002878517097;1;194;132;191;68;115;700
036862240734;1;113;165;117;59;173;627
019196958377;1;137;180;138;74;62;591
082852745944;1;111;199;182;84;177;753
004480297883;1;210;106;212;90;172;790
092383985300;1;111;226;273;101;170;881
091536949986;1;273;221;245;120;109;968
040039746595;1;195;80;282;69;170;796
092484130316;1;124;283;227;107;118;859
044053516755;1;149;132;299;70;50;700
053891711598;1;279;207;247;107;89;929
097606159198;1;90;100;154;74;65;483
002792285823;1;99;160;117;52;151;579
046783140261;1;275;163;112;109;59;718
053947512126;1;141;177;291;101;79;789
066084981499;1;90;239;150;81;59;619
030731749984;1;108;241;205;117;164;835
059236807967;1;154;188;91;66;100;599
095317663359;1;189;194;139;91;167;780
049334744243;1;205;231;90;74;126;726
038057724911;1;129;184;188;58;119;678
032828717871;1;247;129;275;83;95;829
034156200791;1;112;99;154;73;75;513
061363708514;1;223;152;222;73;99;769
095878583923;1;169;192;260;117;86;824
081534935089;1;164;255;212;69;124;824
098112256295;1;197;104;179;77;69;626
087377472697;1;89;139;154;110;126;618
090612298026;1;292;175;289;63;160;979
010887981059;1;166;169;114;69;149;667
036696900095;1;231;189;153;106;164;843
099490285492;1;153;131;225;52;108;669
071243096419;1;97;223;257;72;89;738
077123819095;1;251;90;269;80;97;787
091110665537;1;204;256;163;96;157;876
025652365155;1;180;169;188;117;97;751
074577372006;1;188;274;260;76;134;932
069424446328;1;103;187;112;103;73;578
079621214560;1;210;181;178;57;165;791
069743160178;1;279;113;168;112;96;768
099502663272;1;95;130;280;114;54;673
055205982556;1;212;285;285;91;86;959
061980127933;1;112;193;260;111;125;801
058447294290;1;276;271;246;91;157;1041
014269789935;1;181;269;242;65;71;828
085207718531;1;116;205;132;87;140;680
079650480809;1;240;253;264;113;154;1024
000347835381;1;133;87;157;77;71;525
046168464435;1;163;273;95;69;112;712
046662813546;1;102;271;180;51;88;692
077506878891;1;113;216;118;55;158;660
082193594535;1;178;106;288;98;108;778
037204106639;1;280;106;142;89;143;760
022020548815;1;223;286;188;63;147;907
003916751316;1;101;261;99;110;141;712
010695931198;1;172;102;97;100;133;604
014495341245;1;126;253;254;75;151;859
013398050126;1;220;81;93;61;159;614
068789641742;1;114;88;291;62;118;673
082125150733;1;119;194;168;58;69;608
051737584656;1;165;109;285;110;144;813
030766760290;1;222;258;170;67;58;775
091954373126;1;239;272;288;110;156;1065
055382705526;1;165;231;94;97;58;645
062846443507;1;289;117;296;112;133;947
038438223435;1;235;256;271;109;111;982
099394147942;1;139;88;265;76;76;644
082052896636;1;266;112;242;104;85;809
082743311438;1;267;98;110;107;114;696
066928116681;1;146;273;221;99;79;818
064525079738;1;172;164;117;117;83;653
091754062143;1;85;154;117;112;130;598
064036135529;1;267;212;142;115;61;797
027486456738;1;277;131;91;105;159;763
028655279558;1;278;272;104;68;128;850
000061457590;1;225;95;98;82;121;621
005830792480;1;213;136;292;55;70;766
044557202276;1;190;159;160;71;81;661
048493777645;1;179;141;173;92;89;674
065328208218;1;139;102;101;94;167;603
042359271029;1;272;182;260;107;73;894
086666636452;1;105;156;269;60;83;673
082528033076;1;227;255;122;96;131;831
009538281040;1;129;143;93;51;60;476
034461511833;1;111;273;92;104;121;701
086597076069;1;254;125;256;92;178;905
005071084214;1;279;102;257;51;59;748
007200600302;1;223;148;294;56;168;889
016785945112;1;97;179;252;100;50;678
024578621832;1;103;247;121;109;74;654
017542597950;1;187;257;193;83;124;844
063191280337;1;164;237;129;62;58;650
023541713502;1;264;192;256;120;89;921
021729307410;1;220;254;136;99;61;770
042159201195;1;94;262;284;114;62;816
024024092735;1;237;115;182;93;169;796
074394058417;1;202;168;222;92;153;837
012231990765;1;272;81;179;78;170;780
052433864424;1;218;86;157;69;84;614
046943174821;1;106;86;222;81;120;615
056587679736;1;187;193;122;101;81;684
017868654325;1;169;225;95;78;146;713
062688655934;1;137;217;169;74;133;730
003364504165;1;123;153;124;54;56;510
083384499255;1;190;135;229;86;146;786
089366759187;1;253;229;153;118;144;897
030696935842;1;255;168;213;57;88;781
012438007972;1;138;138;235;69;156;736
014232566092;1;118;186;181;120;148;753
059314302744;1;190;121;259;100;160;830
040272022857;1;126;84;281;107;178;776
003270796297;1;91;254;246;60;161;812
049409070786;1;182;203;196;113;99;793
030747835268;1;288;285;294;95;165;1127
035623015449;1;265;281;267;57;116;986
074552052594;1;165;99;292;105;101;762
069851995122;1;281;281;202;103;111;978
028874653925;1;123;164;96;61;177;621
062160072039;1;216;172;299;86;124;897
001641381679;1;84;276;180;95;69;704
005996404935;1;164;210;118;74;87;653
093448836764;1;147;212;102;85;142;688
083151764354;1;206;165;135;89;177;772
077911318370;1;142;129;140;103;165;679
062325108325;1;215;166;229;93;91;794
046252728030;1;186;95;159;120;92;652
026724332879;1;247;110;222;65;90;734
030196870108;1;244;252;246;88;112;942
002209676147;1;123;256;226;96;173;874
062059436130;1;139;199;278;119;117;852
073809193240;1;110;253;256;79;136;834
004514038981;1;171;157;260;83;121;792
058073979579;1;244;102;200;54;118;718
078430914824;1;257;192;111;60;51;671
045649051895;1;278;82;266;114;63;803
005753380793;1;133;236;156;102;120;747
092753168094;1;185;123;181;117;90;696
092923952421;1;249;269;108;117;99;842
000909924647;1;215;277;285;106;138;1021
047691636161;1;168;159;170;120;171;788
076403718134;1;245;223;131;102;87;788
033886046138;1;82;201;98;58;173;612
096436360955;1;228;143;94;60;162;687
058340163300;1;185;220;183;58;78;724
066566368290;1;273;138;284;118;153;966
084142050135;1;142;281;142;119;91;775
087059505921;1;117;121;129;119;55;541
098493441713;1;234;236;184;75;53;782
092153345799;1;188;232;204;54;52;730
074623452279;1;178;224;300;75;88;865
043965799085;1;125;106;214;61;73;579
078629003930;1;141;125;165;117;53;601
004137443277;1;185;156;168;117;65;691
031701968747;1;129;210;283;86;177;885
019349243416;1;190;286;214;93;87;870
091170824127;1;280;116;140;84;73;693
027786309091;1;224;234;181;80;103;822
095214132939;1;183;280;224;76;73;836
018148465913;1;252;127;230;104;147;860
095304979052;1;269;280;194;113;133;989
030055732070;1;103;114;267;117;167;768
036927104613;1;239;243;180;74;89;825
023491973376;1;177;151;277;104;170;879
024799837208;1;254;122;246;113;153;888
089802905532;1;130;133;275;54;58;650
003094856405;1;191;127;241;111;157;827
048865282595;1;206;117;284;63;85;755
017153416189;1;120;227;281;74;112;814
063766022691;1;101;148;197;88;150;684
031524170478;1;188;266;177;111;58;800
023554020046;1;192;232;189;57;174;844
059667699515;1;286;241;223;94;78;922
047922924876;1;278;276;115;113;78;860
002280311333;1;235;283;94;106;109;827
004261573043;1;160;276;279;91;121;927
070371666734;1;150;144;187;60;115;656
058500520355;1;166;232;181;84;86;749
002598834034;1;81;221;300;56;58;716
039632423055;1;88;168;225;86;72;639
006442614200;1;239;167;194;90;103;793
018549000032;1;145;216;219;62;80;722
063810608182;1;243;194;292;118;159;1006
099598868599;1;113;81;207;52;69;522
040890353296;1;279;255;140;71;153;898
013015393736;1;121;252;288;119;61;841
011371557554;1;108;110;104;68;95;485
040686211052;1;253;151;295;58;151;908
068681579971;1;251;271;277;89;58;946
015587927567;1;100;147;212;100;146;705
074346619557;1;199;235;190;79;63;766
048555599698;1;174;169;248;111;103;805
085912549897;1;238;86;176;97;75;672
098214015754;1;167;200;234;64;106;771
047530803807;1;166;227;125;71;86;675
005785887593;1;224;231;122;106;127;810
082300264281;1;180;187;237;100;177;881
006137983884;1;170;231;171;74;59;705
092644460420;1;104;242;294;95;142;877
066162028039;1;282;108;175;107;145;817
004766179812;1;257;187;197;97;80;818
093276746141;1;197;119;156;77;146;695
048069557529;1;186;164;295;102;106;853
037580400329;1;101;286;114;51;143;695
034326166836;1;215;87;146;118;90;656
058177279636;1;202;155;277;100;124;858
072474627437;1;192;219;159;111;154;835
027545843720;1;146;283;245;91;77;842
036399361392;1;159;130;265;63;165;782
026402707149;1;91;86;147;113;50;487
073167333793;1;184;174;105;83;114;660
049181011208;1;118;183;289;71;76;737
046006581304;1;134;167;123;75;51;550
084385993106;1;153;180;259;110;126;828
049784399165;1;177;122;239;60;101;699
024321600466;1;176;278;213;117;151;935
002375820700;1;133;273;191;88;123;808
025636780055;1;174;281;146;119;154;874
008308252502;1;146;240;215;75;150;826
068530503395;1;173;246;122;117;166;824
053767837434;1;245;193;121;87;147;793
015961175664;1;224;250;236;105;124;939
022627465930;1;180;109;131;99;77;596
013063264960;1;248;255;263;109;166;1041
033227884563;1;268;185;295;88;69;905
097367493290;1;247;239;265;59;86;896
051680875663;1;235;246;228;92;67;868
055639357694;1;139;224;225;73;111;772
048257412429;1;222;233;141;105;103;804
075863067691;1;228;181;251;80;74;814
043421234693;1;138;161;232;99;159;789
015210221346;1;143;271;250;82;62;808
013945990859;1;129;185;186;104;124;728
043489596652;1;149;132;262;68;142;753
010397357806;1;256;176;242;77;133;884
015890572329;1;160;254;171;62;92;739
002743515305;1;265;194;278;54;159;950
089939616949;1;276;244;263;95;127;1005
088164015938;1;176;210;121;92;121;720
057023600714;1;292;141;220;68;87;808
051131646196;1;94;177;218;97;128;714
058421817569;1;131;242;167;96;170;806
099313382699;1;84;198;139;119;62;602
060003986779;1;248;221;268;88;134;959
015732994105;1;100;167;166;107;100;640
070061681092;1;163;248;298;66;65;840
085976051773;1;154;108;235;85;145;727
080532284138;1;244;87;263;104;177;875
057242905153;1;168;207;245;89;129;838
056108236239;1;290;139;206;112;132;879
029315601867;1;87;101;169;71;86;514
081994708150;1;100;190;136;86;147;659
028449585813;1;142;83;214;64;105;608
088733174480;1;145;268;123;102;131;769
019686693386;1;209;209;224;117;150;909
049971928166;1;119;183;140;80;72;594
024605735813;1;149;243;227;76;80;775
024133300796;1;178;97;221;116;96;708
012988556155;1;121;173;238;88;77;697
048336408158;1;247;225;130;83;127;812
088693594744;1;122;126;265;104;99;716
045817240854;1;124;135;283;114;124;780
057162565791;1;134;234;226;96;103;793
025459368524;1;198;86;217;56;64;621
010856690215;1;198;161;230;87;111;787
080681979469;1;292;106;235;106;155;894
083538645929;1;155;270;291;112;103;931
073066563371;1;143;215;120;114;134;726
037634299711;1;253;246;109;84;55;747
042610547672;1;211;158;233;96;66;764
078196878698;1;266;89;225;105;101;786
065652332200;1;122;81;270;65;56;594
049696153220;1;117;207;294;120;107;845
043854882077;1;214;177;182;94;63;730
017150553493;1;103;180;262;57;68;670
037176835774;1;96;256;200;97;99;748
022142832501;1;271;158;292;81;134;936
024514302087;1;241;107;202;65;131;746
040815582096;1;276;252;164;77;58;827
058225108873;1;87;271;141;108;120;727
013348103300;1;86;198;263;104;60;711
028815245682;1;175;125;126;93;116;635
084622750106;1;143;82;197;77;137;636
092900364978;1;290;166;186;63;153;858
010543070732;1;82;184;154;119;110;649
006375279048;1;185;85;103;74;148;595
015224590432;1;122;269;179;118;94;782
070765589979;1;268;195;192;75;143;873
009312886123;1;215;208;227;78;178;906
047767922475;1;215;219;279;117;107;937
096926568018;1;269;143;143;51;100;706
085625586126;1;188;88;286;106;141;809
035516525047;1;107;233;108;63;63;574
049388492529;1;176;160;109;81;153;679
021685240094;1;127;275;203;100;167;872
029013291756;1;136;120;142;71;55;524
004494064505;1;236;81;195;96;141;749
045579091516;1;228;279;153;111;162;933
083988444309;1;202;99;92;62;128;583
040285073516;1;111;215;175;98;152;751
023891254904;1;248;80;216;82;109;735
013710784306;1;82;113;199;81;93;568
058699201330;1;124;133;286;91;164;798
013020516473;1;80;81;208;80;120;569
084393843089;1;246;100;238;102;130;816
034571778311;1;164;143;275;106;103;791
019096218688;1;152;203;250;86;148;839
079832255923;1;208;134;208;119;107;776
020756084100;1;173;190;185;69;135;752
074348322828;1;170;262;193;64;145;834
007342009171;1;281;188;161;55;131;816
073290973384;1;99;262;130;59;146;696
071864895159;1;126;197;294;107;73;797
049882535390;1;103;284;250;58;120;815
002092674597;1;239;264;174;79;80;836
083600535672;1;272;185;119;85;168;829
038413660702;1;86;122;105;60;166;539
043154059270;1;158;120;282;64;101;725
062200342153;1;211;154;160;75;88;688
087813427059;1;229;101;175;51;144;700
018033718657;1;96;144;161;67;129;597
006428494803;1;214;230;254;103;146;947
068392915963;1;247;237;289;55;113;941
030198322452;1;225;192;155;109;90;771
023322144519;1;165;268;198;67;118;816
097893432074;1;206;198;253;70;133;860
048790094999;1;157;153;104;84;68;566
041795289846;1;188;175;104;73;172;712
097117577389;1;259;153;295;74;151;932
021293513446;1;159;156;221;98;54;688
016341710245;1;106;232;196;115;174;823
098405337121;1;103;109;236;99;84;631
091696580954;1;262;181;181;106;177;907
051761343516;1;154;247;193;74;162;830
085129580375;1;230;195;247;99;140;911
028791912563;1;139;141;285;110;51;726
022275581174;1;88;97;288;108;176;757
020492516313;1;246;121;106;62;126;661
019454628533;1;177;238;161;108;89;773
092986290210;1;102;214;100;97;122;635
002897184619;1;195;142;245;65;99;746
064822701185;1;185;99;257;53;68;662
084871095322;1;146;110;203;56;83;598
003949895082;1;202;141;135;94;130;702
017311647351;1;128;189;138;117;82;654
091241534021;1;151;260;103;65;154;733
082035571393;1;274;203;195;88;112;872
073317716333;1;140;115;131;101;60;547
045943797469;1;237;207;199;63;121;827
030460146959;1;159;113;120;97;164;653
092034470249;1;166;267;165;101;167;866
057267368935;1;114;112;221;106;165;718
054223147261;1;138;216;237;112;100;803
063758434242;1;207;94;183;93;175;752
021207770935;1;121;199;192;114;59;685
042230136792;1;95;175;205;113;122;710
081261779715;1;229;237;130;95;54;745
052294122730;1;128;265;206;116;140;855
011410300465;1;187;269;133;69;175;833
087015050791;1;160;225;126;71;60;642
099973523747;1;281;246;300;112;58;997
062207202165;1;284;274;254;110;178;1100
010672526633;1;122;238;119;57;56;592
070522204547;1;187;205;271;50;87;800
050222766002;1;215;192;159;120;144;830
050813003315;1;195;89;135;83;66;568
021421748253;1;278;269;147;106;150;950
089490397359;1;152;161;114;89;94;610
024967235030;1;286;149;263;95;79;872
006253634620;1;259;93;113;111;79;655
083381973162;1;214;259;127;96;170;866
004426511661;1;233;153;140;70;150;746
087853458953;1;129;185;186;95;157;752
066089515441;1;170;145;234;70;169;788
009023913455;1;267;103;241;70;178;859
087146923464;1;271;253;150;111;150;935
029046501788;1;83;139;171;95;88;576
018311824499;1;265;268;144;88;66;831
091472006049;1;253;84;153;76;115;681
084289379229;1;191;136;104;87;77;595
031199907297;1;96;249;280;120;135;880
066141174940;1;145;105;213;111;83;657
018140836715;1;230;157;95;92;113;687
056907332830;1;282;237;293;87;156;1055
084182473381;1;232;198;259;84;73;846
004475274811;1;224;180;111;81;173;769
097212719292;1;184;140;212;88;162;786
070290920510;1;148;82;242;50;130;652
037926233177;1;102;87;262;107;154;712
007064804935;1;191;179;241;57;85;753
036800457283;1;90;140;149;61;68;508
029856074086;1;115;113;149;61;126;564
092450798586;1;210;242;298;109;106;965
067855523243;1;82;148;279;65;108;682
070792285379;1;222;269;169;116;156;932
030995900425;1;288;245;249;98;50;930
051808369164;1;164;270;271;79;124;908
090888352590;1;117;132;165;70;112;596
092825106300;1;153;143;156;55;86;593
079069205905;1;157;147;260;61;162;787
004082910219;1;186;258;121;51;120;736
059000840495;1;268;98;296;92;160;914
030253052986;1;128;187;204;71;85;675
042717381586;1;93;274;285;53;119;824
069335089589;1;160;107;97;56;162;582
057879135318;1;106;207;115;53;80;561
056258061323;1;285;147;220;117;50;819
019219767773;1;169;275;248;103;75;870
094334677957;1;159;136;288;105;170;858
054794658471;1;89;93;248;83;86;599
000862123703;1;198;84;110;111;147;650
096842583620;1;86;112;138;96;112;544
083346748120;1;190;82;228;56;58;614
043359139517;1;127;222;128;101;83;661
099030398039;1;118;259;203;91;115;786
000660843841;1;231;154;289;81;122;877
026292212741;1;276;214;192;108;139;929
090404257402;1;160;209;156;120;62;707
014528500622;1;292;239;93;99;130;853
044279778727;1;270;108;291;114;85;868
034307440296;1;191;251;239;84;83;848
074231632423;1;85;267;266;88;83;789
053953801825;1;272;219;104;110;164;869
009701566743;1;125;152;202;91;50;620
079577789106;1;112;279;259;107;61;818
094346781417;1;149;230;143;66;175;763
023819000962;1;134;88;235;97;140;694
075317102674;1;126;230;276;108;109;849
035902317199;1;166;86;252;51;119;674
005861913946;1;130;223;241;108;154;856
072913827978;1;166;100;157;92;149;664
019341253708;1;273;206;269;79;98;925
074800002844;1;97;217;262;109;82;767
068238923142;1;197;156;224;83;76;736
014641233147;1;275;244;209;110;107;945
095767260075;1;127;240;230;57;174;828
081697612486;1;226;146;287;110;171;940
086567317301;1;143;140;268;94;79;724
044439774532;1;224;265;156;62;170;877
007429871765;1;288;165;217;54;153;877
072002833330;1;274;278;296;105;146;1099
036491378936;1;217;116;159;69;162;723
026884896223;1;174;274;281;70;83;882
045581315790;1;265;193;209;79;130;876
092380400776;1;176;93;240;60;159;728
061110056872;1;182;182;146;60;97;667
004344172704;1;245;208;106;87;154;800
008088236726;1;121;191;246;117;72;747
097273674594;1;82;169;196;71;131;649
084465820436;1;143;216;230;114;128;831
079308293951;1;264;264;238;78;82;926
064724557419;1;191;153;194;104;153;795
029447965940;1;111;199;186;66;177;739
018640470727;1;181;164;133;85;103;666
040177766478;1;178;166;229;80;75;728
058336885915;1;136;221;275;67;91;790
018278440161;1;124;144;272;64;95;699
071087956404;1;148;276;130;91;148;793
090319247711;1;192;282;264;64;152;954
049143473504;1;89;222;138;51;110;610
035562644895;1;103;236;227;106;170;842
090318608798;1;156;227;134;82;88;687
022441100765;1;229;206;185;68;78;766
085389269207;1;196;219;104;58;87;664
022907458111;1;106;204;258;77;100;745
069414846674;1;189;201;102;90;151;733
067389840307;1;275;169;296;99;136;975
031209126942;1;187;100;107;104;117;615
019644932937;1;251;216;265;76;113;921
055925675480;1;280;136;106;107;161;790
010112793107;1;123;99;164;94;153;633
098315114429;1;97;193;225;108;127;750
043523040852;1;115;133;140;102;156;646
070977006633;1;186;275;113;51;72;697
023613694485;1;89;203;264;80;157;793
055367809922;1;174;104;272;96;175;821
016757376774;1;141;164;175;87;142;709
073099282405;1;175;102;112;65;169;623
053831826278;1;253;279;205;91;162;990
012301942048;1;153;253;216;105;72;799
073757653682;1;210;145;155;113;131;754
007228369963;1;103;205;138;51;114;611
073666833044;1;193;220;226;52;56;747
011716038378;1;177;189;194;81;132;773
013757777928;1;230;142;248;120;174;914
044683119366;1;252;251;249;87;55;894
024874890772;1;292;149;219;62;72;794
015625965155;1;98;228;145;74;163;708
027406317649;1;292;159;222;91;128;892
047450501263;1;103;210;229;85;104;731
001899636047;1;259;164;199;82;167;871
040018285432;1;190;99;180;99;87;655
036280299364;1;179;249;291;53;61;833
077715512448;1;182;271;179;120;110;862
077506733733;1;126;91;281;89;67;654
092045178901;1;233;129;241;54;114;771
073720091072;1;80;238;181;63;98;660
099467331217;1;144;258;293;103;177;975
054142918230;1;257;196;160;116;109;838
079461739389;1;95;228;98;80;75;576
072009864622;1;226;273;238;58;158;953
063768047039;1;113;147;194;57;93;604
005150736179;1;106;238;181;64;65;654
017090015811;1;239;148;215;113;70;785
040973737398;1;159;285;281;52;69;846
032698748735;1;236;223;177;51;140;827
095897221342;1;175;81;163;112;82;613
030421193642;1;171;249;269;110;53;852
030400247073;1;221;213;256;66;86;842
034215121085;1;274;190;130;102;117;813
089999340319;1;286;286;298;63;175;1108
016450563760;1;192;269;287;115;112;975
020577416926;1;141;91;229;50;155;666
099838125541;1;210;237;235;79;156;917
063034707896;1;192;229;171;50;67;709
071983586524;1;180;189;174;108;124;775
004392656117;1;156;232;298;104;60;850
022877601177;1;162;99;149;119;74;603
096973034914;1;129;168;270;116;129;812
098347915698;1;174;216;193;71;88;742
002833356767;1;265;204;217;90;61;837
051601365330;1;172;194;107;114;127;714
077198091795;1;130;123;130;85;177;645
043464621989;1;292;195;176;103;99;865
049183672663;1;200;96;167;58;99;620
043594430368;1;146;142;247;109;70;714
084287216717;1;146;158;283;63;147;797
049896527431;1;146;176;206;59;94;681
099443256420;1;180;194;140;53;150;717
005686789212;1;264;92;263;66;133;818
008399592428;1;209;193;206;81;75;764
053114567563;1;281;266;244;91;84;966
058402339498;1;164;132;284;80;151;811
090515955700;1;261;278;279;86;169;1073
028048243843;1;118;127;188;76;117;626
056950844285;1;114;136;202;113;113;678
020263002804;1;190;132;132;114;123;691
075733088214;1;120;171;253;115;69;728
062205314983;1;158;155;153;61;86;613
067152561978;1;281;83;170;86;105;725
081810254369;1;90;256;210;118;138;812
020399097737;1;96;159;240;110;108;713
051034821024;1;133;251;121;72;146;723
011548656063;1;162;164;271;85;121;803
044905187812;1;86;189;136;117;136;664
030412795931;1;116;227;115;98;79;635
061267217305;1;129;239;123;102;105;698
023768289730;1;100;258;186;103;122;769
038161745840;1;167;132;300;76;74;749
094510994268;1;225;173;233;86;174;891
039064955053;1;108;277;275;70;159;889
013721587683;1;92;155;138;98;110;593
053578219507;1;246;232;230;114;130;952
005129698943;1;129;224;230;69;128;780
054079951261;1;145;179;195;60;66;645
076053549350;1;134;154;147;120;115;670
040167968685;1;169;225;188;80;86;748
032329055972;1;182;157;200;62;75;676
018901466841;1;144;182;121;78;76;601
057753887546;1;204;142;253;53;147;799
092275841233;1;128;216;260;98;167;869
008617327047;1;258;271;222;108;59;918
024277950394;1;104;255;282;75;100;816
025418499653;1;168;246;195;105;133;847
052418360544;1;86;132;240;82;126;666
034044828700;1;85;179;144;81;144;633
099010069451;1;146;180;213;89;69;697
023857733980;1;150;193;230;99;171;843
047789478078;1;85;247;297;74;163;866
044717441724;1;140;260;160;107;166;833
066832545911;1;266;257;171;85;170;949
038149033677;1;108;262;289;86;94;839
043853547733;1;116;124;123;69;86;518
008680911366;1;178;138;105;117;142;680
014505549723;1;108;96;167;111;54;536
018807129234;1;155;276;213;51;58;753
009998463870;1;144;218;255;55;151;823
078097696828;1;184;282;141;65;108;780
057352189156;1;254;272;180;102;61;869
047795537928;1;105;195;128;72;66;566
097520194208;1;285;261;251;111;86;994
045823872540;1;223;107;237;52;65;684
091634143169;1;254;140;146;94;97;731
061774358222;1;132;132;191;56;81;592
002838305904;1;148;266;265;92;92;863
042760560483;1;245;129;106;105;130;715
047665534224;1;249;251;203;97;104;904
092637865158;1;213;229;279;95;170;986
065747652358;1;138;278;145;55;132;748
078055124612;1;166;233;170;118;111;798
046930206590;1;131;240;176;58;127;732
085626480538;1;93;96;98;55;93;435
060557426166;1;127;88;148;82;177;622
003454360550;1;258;135;240;101;98;832
059565513044;1;192;239;99;62;91;683
097317133447;1;192;239;296;78;170;975
024643447305;1;97;241;213;54;143;748
050981327148;1;270;106;279;120;56;831
067399036746;1;109;187;154;65;149;664
006660141551;1;255;182;185;70;122;814
090834561589;1;208;88;276;70;57;699
034757445255;1;168;273;113;56;104;714
000666454687;1;278;198;149;80;63;768
042014729349;1;283;205;138;80;74;780
008659933336;1;258;138;159;59;127;741
067222324692;1;225;88;167;61;133;674
078613199226;1;155;220;146;51;149;721
020710891949;1;169;172;108;73;81;603
075933649509;1;176;218;255;99;123;871
077093734724;1;172;259;113;92;57;693
073376166123;1;152;249;189;115;104;809
080250255010;1;82;172;113;105;151;623
011115129022;1;227;107;281;114;172;901
061951013027;1;166;157;119;54;119;615
029374247131;1;158;251;113;111;168;801
059819185957;1;236;149;232;115;133;865
080992313484;1;89;196;137;87;65;574
061159494932;1;127;183;249;80;82;721
031348320729;1;188;213;95;60;80;636
074875769994;1;219;198;275;96;121;909
033718110558;1;254;180;288;102;79;903
004105642143;1;209;217;113;94;159;792
094325442719;1;118;181;183;78;68;628
013374753450;1;240;155;215;79;170;859
020149527169;1;218;279;96;65;175;833
096274756452;1;214;230;247;73;103;867
060311926578;1;194;108;265;61;107;735
031845020948;1;120;218;95;57;108;598
000249450514;1;256;137;144;96;148;781
031836133622;1;183;148;139;65;89;624
028238894397;1;82;96;299;88;170;735
001566922447;1;272;288;261;106;61;988
075043386515;1;174;164;300;112;119;869
004504432290;1;158;85;239;77;107;666
021472298301;1;272;176;217;112;50;827
036828782072;1;289;282;106;114;143;934
094845596640;1;204;238;138;117;144;841
040458030587;1;131;198;269;120;101;819
055512295084;1;102;251;202;110;117;782
015185814843;1;132;171;169;72;83;627
047831580236;1;106;140;164;89;174;673
076571466290;1;289;133;140;60;170;792
016142138923;1;271;246;236;106;99;958
016545715033;1;218;86;219;60;100;683
084380037416;1;177;108;288;88;148;809
073530578826;1;268;253;214;99;163;997
045726656450;1;151;181;164;104;117;717
057470414927;1;269;239;249;60;158;975
003346282716;1;117;174;272;113;136;812
084624146377;1;222;170;261;101;128;882
040193131968;1;81;160;184;95;58;578
096338572781;1;181;196;104;74;145;700
037913152424;1;110;257;142;92;92;693
075426854545;1;136;195;162;101;86;680
076212830128;1;280;255;264;91;69;959
075117746022;1;245;147;159;111;141;803
057760529985;1;111;229;280;101;73;794
008170408015;1;128;166;215;75;135;719
081219802000;1;152;245;137;94;101;729
028164036877;1;104;97;270;62;96;629
062845473268;1;268;174;132;114;170;858
032141350787;1;131;269;240;114;163;917
009366881124;1;194;84;215;106;98;697
032155788607;1;98;174;280;111;174;837
038561973953;1;232;143;113;91;141;720
044794181848;1;96;264;210;95;115;780
030019942138;1;102;269;145;69;58;643
000688980903;1;227;212;209;115;102;865
065884010014;1;269;162;269;68;153;921
081293652205;1;282;223;153;84;109;851
035549470808;1;164;178;254;79;145;820
009844602033;1;119;262;143;99;94;717
002028801236;1;155;136;140;53;103;587
050183602821;1;265;260;193;74;151;943
055021621290;1;116;176;138;98;164;692
057313907088;1;224;134;187;87;85;717
020862873955;1;173;179;192;103;108;755
011475745806;1;164;170;115;74;88;611
006991376374;1;96;103;136;97;153;585
067813512540;1;98;127;219;68;80;592
074281740471;1;112;90;184;107;126;619
006419846800;1;286;187;139;99;134;845
087499602429;1;156;270;268;86;97;877
010306205003;1;125;130;114;69;147;585
065103302807;1;208;203;161;70;165;807
099641208718;1;119;181;117;111;168;696
051169846205;1;230;265;201;51;51;798
024108624443;1;281;211;204;100;73;869
086734533712;1;273;147;113;82;61;676
007980791806;1;219;154;125;58;98;654
009451356474;1;113;280;92;64;62;611
069460128114;1;214;127;113;92;86;632
063659016872;1;109;113;266;63;103;654
054723112921;1;192;180;199;55;100;726
009017425360;1;188;144;209;58;175;774
081132893545;1;194;126;247;77;169;813
021014014592;1;96;85;255;120;178;734
038805426582;1;90;184;191;108;117;690
079955558389;1;153;167;274;56;105;755
082407972277;1;224;206;286;70;55;841
002762196518;1;82;93;232;92;72;571
079123194608;1;203;271;256;111;168;1009
024673756091;1;240;159;233;101;79;812
059983899734;1;101;159;216;115;169;760
019693546867;1;169;280;124;86;151;810
056280682544;1;183;102;180;67;176;708
050399823463;1;189;226;170;96;164;845
091203872833;1;130;179;173;66;158;706
043688083014;1;121;286;168;64;133;772
043750665014;1;83;85;212;70;174;624
093220810643;1;257;204;168;88;153;870
062676518700;1;234;87;276;93;149;839
060325743795;1;220;145;221;80;127;793
084307062068;1;117;204;192;114;174;801
005566730232;1;154;162;288;105;177;886
085388003842;1;144;100;173;106;144;667
066510238847;1;235;154;241;101;146;877
012017599914;1;123;165;183;56;75;602
048609684275;1;270;244;190;60;64;828
083992551217;1;270;200;138;62;124;794
098900209057;1;153;144;297;73;76;743
026263816305;1;281;139;287;107;140;954
000615083110;1;258;101;257;101;129;846
024991418027;1;104;152;283;119;51;709
099303334811;1;291;202;104;70;75;742
083629350557;1;153;147;162;99;90;651
070460174133;1;177;251;262;56;136;882
063965957882;1;135;117;151;72;111;586
050386254594;1;239;239;218;114;143;953
049733611898;1;205;161;246;96;121;829
006004907817;1;286;283;155;54;145;923
039031786581;1;239;199;94;119;128;779
099675382959;1;241;261;298;75;89;964
021656532541;1;169;91;245;68;61;634
003833083290;1;117;120;95;109;115;556
066277510975;1;171;285;161;62;63;742
033745477903;1;151;154;250;54;169;778
082664927891;1;168;85;265;119;93;730
082966916694;1;286;166;293;75;109;929
038374171755;1;129;115;144;64;104;556
087482140236;1;220;129;108;72;95;624
004831020556;1;151;255;174;76;74;730
046084760893;1;102;208;165;63;115;653
019941390762;1;82;144;253;110;59;648
083650378167;1;140;122;218;69;117;666
039444099368;1;165;127;205;120;68;685
048893346716;1;117;148;233;115;149;762
083610762385;1;87;178;277;73;81;696
061106085821;1;207;265;247;92;141;952
030051793214;1;225;155;273;118;64;835
017720629144;1;291;112;150;98;126;777
050708063873;1;220;275;175;99;116;885
027627487752;1;279;280;292;85;169;1105
040678954830;1;207;217;205;90;117;836
006553926258;1;86;196;222;115;80;699
060788447811;1;198;269;199;90;154;910
054734420578;1;132;80;220;88;55;575
018759629366;1;137;241;298;120;63;859
078872360723;1;249;98;114;73;135;669
035798248606;1;141;94;178;74;104;591
084361756329;1;263;161;175;71;133;803
035121668564;1;286;183;220;70;55;814
089723116193;1;87;251;269;65;50;722
030973268929;1;103;99;99;82;77;460
057772418552;1;98;136;154;110;148;646
023223025034;1;226;107;276;80;54;743
013337786832;1;283;242;209;88;76;898
060233383190;1;164;166;286;63;149;828
005548496567;1;241;85;285;71;51;733
042397827256;1;86;128;277;109;141;741
091591067857;1;101;111;97;94;167;570
025170429013;1;270;164;148;76;136;794
004089006215;1;289;228;275;57;137;986
037939100755;1;214;278;263;63;115;933
069442655430;1;282;209;93;50;104;738
072551886682;1;135;151;132;78;89;585
037483904583;1;246;195;179;50;94;764
009277944664;1;240;252;220;93;155;960
084028571176;1;127;190;255;106;172;850
061030637906;1;268;253;262;118;102;1003
085212694918;1;224;176;257;103;68;828
033119247763;1;205;93;300;70;144;812
014690795855;1;108;230;287;59;118;802
007166735340;1;251;147;219;96;67;780
026974493493;1;81;122;240;114;81;638
011526473864;1;81;114;137;88;75;495
061894767945;1;186;230;106;98;86;706
092212977497;1;157;107;92;87;61;504
053568285395;1;177;264;165;102;159;867
099865954272;1;288;141;163;51;74;717
009403913569;1;112;288;106;71;60;637
065977676837;1;127;166;219;106;160;778
089137718063;1;239;93;95;62;156;645
056456674026;1;211;127;126;60;101;625
088386866943;1;269;213;127;69;140;818
081430451042;1;250;121;181;115;57;724
033536930009;1;198;161;209;63;123;754
054350136349;1;227;97;185;84;74;667
060187786860;1;104;263;230;67;82;746
043608277332;1;132;205;159;80;80;656
083068168183;1;212;177;92;51;157;689
087890186053;1;277;232;120;55;95;779
011069669782;1;84;161;220;102;108;675
077257685442;1;222;245;114;51;57;689
006127039998;1;210;96;118;91;132;647
012753095938;1;80;143;274;77;107;681
089479902767;1;85;95;198;94;91;563
069354507809;1;141;100;258;111;111;721
093236672352;1;151;237;205;108;51;752
076191630036;1;196;221;184;99;108;808
091753157502;1;263;128;165;90;76;722
025601508398;1;184;114;283;98;147;826
032250515391;1;123;191;230;82;74;700
019147743909;1;271;119;132;90;51;663
099080529603;1;188;284;293;76;134;975
028201014895;1;90;252;235;106;135;818
062337584985;1;180;211;173;51;170;785
031282807837;1;140;94;106;65;156;561
028093811131;1;131;212;266;117;153;879
057183121811;1;89;212;288;77;92;758
080920440662;1;203;111;235;58;144;751
065956039332;1;208;182;265;110;157;922
028345539349;1;152;204;186;119;124;785
039708430906;1;266;112;151;100;157;786
032415342218;1;125;215;251;115;133;839
088196990961;1;185;145;226;80;103;739
011215588633;1;172;249;225;114;156;916
028723433887;1;224;270;147;76;124;841
088833045759;1;110;141;155;89;130;625
001796165433;1;81;186;120;68;96;551
012050717627;1;274;199;102;112;56;743
018239082322;1;289;89;170;119;123;790
009629216289;1;89;89;185;63;153;579
092666407220;1;108;178;218;86;148;738
009393873622;1;139;111;223;68;101;642
040739305225;1;85;222;159;80;140;686
033019779901;1;121;224;296;69;57;767
066420431733;1;207;212;210;63;153;845
008298171554;1;101;129;182;114;155;681
009417017884;1;281;117;131;92;167;788
058776790873;1;134;86;112;73;174;579
038343255759;1;196;99;110;86;113;604
045716687167;1;216;260;267;73;93;909
019445005959;1;111;92;160;102;117;582
060771714921;1;289;94;135;94;139;751
098841989129;1;249;121;91;108;108;677
038266249930;1;269;279;115;92;75;830
066880524508;1;287;178;126;76;103;770
086308315141;1;110;128;201;106;122;667
001691664225;1;226;224;115;105;57;727
059119916765;1;186;222;230;102;123;863
077475039853;1;176;104;211;109;73;673
099013495320;1;134;245;297;62;130;868
056809497979;1;163;85;233;51;94;626
001271469628;1;246;158;232;95;110;841
055395744094;1;243;208;264;109;149;973
070683119761;1;95;225;283;50;68;721
068751230030;1;207;227;177;84;91;786
007609958529;1;201;125;299;93;174;892
024343112255;1;224;267;182;78;59;810
096804379169;1;280;170;161;62;138;811
090949186163;1;238;92;112;87;117;646
071820816827;1;130;159;225;84;76;674
054498827045;1;217;173;297;99;160;946
060202355802;1;208;173;201;57;178;817
098178860507;1;108;138;175;95;62;578
070171907281;1;218;216;182;53;95;764
032184507593;1;197;83;250;118;165;813
063885455971;1;112;121;285;52;125;695
009764775103;1;259;215;137;99;145;855
086301200572;1;283;244;204;83;102;916
035055635982;1;233;87;92;65;123;600
038138140026;1;167;112;269;98;110;756
005206245880;1;99;160;164;100;153;676
036136915042;1;199;141;250;61;90;741
047209866860;1;188;105;199;112;96;700
091144615661;1;225;159;168;119;74;745
022480002093;1;285;88;127;120;100;720
097903073434;1;143;98;100;103;172;616
044003153440;1;162;93;106;57;122;540
026301404191;1;190;232;210;81;87;800
056108585341;1;269;221;220;67;152;929
079150069709;1;189;133;251;100;129;802
074319440184;1;270;161;159;98;169;857
059615724443;1;154;81;170;83;83;571
060224164231;1;195;99;114;56;73;537
006620389670;1;85;89;298;91;53;616
091323455944;1;102;95;118;109;112;536
055708845411;1;215;269;266;96;165;1011
019807108992;1;113;257;187;67;83;707
069758452366;1;180;183;271;74;91;799
073019875494;1;166;241;269;71;119;866
025795147047;1;176;97;150;79;99;601
000926769402;1;265;179;149;103;102;798
079021419448;1;138;278;177;69;132;794
020635886898;1;167;188;91;107;144;697
020338903874;1;87;126;94;53;101;461
000195632819;1;164;214;117;102;105;702
087008650877;1;269;284;250;75;51;929
069492595748;1;182;208;93;57;153;693
017729022116;1;82;135;235;71;56;579
074959611369;1;277;141;202;75;96;791
068943921950;1;199;207;267;113;153;939
071116006397;1;212;89;220;110;156;787
053919236970;1;240;264;281;113;116;1014
076210096227;1;163;179;95;59;116;612
048190364863;1;175;163;256;86;93;773
044785412985;1;133;174;244;84;55;690
033332042717;1;278;252;279;102;92;1003
021044329828;1;278;183;123;93;91;768
070085075470;1;135;198;258;106;75;772
081449047660;1;114;271;169;79;146;779
044956632738;1;127;193;116;99;133;668
022023045142;1;92;284;90;103;92;661
037936761278;1;208;106;296;113;150;873
078890222942;1;292;88;113;56;144;693
086625157374;1;184;124;252;81;98;739
020375682052;1;149;211;178;53;90;681
012281067430;1;95;268;240;120;154;877
058616334951;1;206;139;223;116;124;808
074835040300;1;290;268;96;86;83;823
093996077909;1;149;213;222;100;83;767
014510504414;1;285;170;182;64;89;790
030649219853;1;287;244;287;54;85;957
080807398097;1;98;226;231;54;158;767
084559149120;1;133;110;156;67;115;581
085416775764;1;199;178;277;89;85;828
041850171580;1;108;153;122;76;145;604
069382503194;1;159;228;151;104;90;732
014216773744;1;92;104;244;94;63;597
044298880103;1;289;202;155;83;77;806
037627945970;1;94;260;286;98;110;848
038144515709;1;132;283;195;68;92;770
047893712783;1;205;173;122;66;53;619
029004384983;1;146;228;141;93;150;758
061746802882;1;92;94;256;55;84;581
027459648251;1;101;226;163;74;167;731
055651323340;1;204;110;297;63;164;838
039476695743;1;90;262;271;114;54;791
001053865976;1;126;113;277;114;62;692
069115218051;1;151;196;195;74;170;786
064935774250;1;155;236;201;61;71;724
034657758335;1;286;80;150;84;169;769
048171808423;1;132;132;257;80;123;724
087368332951;1;138;121;219;82;114;674
073209004330;1;138;183;174;81;152;728
085957212919;1;224;168;195;101;70;758
023414173297;1;140;251;256;70;82;799
079357911382;1;216;275;244;74;109;918
014543081312;1;152;102;171;93;98;616
086261610975;1;83;167;167;66;134;617
077213299635;1;111;141;244;67;177;740
078946855095;1;196;157;296;68;125;842
069709410092;1;90;162;179;66;134;631
011497037679;1;163;98;132;89;54;536
028034858443;1;178;182;104;63;95;622
073483855711;1;238;174;234;73;88;807
044690315223;1;268;225;270;65;172;1000
037042053825;1;291;224;183;50;110;858
070755696748;1;128;240;262;62;54;746
013679938612;1;190;180;194;109;125;798
034855044970;1;250;249;230;99;151;979
080664537008;1;156;109;91;67;169;592
063254267495;1;139;147;241;104;103;734
057863926417;1;265;250;248;97;157;1017
042368023612;1;89;285;91;80;95;640
013454698687;1;290;150;161;95;104;800
052064874426;1;191;88;214;86;144;723
016030421238;1;290;117;278;76;177;938
023531085340;1;81;188;256;117;116;758
021175188757;1;93;135;149;69;51;497
044418270706;1;292;114;253;89;152;900
069005028734;1;210;265;258;87;70;890
068925890859;1;126;208;204;119;94;751
001993950386;1;171;261;164;56;155;807
052666388736;1;145;104;298;68;75;690
044286522296;1;134;167;178;50;119;648
010621793756;1;260;114;265;96;115;850
089420506093;1;240;233;213;58;121;865
006177244171;1;229;231;290;63;126;939
026470099967;1;147;106;264;59;168;744
022079132876;1;196;102;289;52;83;722
055423987741;1;156;144;179;90;69;638
096892837559;1;98;190;126;92;127;633
021532776688;1;224;197;115;81;152;769
006259820391;1;273;111;152;50;90;676
040010489037;1;201;119;146;109;85;660
049752493921;1;279;186;135;97;162;859
016645758563;1;95;282;171;114;60;722
076438751325;1;220;148;123;64;59;614
055328957587;1;210;99;258;105;166;838
084503370753;1;267;86;161;107;59;680
066772478653;1;107;210;183;70;108;678
011551474123;1;126;188;266;82;76;738
078689589265;1;123;97;267;72;103;662
002312094361;1;247;85;249;94;114;789
071268976156;1;139;223;216;112;116;806
000532149386;1;215;235;162;71;91;774
081741703343;1;193;82;110;81;166;632
019885160570;1;197;270;194;79;107;847
087687043535;1;140;165;241;95;87;728
064595476780;1;133;154;112;94;145;638
090494952309;1;242;157;146;73;109;727
084397465796;1;147;246;137;80;99;709
019728865092;1;263;91;271;99;98;822
061151053603;1;169;256;173;67;120;785
034883667567;1;131;260;98;118;164;771
011489699704;1;162;105;132;70;174;643
022543426119;1;172;133;124;109;146;684
041210910411;1;132;248;146;119;104;749
056284913911;1;102;115;145;59;75;496
002454081621;1;276;119;198;72;170;835
075363400214;1;85;261;289;107;58;800
052614261181;1;144;88;168;103;127;630
007435967504;1;243;103;228;98;170;842
089717336744;1;281;251;95;97;73;797
000287107536;1;138;275;220;116;79;828
082866545079;1;292;270;163;61;100;886
015665298784;1;163;239;253;108;54;817
059922027094;1;268;182;102;74;83;709
005792886996;1;141;211;160;83;102;697
087972108885;1;170;152;248;53;78;701
061948990485;1;189;105;161;74;127;656
079318003329;1;166;129;244;71;54;664
051771848245;1;155;250;192;88;82;767
097177112380;1;275;274;162;114;177;1002
029102120988;1;81;259;205;113;150;808
094324397384;1;119;137;102;83;177;618
072948732823;1;123;270;202;69;88;752
089285830541;1;274;179;269;51;112;885
004458214794;1;177;279;268;62;55;841
017038100560;1;267;99;176;97;162;801
060724983344;1;198;228;130;94;81;731
004812278405;1;199;133;158;113;170;773
071358369869;1;229;276;231;75;53;864
044703280113;1;265;254;298;73;102;992
003079001118;1;94;104;115;91;157;561
010201245735;1;95;160;96;100;85;536
061283800149;1;158;106;162;92;121;639
044681461885;1;254;181;204;115;108;862
003756414912;1;121;163;285;61;86;716
031826202391;1;290;266;199;111;107;973
043222340253;1;120;252;163;92;86;713
042829739665;1;280;83;102;110;98;673
021875156257;1;259;175;286;61;55;836
095317531344;1;280;137;243;102;120;882
027439343248;1;274;215;198;91;89;867
087416610951;1;154;100;122;102;51;529
046248888993;1;119;250;174;70;134;747
051177200139;1;172;233;195;54;107;761
065211741533;1;179;138;140;63;124;644
048624261814;1;192;217;108;103;124;744
047411453170;1;119;185;120;88;94;606
007512802710;1;104;144;101;90;128;567
071229776075;1;277;287;132;53;94;843
070549193583;1;150;256;214;105;68;793
060590273985;1;224;227;93;114;122;780
080945759797;1;203;217;264;65;69;818
078332540005;1;244;154;96;51;66;611
024167340210;1;136;123;111;65;93;528
075862410337;1;123;205;123;75;52;578
030502198315;1;184;253;268;60;54;819
028781001468;1;255;281;173;90;156;955
067484731811;1;168;148;262;78;58;714
014070731637;1;108;166;138;64;113;589
070425828468;1;227;213;260;70;150;920
052783644404;1;145;199;130;105;108;687
011195355130;1;223;179;187;93;172;854
035822353360;1;198;107;92;85;152;634
046669624626;1;120;162;284;98;63;727
029665338581;1;247;190;291;89;139;956
077146056788;1;107;280;123;67;74;651
014202887674;1;290;128;217;83;95;813
091308493340;1;167;136;193;107;65;668
039484885052;1;253;212;154;86;72;777
001018603812;1;127;202;180;53;65;627
038293749638;1;99;228;112;77;172;688
092557479994;1;136;203;171;111;144;765
090320011797;1;155;226;206;82;110;779
065153094178;1;282;110;108;69;101;670
086882517578;1;138;183;238;113;114;786
022560150914;1;243;143;103;109;152;750
098036185527;1;168;281;167;72;65;753
095074832233;1;232;225;190;84;170;901
037411471933;1;145;191;269;86;138;829
011131795319;1;90;123;109;57;101;480
014912785310;1;230;265;261;92;68;916
059160500954;1;126;230;189;88;78;711
036484639551;1;197;263;221;105;111;897
034090454573;1;283;167;189;82;164;885
096343104119;1;267;195;253;101;103;919
021683068449;1;126;286;179;54;169;814
039495090026;1;111;254;241;56;64;726
046525955020;1;139;270;101;120;167;797
055456693855;1;265;265;185;102;152;969
070419351115;1;241;98;143;100;171;753
046729190133;1;145;84;104;57;53;443
067154764298;1;166;205;91;52;100;614
095080837366;1;111;184;275;58;51;679
096371457654;1;127;256;152;71;50;656
059506485295;1;112;288;162;53;144;759
001579071728;1;124;148;195;57;155;679
032429662162;1;103;239;127;107;131;707
014806238955;1;162;159;145;92;66;624
063157260231;1;284;186;243;94;91;898
031458515065;1;227;259;154;101;74;815
012882167758;1;141;245;94;101;129;710
037239432079;1;188;126;130;78;96;618
031741867016;1;125;123;274;67;84;673
096246017743;1;198;273;92;51;70;684
057481815436;1;266;142;182;85;89;764
079254694054;1;244;236;272;102;168;1022
079874349908;1;222;135;99;105;140;701
083183847896;1;228;110;282;88;57;765
029460015239;1;196;168;215;108;110;797
047851904070;1;147;165;157;115;151;735
064376767438;1;212;223;214;115;101;865
027410965776;1;87;107;221;120;134;669
084581138530;1;110;175;150;110;163;708
095622437637;1;188;253;293;111;124;969
053681008039;1;268;200;273;69;76;886
018029295149;1;172;237;239;60;53;761
050433503682;1;274;198;174;111;126;883
030493290506;1;240;160;255;56;50;761
097763521920;1;189;93;151;76;55;564
082285623186;1;176;245;206;64;137;828
075511497069;1;193;277;299;73;139;981
046121285286;1;188;107;185;81;115;676
055628917387;1;270;250;270;65;83;938
070242248244;1;265;187;269;56;98;875
043437252519;1;85;134;244;55;111;629
010586683016;1;126;130;189;76;131;652
023947562085;1;211;169;203;62;72;717
076063676412;1;143;203;248;64;77;735
085032683217;1;97;98;167;59;92;513
068834147400;1;134;95;281;63;61;634
056457850599;1;228;274;194;98;102;896
098816948096;1;203;184;279;76;62;804
003371908357;1;158;130;278;108;151;825
051133811221;1;241;150;214;64;130;799
081342300143;1;266;260;130;111;61;828
001893747657;1;222;154;113;110;72;671
019252340050;1;142;242;154;112;77;727
092868480605;1;282;114;160;96;140;792
076472511712;1;266;107;131;114;137;755
040956517079;1;254;241;100;113;100;808
038505882172;1;149;191;286;53;127;806
084198568327;1;273;262;214;82;51;882
059713942131;1;84;202;189;95;72;642
098535774722;1;196;221;190;67;172;846
042018644424;1;184;239;181;104;65;773
034208874901;1;258;240;188;70;80;836
099486978961;1;282;115;175;88;178;838
051670896713;1;233;100;117;91;136;677
055699511938;1;236;199;124;94;176;829
049781413674;1;232;148;269;100;88;837
048815801989;1;263;246;268;100;172;1049
020413228980;1;276;188;172;93;88;817
075987577487;1;122;80;166;98;147;613
095550086363;1;190;80;118;96;86;570
009517813861;1;157;175;202;99;157;790
005057596032;1;230;100;231;112;139;812
060798232978;1;133;269;190;103;56;751
030528595483;1;94;193;172;116;142;717
020401849038;1;194;145;215;75;114;743
066269036976;1;159;244;297;101;90;891
039885157395;1;259;144;182;115;77;777
005286964301;1;215;146;184;80;125;750
057821461796;1;239;194;254;74;139;900
077665426751;1;256;210;221;68;176;931
077393517452;1;116;178;229;74;78;675
056891762359;1;160;146;158;73;111;648
061294025615;1;179;255;187;91;56;768
053367313375;1;110;163;264;116;77;730
001665661700;1;106;262;294;66;109;837
005655910159;1;216;124;188;72;153;753
083173151668;1;135;223;237;71;178;844
067689732302;1;259;274;269;92;170;1064
023387182720;1;251;205;192;60;70;778
050379134094;1;127;171;249;116;70;733
092623919166;1;126;271;149;72;62;680
063112072041;1;136;274;153;73;68;704
044318883672;1;253;177;181;58;144;813
013151798818;1;283;239;206;115;76;919
054672645570;1;226;143;233;117;94;813
064175901303;1;229;279;293;116;78;995
099052657874;1;208;199;264;73;89;833
032499495011;1;229;196;193;92;126;836
047777794132;1;111;194;253;75;119;752
005555563840;1;153;107;190;85;105;640
044424506428;1;246;124;156;114;139;779
008548723076;1;284;161;277;69;175;966
094106985964;1;126;107;107;96;141;577
054285732053;1;165;119;238;81;102;705
071407836443;1;139;91;232;50;117;629
051160005459;1;163;98;101;96;52;510
094389001298;1;275;111;158;92;134;770
069356602823;1;119;118;220;75;138;670
039478947259;1;202;275;263;88;126;954
000450812302;1;242;215;97;75;65;694
041709333598;1;121;234;247;96;111;809
076634323041;1;99;212;240;87;109;747
067715546191;1;99;177;272;91;101;740
009951910716;1;267;203;210;116;117;913
042223225925;1;85;242;124;63;59;573
072930150173;1;255;111;231;80;153;830
054119201205;1;225;114;293;89;152;873
086215514755;1;193;199;280;84;93;849
015074420090;1;207;124;150;97;92;670
090186851124;1;161;256;201;102;52;772
020160242905;1;141;160;273;84;66;724
003259573847;1;224;148;277;71;106;826
000578182028;1;125;149;296;86;52;708
087779774902;1;270;158;113;70;148;759
066913765303;1;183;80;228;71;156;718
080460017963;1;248;173;126;94;129;770
069897370939;1;169;213;121;99;85;687
022691359223;1;148;237;271;80;70;806
008630865825;1;147;193;256;115;125;836
048513604963;1;264;266;199;56;57;842
094471731283;1;271;286;142;95;73;867
064185396443;1;189;88;106;81;142;606
010060474263;1;283;183;297;72;170;1005
061735361489;1;250;135;164;116;177;842
006487809666;1;178;161;173;88;135;735
014738490446;1;220;111;140;117;178;766
077842496833;1;223;233;252;74;58;840
039398429906;1;165;126;109;50;151;601
066332621577;1;108;223;169;84;139;723
011355747904;1;210;159;268;81;129;847
061592241443;1;289;268;245;62;136;1000
034578765284;1;168;220;194;102;116;800
058900086822;1;195;122;267;72;125;781
041363757946;1;274;145;95;104;84;702
092237000622;1;165;89;157;77;94;582
074771560279;1;128;269;274;90;79;840
073600664958;1;213;198;117;52;167;747
089286602989;1;284;261;171;53;127;896
044554071893;1;107;161;137;74;123;602
056638783165;1;179;189;106;117;159;750
086878263274;1;235;168;234;109;158;904
091114413379;1;266;213;288;65;110;942
078040943565;1;126;181;192;110;125;734
027941505054;1;97;112;289;120;167;785
021579346996;1;243;272;141;73;134;863
024190569370;1;267;255;298;58;167;1045
044034688488;1;280;134;237;76;64;791
056260704893;1;184;138;199;61;75;657
018147979232;1;212;130;102;90;90;624
035354410381;1;276;131;238;97;53;795
038072047855;1;125;104;209;89;123;650
045640746483;1;255;167;251;79;169;921
033180228766;1;200;280;257;102;110;949
014349642787;1;85;273;160;91;65;674
084764405128;1;156;277;246;81;75;835
051887554233;1;255;178;193;58;161;845
090542693579;1;261;126;240;57;149;833
092047108264;1;259;169;121;119;149;817
011550731308;1;265;150;147;51;155;768
084321980984;1;262;88;216;109;147;822
004709309387;1;260;108;241;62;114;785
048266940408;1;250;210;195;62;90;807
059392640868;1;221;269;215;105;172;982
022078302149;1;108;249;144;71;98;670
036127063288;1;237;235;290;116;108;986
014903609715;1;276;135;237;72;164;884
080253857811;1;278;114;126;68;115;701
082871365387;1;271;179;208;59;147;864
012332941863;1;123;214;212;80;157;786
032883878915;1;291;137;231;110;100;869
099075382946;1;111;131;222;120;140;724
007227898429;1;255;164;98;80;103;700
078047441247;1;235;133;211;84;165;828
060833465031;1;284;192;95;54;50;675
069151238903;1;210;82;171;95;151;709
027607007991;1;91;210;187;120;168;776
089709396751;1;279;271;153;97;116;916
093229361559;1;139;192;108;115;146;700
012331365722;1;228;126;102;116;146;718
046816649155;1;289;102;102;73;105;671
099025759291;1;133;282;148;96;99;758
011759876476;1;178;243;190;64;174;849
079831598030;1;126;182;98;101;153;660
020583193921;1;279;179;157;100;66;781
070909850983;1;109;284;200;117;141;851
032759244160;1;125;243;205;53;120;746
055835313345;1;228;164;289;58;124;863
071366623879;1;230;173;243;60;156;862
013440577910;1;244;222;162;110;86;824
058373325842;1;225;185;112;73;124;719
026708863724;1;257;256;285;79;75;952
060917114523;1;192;262;186;86;155;881
056197967368;1;136;192;155;115;148;746
071887945524;1;259;275;173;70;62;839
019052951723;1;224;126;249;112;100;811
008782432370;1;195;275;146;72;149;837
010773277008;1;221;173;232;92;131;849
097805015920;1;168;152;165;76;151;712
074001494377;1;172;187;274;59;126;818
098791307792;1;84;125;110;97;76;492
051343997314;1;165;287;192;120;144;908
001984766179;1;274;227;247;100;148;996
036997930272;1;106;89;171;53;102;521
095419297719;1;223;111;182;71;142;729
000410957361;1;132;99;206;104;166;707
077332796345;1;236;157;265;52;56;766
091882298154;1;102;227;274;84;55;742
016730533970;1;277;125;220;52;141;815
098828353256;1;240;192;159;111;87;789
041054863877;1;99;103;154;94;164;614
079999750873;1;211;126;159;88;118;702
041188805778;1;193;176;150;110;99;728
017952712799;1;268;91;138;52;151;700
062521757745;1;108;142;293;99;170;812
065506346933;1;175;182;227;82;113;779
059045674067;1;121;198;284;95;64;762
036168440129;1;133;224;205;85;121;768
052185311044;1;139;255;198;89;61;742
055254146018;1;128;283;173;113;55;752
077627156652;1;241;162;210;114;112;839
011481761094;1;221;259;111;81;170;842
025983452384;1;112;169;195;71;171;718
091655422850;1;204;176;138;71;173;762
020037812650;1;127;261;223;114;86;811
099354325907;1;88;203;218;97;76;682
073734725405;1;99;230;232;82;142;785
025774217353;1;125;184;268;106;63;746
088274100275;1;132;259;206;60;104;761
061386124580;1;223;261;151;100;148;883
084223872397;1;276;94;232;110;154;866
088099138164;1;165;237;200;105;132;839
094708465773;1;158;201;270;82;132;843
098046628294;1;168;103;139;69;146;625
095734009374;1;124;126;202;51;91;594
049127568611;1;145;136;150;100;149;680
041058474893;1;226;142;147;96;139;750
013405320576;1;193;139;148;87;129;696
070410144361;1;286;103;253;81;62;785
003301644089;1;92;279;159;110;64;704
067342968419;1;154;271;208;83;64;780
047472429623;1;103;246;157;116;132;754
093653114625;1;270;187;90;84;113;744
024453912003;1;154;143;269;50;149;765
026172657827;1;141;265;271;97;62;836
027194264308;1;230;109;286;53;82;760
082504545551;1;233;272;94;111;162;872
062194010408;1;279;202;214;51;82;828
082168894664;1;256;159;267;106;135;923
030404970508;1;258;168;268;93;142;929
013788306485;1;195;160;243;109;84;791
042364335264;1;114;103;257;95;130;699
082146675131;1;132;95;283;92;125;727
007939813002;1;193;133;294;80;68;768
021221864463;1;265;123;210;88;100;786
030398678014;1;175;202;164;63;100;704
080030397743;1;197;143;147;56;57;600
052340182890;1;196;144;242;75;91;748
003546245437;1;217;231;213;82;57;800
062982835673;1;142;149;195;66;147;699
043049791218;1;104;117;132;107;147;607
082807134980;1;131;188;285;54;116;774
077981328419;1;212;174;214;90;158;848
091884309868;1;86;274;161;52;115;688
052664313398;1;281;130;253;93;125;882
018801346228;1;218;205;192;70;154;839
023641992861;1;118;279;129;108;109;743
039491624614;1;111;140;162;57;61;531
069793499828;1;127;268;282;105;86;868
020986534192;1;265;107;182;50;51;655
078154171280;1;254;205;249;75;94;877
001932894736;1;210;92;115;79;60;556
005774774397;1;142;115;212;94;149;712
080404431122;1;185;133;271;86;73;748
049911765091;1;168;246;164;84;171;833
082300634634;1;289;236;248;52;136;961
032100956454;1;216;153;284;103;79;835
032905636050;1;186;243;284;118;132;963
034025370143;1;111;149;281;65;103;709
093968122685;1;161;221;179;90;149;800
021140879981;1;158;130;131;73;58;550
095597700913;1;150;230;91;101;77;649
014536906610;1;259;284;225;91;142;1001
000035943791;1;291;221;153;105;173;943
099867206611;1;127;218;110;51;104;610
026446545250;1;289;226;123;108;153;899
090829864305;1;110;104;90;111;160;575
058079086039;1;229;223;209;80;60;801
048420934548;1;183;223;222;119;57;804
089854494653;1;275;251;247;68;60;901
032409534510;1;173;256;176;57;72;734
015210269295;1;229;143;299;50;62;783
007701531844;1;131;100;218;70;148;667
026584998079;1;287;219;213;69;139;927
044231654573;1;212;93;108;57;163;633
086788163807;1;116;242;169;77;142;746
034967491038;1;165;238;254;117;53;827
074578643890;1;274;169;261;109;102;915
068834290617;1;155;101;225;67;111;659
076801649519;1;215;89;200;80;143;727
060737973037;1;181;111;243;55;143;733
097194086244;1;157;81;245;119;80;682
087764301473;1;198;148;188;82;111;727
007602717441;1;227;274;194;92;138;925
084642690460;1;267;95;274;64;72;772
069326197544;1;97;87;153;115;97;549
013260278007;1;199;160;116;64;72;611
010663245674;1;101;252;157;104;104;718
062826992771;1;81;81;299;59;167;687
044692204230;1;264;101;277;54;153;849
043893948415;1;81;288;105;78;88;640
026179753243;1;193;223;167;109;67;759
013065958492;1;205;201;142;91;88;727
068100274100;1;243;95;118;63;152;671
089804113235;1;100;121;138;63;89;511
015649352575;1;277;132;278;80;97;864
052947364888;1;230;192;287;81;167;957
035917070678;1;173;281;274;66;138;932
025029548045;1;143;168;178;92;99;680
087500653855;1;148;108;115;83;143;597
047141911892;1;225;252;208;101;117;903
097177796164;1;266;202;115;108;68;759
074352230250;1;134;143;190;96;134;697
077735100041;1;151;203;154;116;151;775
093040280793;1;144;276;150;93;110;773
099674813488;1;207;187;179;53;128;754
023395483642;1;230;218;244;73;149;914
005551591829;1;92;219;259;94;106;770
047582909239;1;149;253;139;108;63;712
066023433139;1;86;256;262;50;129;783
093143448091;1;263;215;184;85;117;864
034695708291;1;134;116;123;51;166;590
055923185706;1;254;146;196;102;86;784
058988973990;1;85;157;120;85;136;583
011539654531;1;124;254;147;52;74;651
030756773943;1;204;209;118;111;143;785
012712473724;1;133;277;255;77;148;890
037134142452;1;85;271;145;75;134;710
085828932329;1;190;86;231;89;172;768
034172922188;1;188;184;115;111;121;719
027632386696;1;248;95;224;81;143;791
038847901260;1;278;204;290;79;88;939
030626923434;1;141;156;103;52;163;615
088947519280;1;248;96;165;118;147;774
032706055226;1;81;259;292;56;116;804
087315602138;1;99;279;116;51;95;640
067810335378;1;237;132;179;84;103;735
018758021850;1;212;151;130;74;148;715
030083711311;1;257;88;133;55;164;697
068725529970;1;238;273;128;115;82;836
031505225353;1;129;252;277;88;176;922
069316255575;1;178;146;147;66;160;697
076655070601;1;138;283;166;102;62;751
005532446974;1;168;189;147;115;103;722
075152708786;1;273;202;161;111;106;853
080017428547;1;123;277;298;98;57;853
075667532722;1;255;124;120;107;110;716
098284203702;1;155;259;153;68;60;695
074741523834;1;157;250;233;97;133;870
093524069972;1;187;187;265;61;70;770
062259072009;1;182;140;133;77;149;681
050095165811;1;201;186;230;77;87;781
098536493712;1;258;219;225;91;101;894
076399691329;1;228;107;221;110;72;738
002372700534;1;130;98;178;105;56;567
026107526582;1;291;157;172;73;77;770
063153144373;1;121;166;274;70;64;695
066386104355;1;179;95;193;87;60;614
000857324988;1;133;242;189;81;141;786
006864547840;1;228;142;296;54;147;867
085758401671;1;265;89;212;57;104;727
031048111980;1;231;155;154;77;158;775
021399787532;1;219;190;177;113;97;796
056311197067;1;279;162;122;57;171;791
099613334235;1;282;192;134;88;141;837
017101648131;1;119;286;163;65;125;758
024146112486;1;160;130;124;107;53;574
009299809486;1;250;166;143;114;51;724
086865942604;1;231;95;130;105;127;688
043958628675;1;265;178;223;57;66;789
009681944369;1;161;218;224;115;68;786
017373533703;1;181;286;246;82;125;920
084813774367;1;288;163;298;87;158;994
092659431132;1;182;161;103;76;72;594
064132596890;1;214;85;176;106;130;711
040346991121;1;214;164;155;111;59;703
084725868880;1;290;129;213;55;76;763
001602864982;1;131;130;142;105;55;563
032065182490;1;241;144;218;101;66;770
080342602207;1;269;151;97;113;53;683
025211413191;1;119;240;207;60;131;757
008873910850;1;284;147;254;83;114;882
040423216128;1;282;254;97;115;104;852
045789324768;1;281;280;227;96;87;971
041767724616;1;221;186;102;80;121;710
001805949702;1;243;104;168;99;82;696
007520403010;1;236;91;241;66;162;796
069369437438;1;188;177;264;72;71;772
097677461529;1;292;230;289;90;91;992
081234601042;1;225;263;147;118;51;804
054920842487;1;113;164;255;100;110;742
036265064969;1;200;131;222;79;91;723
043582606841;1;279;199;256;110;91;935
018778021513;1;270;177;137;115;119;818
074806205012;1;179;280;282;113;83;937
079839881987;1;247;222;104;104;132;809
021169076276;1;113;105;139;61;158;576
067661445264;1;129;115;244;86;104;678
085263282686;1;194;220;193;86;161;854
083793887836;1;278;234;235;100;80;927
049462636863;1;87;127;280;92;123;709
083556138478;1;258;217;204;80;68;827
051048477216;1;185;184;190;108;82;749
081956161785;1;221;270;111;97;64;763
087516257835;1;262;251;242;75;83;913
024260970102;1;262;91;160;119;55;687
002543454078;1;215;281;159;70;110;835
010088248029;1;258;165;145;120;123;811
002117193096;1;205;105;131;116;56;613
019868240382;1;286;226;268;80;139;999
040200891397;1;102;84;98;108;155;547
047787027644;1;225;255;223;78;81;862
065503470832;1;129;142;267;70;105;713
034145883546;1;203;275;159;105;145;887
045318011615;1;125;256;116;113;88;698
031399322800;1;109;96;222;99;75;601
044704649731;1;168;192;96;105;83;644
056133160630;1;109;228;148;103;87;675
026418896065;1;288;123;225;78;145;859
006808647243;1;118;105;124;116;155;618
045844564211;1;259;163;95;71;164;752
006557860779;1;231;200;290;75;53;849
058020727799;1;135;218;168;91;93;705
020413991325;1;182;232;192;73;169;848
042771417065;1;224;223;214;96;89;846
039326650416;1;188;90;164;102;162;706
080906592646;1;122;288;153;70;83;716
069690468955;1;174;234;143;76;177;804
025297696512;1;230;205;274;104;126;939
097192563206;1;116;252;188;88;116;760
065840316479;1;183;200;230;114;75;802
017058340071;1;273;233;108;95;88;797
020960889884;1;207;226;121;68;135;757
030231165172;1;200;281;245;111;178;1015
052919900198;1;134;188;297;78;155;852
037208048981;1;227;284;98;103;105;817
039455973356;1;290;273;164;110;99;936
056611520803;1;85;164;234;67;126;676
016985602615;1;257;205;298;119;58;937
094014266800;1;199;82;163;92;91;627
022102327148;1;117;229;212;110;124;792
074462065760;1;159;219;178;111;140;807
035247216780;1;285;221;209;115;140;970
082140404483;1;150;199;258;92;150;849
014503553817;1;175;209;134;86;72;676
062961759520;1;89;249;258;95;60;751
035635492185;1;153;180;262;96;110;801
078735686742;1;225;98;115;74;89;601
032737590660;1;161;211;198;83;121;774
095509646225;1;215;137;106;73;124;655
013858522970;1;141;226;199;94;122;782
039875561496;1;144;82;181;55;93;555
028121178114;1;252;81;169;67;65;634
015669470801;1;87;219;206;91;157;760
080179430328;1;267;200;265;118;105;955
025375420459;1;239;228;251;63;125;906
026364410905;1;196;202;93;55;82;628
013171142802;1;292;163;161;84;152;852
095312812540;1;259;149;226;85;159;878
029721982802;1;92;219;228;79;64;682
015405250665;1;112;227;157;71;132;699
080442933670;1;174;177;263;110;141;865
094701787762;1;131;83;146;101;54;515
054483954903;1;272;198;106;57;61;694
056052101581;1;122;168;192;52;85;619
023573774266;1;278;176;190;92;53;789
090287050846;1;262;196;177;66;59;760
070505773740;1;248;128;126;52;76;630
096570359399;1;283;140;244;102;57;826
033004732920;1;117;225;198;76;154;770
068456215733;1;95;268;163;119;81;726
076772376940;1;212;114;287;72;87;772
016579498099;1;128;199;251;93;98;769
043733741676;1;242;127;189;116;174;848
012969408543;1;144;224;270;89;97;824
056547189671;1;187;139;189;56;88;659
016423691960;1;193;276;185;87;105;846
038643970462;1;212;132;171;65;116;696
027933360712;1;94;122;257;103;115;691
005432978560;1;195;102;227;65;97;686
081675647176;1;113;89;146;75;139;562
055609491164;1;170;203;121;79;77;650
053735206271;1;145;282;122;60;60;669
039947253541;1;201;215;162;62;174;814
046231881721;1;106;90;201;92;143;632
081974536105;1;203;193;112;51;64;623
078576295899;1;143;156;130;76;142;647
089048113241;1;207;252;152;99;103;813
050368433044;1;245;275;269;118;142;1049
095899492361;1;110;241;203;118;120;792
010307559455;1;152;238;210;75;67;742
002029939171;1;104;236;263;91;78;772
074274317738;1;126;229;223;78;126;782
066197015456;1;220;190;109;101;101;721
067682659712;1;94;82;137;81;51;445
027896519228;1;212;96;245;90;92;735
030406947773;1;117;242;240;52;152;803
018754902085;1;247;217;202;103;124;893
076825800005;1;240;223;265;108;111;947
073171070320;1;103;211;242;60;108;724
058138547431;1;110;156;295;57;153;771
005698679716;1;176;134;153;81;113;657
045258367193;1;113;124;160;101;70;568
070955724230;1;206;233;106;76;132;753
084617372552;1;97;113;216;52;113;591
085273090292;1;219;107;175;100;149;750
014108835205;1;269;111;283;62;60;785
093570865676;1;153;153;216;100;109;731
036824191772;1;158;268;287;76;140;929
037603927240;1;145;234;221;78;127;805
020449063532;1;175;242;196;92;155;860
031514742821;1;87;256;284;107;168;902
055600242938;1;269;166;299;72;159;965
061804118561;1;224;244;166;88;162;884
003553874980;1;214;218;281;99;106;918
086394376316;1;152;148;226;55;55;636
072264026076;1;144;177;96;91;127;635
001434545122;1;116;266;235;72;110;799
051342447240;1;230;222;192;59;156;859
009563243683;1;149;144;262;73;158;786
075508474366;1;184;213;296;100;62;855
086652584923;1;91;158;166;92;167;674
050434817605;1;99;176;156;86;139;656
042020343111;1;279;261;210;93;121;964
072218602556;1;261;234;142;70;168;875
077524717292;1;115;84;125;50;160;534
093419414292;1;136;258;175;78;60;707
080036571261;1;145;158;290;109;58;760
030098881190;1;239;170;243;112;114;878
072831982146;1;280;165;99;103;173;820
065601537933;1;146;154;138;94;99;631
023176614188;1;217;88;190;72;167;734
055324899319;1;267;179;300;78;174;998
067907390086;1;260;235;280;64;174;1013
098336136276;1;161;162;290;113;160;886
002078710028;1;167;275;154;63;54;713
011139260901;1;194;216;177;52;63;702
076089369505;1;245;214;185;71;145;860
034136774240;1;136;168;255;56;91;706
085514282343;1;207;203;200;117;57;784
093520444462;1;105;280;208;78;91;762
071644283807;1;248;247;193;62;60;810
007669789762;1;261;271;155;67;51;805
042775019738;1;163;166;119;93;101;642
051873791873;1;119;196;203;99;159;776
042291828080;1;101;158;298;61;58;676
092963986651;1;249;107;289;86;120;851
097579263254;1;175;252;129;84;56;696
059866093455;1;122;216;278;59;59;734
047862533893;1;150;268;200;102;172;892
062439197703;1;216;142;264;80;165;867
083487125192;1;204;223;205;76;84;792
039389050508;1;233;282;286;51;113;965
028451343783;1;98;143;149;94;159;643
028500709789;1;191;114;150;92;113;660
083079171625;1;268;211;269;115;156;1019
041063645217;1;140;120;126;85;56;527
033411076658;1;101;184;259;68;100;712
086449083405;1;103;251;109;101;177;741
037243385756;1;255;94;112;103;135;699
060265722822;1;136;264;273;84;120;877
038220396040;1;132;174;266;68;94;734
054772908953;1;102;233;172;101;148;756
083340895441;1;222;242;263;76;146;949
037969835540;1;223;86;178;56;157;700
011078275455;1;260;199;121;52;130;762
082311525316;1;265;102;263;73;77;780
037441553577;1;184;114;202;86;148;734
022775419253;1;269;175;99;97;151;791
051917068242;1;94;234;270;62;142;802
028977370347;1;106;182;104;92;89;573
069184113736;1;156;254;185;99;171;865
047532656594;1;135;166;227;67;73;668
064225650987;1;109;233;208;114;122;786
053137495701;1;123;157;139;61;121;601
034610382819;1;212;247;251;92;169;971
031213477952;1;125;100;163;115;145;648
074403895279;1;89;123;244;70;152;678
039052991023;1;119;210;224;120;101;774
014858799588;1;165;159;277;88;116;805
096007187436;1;201;251;287;69;73;881
016410266385;1;204;249;123;57;142;775
039388452925;1;180;194;190;117;144;825
058673426008;1;188;107;174;56;94;619
093907959343;1;135;211;285;52;108;791
071848393901;1;192;97;177;60;157;683
088764508162;1;154;199;102;55;81;591
092399014080;1;231;200;196;95;151;873
046846518934;1;213;124;137;67;77;618
005750991266;1;245;95;250;91;150;831
075887899346;1;247;269;212;59;99;886
021163677818;1;126;272;189;110;121;818
002166389937;1;270;215;244;101;74;904
064223691639;1;91;95;185;57;87;515
085194887725;1;248;103;153;56;139;699
001017578616;1;258;127;300;110;149;944
096476434747;1;191;225;228;83;75;802
077598097749;1;245;263;240;104;112;964
069541582300;1;135;104;123;115;68;545
043072721984;1;127;172;172;91;57;619
094213606056;1;154;84;177;104;140;659
078824308748;1;242;122;254;50;140;808
070666853179;1;208;85;168;116;57;634
017683409452;1;254;124;185;81;59;703
011020146344;1;207;189;293;77;129;895
031145144078;1;115;209;283;81;139;827
073830700702;1;157;220;201;111;64;753
013882131603;1;231;244;151;116;54;796
093010399187;1;230;80;164;84;157;715
092744933702;1;285;119;90;112;90;696
094864576346;1;287;238;250;59;89;923
092994285535;1;192;209;114;119;95;729
047907701119;1;88;214;271;73;139;785
030638949387;1;92;200;91;52;90;525
050664450165;1;226;136;280;58;142;842
072524224233;1;252;147;147;59;66;671
092837088562;1;138;87;151;58;111;545
005296719767;1;103;247;111;93;123;677
012745201181;1;193;180;183;110;173;839
037529037348;1;191;91;178;60;55;575
014318360306;1;248;80;215;95;170;808
078419639355;1;202;81;272;88;126;769
098399857876;1;127;280;177;87;175;846
075593046517;1;213;238;228;50;98;827
028733651051;1;140;284;188;61;160;833
069993465647;1;223;176;148;89;130;766
062696459499;1;262;248;206;90;73;879
004369156103;1;257;204;165;58;66;750
046050846612;1;81;263;169;88;74;675
062815786249;1;167;254;194;77;118;810
066092371947;1;129;278;240;90;116;853
092283376994;1;255;166;227;98;111;857
010260498150;1;121;194;110;103;161;689
092244029048;1;238;115;227;120;79;779
028375121231;1;213;241;276;87;165;982
013763242286;1;242;163;151;82;54;692
030930828404;1;173;222;157;85;153;790
093581994595;1;182;175;227;91;68;743
023569685856;1;91;265;193;108;123;780
065887941348;1;225;222;148;70;65;730
032058789895;1;134;126;187;59;165;671
093249194623;1;257;174;183;101;95;810
059742071859;1;204;247;142;81;63;737
045459853783;1;107;95;122;86;162;572
068886352698;1;287;214;217;90;88;896
031665890499;1;260;175;182;107;151;875
098999595094;1;104;232;278;114;161;889
022071454790;1;186;230;102;57;175;750
016831853180;1;199;106;203;119;159;786
041041009125;1;256;162;156;98;157;829
070268980197;1;104;271;267;71;91;804
019625291775;1;128;129;223;70;170;720
090600261956;1;84;128;235;116;92;655
005669939962;1;96;230;281;77;113;797
027469948681;1;156;259;251;116;173;955
023672706348;1;154;138;216;104;118;730
046941309894;1;112;156;217;98;89;672
074095416286;1;257;215;92;84;119;767
062506095989;1;152;137;194;99;151;733
061767274083;1;241;143;246;104;86;820
009831980891;1;190;98;282;79;113;762
002865287260;1;158;169;213;118;71;729
007912652731;1;275;224;299;71;59;928
087590615932;1;108;127;100;101;91;527
050752790858;1;129;121;95;63;89;497
042678346756;1;259;219;135;103;68;784
025254243110;1;209;262;181;60;72;784
034653004635;1;186;98;214;106;127;731
044425783412;1;186;241;219;120;145;911
097883002217;1;284;153;290;113;66;906
028273391841;1;212;220;262;105;87;886
090619999672;1;238;149;251;109;86;833
079200208553;1;174;125;244;103;102;748
094225834102;1;292;120;196;97;88;793
049494159979;1;91;225;277;77;119;789
003877391264;1;286;191;96;117;83;773
001113417274;1;278;156;156;53;70;713
073601295108;1;164;132;194;120;78;688
052924882353;1;143;233;127;105;108;716
048803166676;1;184;104;173;54;110;625
020799919529;1;87;261;264;86;54;752
047748916762;1;173;99;275;89;93;729
076868645606;1;198;105;238;95;70;706
045645303649;1;126;114;270;115;113;738
065076974707;1;116;162;253;65;110;706
065132482975;1;266;240;281;77;175;1039
093698513353;1;263;281;268;71;117;1000
080817277677;1;205;185;266;94;122;872
099027091507;1;233;219;133;94;147;826
089660311206;1;81;164;160;119;83;607
070184119778;1;221;91;151;92;105;660
086829033193;1;92;127;201;89;141;650
040369652534;1;119;185;299;113;87;803
000479957259;1;172;261;102;72;144;751
073761072266;1;81;134;222;84;123;644
022979431819;1;96;213;131;114;75;629
085372406080;1;188;200;106;95;154;743
022751073609;1;179;258;106;53;79;675
004801998694;1;207;134;252;102;159;854
087243529005;1;209;136;168;100;116;729
087433321463;1;148;145;172;97;176;738
033830830934;1;292;97;228;67;177;861
053634200023;1;284;97;139;51;130;701
027023320896;1;219;259;160;69;62;769
045706629717;1;145;183;175;90;127;720
006199646050;1;159;149;112;70;99;589
013948558722;1;156;230;234;77;163;860
026176633226;1;91;108;151;92;129;571
015792858276;1;267;187;190;56;170;870
094045284357;1;97;267;187;107;157;815
062558827577;1;212;250;104;68;155;789
094971839339;1;128;80;107;63;173;551
012764572409;1;83;288;145;88;86;690
022378022696;1;248;133;185;86;168;820
075180070259;1;228;275;93;71;164;831
015739532159;1;152;278;107;56;137;730
088215909323;1;96;87;129;81;134;527
076879923669;1;223;190;224;54;164;855
042512287217;1;96;92;148;105;60;501
022693968745;1;226;147;242;64;55;734
039126062270;1;207;284;121;88;144;844
068148563547;1;204;102;261;80;78;725
070726246173;1;263;255;260;108;110;996
027598189955;1;113;236;275;113;143;880
083916797774;1;192;179;294;96;119;880
017027189305;1;204;138;159;52;145;698
077930656470;1;236;223;133;64;50;706
070429169187;1;88;81;135;60;92;456
057512596438;1;123;160;112;95;81;571
051275577991;1;152;256;269;57;104;838
051182865243;1;113;117;176;76;152;634
061685931004;1;260;262;186;102;59;869
090591774852;1;130;247;299;61;145;882
016732715555;1;92;273;108;107;145;725
002375714745;1;158;109;151;51;105;574
080298619297;1;280;126;199;85;86;776
023540680956;1;144;155;288;97;143;827
067461641631;1;253;98;238;58;54;701
042513820576;1;106;150;202;85;95;638
030991521392;1;144;131;94;92;142;603
065592994109;1;279;288;265;95;146;1073
033692174187;1;113;228;165;99;90;695
090073900254;1;241;256;96;100;75;768
028576741341;1;264;107;186;51;106;714
025416977966;1;217;116;288;71;157;849
007540499467;1;88;258;240;79;84;749
095999098240;1;137;169;269;81;115;771
003932857943;1;100;286;295;53;75;809
034939197607;1;257;225;270;106;56;914
040494686430;1;198;268;265;114;126;971
029330393074;1;137;251;212;115;93;808
030865281274;1;112;259;277;94;146;888
078192464311;1;199;93;225;91;152;760
069247384165;1;278;208;146;114;153;899
024186815151;1;250;136;212;56;127;781
035612955592;1;184;186;157;74;100;701
083337492599;1;155;111;264;60;113;703
075298115908;1;126;127;140;62;151;606
084375712924;1;274;288;148;99;82;891
076534540608;1;108;146;292;95;175;816
068701289269;1;140;92;123;101;126;582
057245920003;1;153;140;171;111;70;645
056780617361;1;223;111;175;117;70;696
005857605911;1;110;231;199;85;97;722
037806549624;1;90;128;99;91;126;534
098239034265;1;283;204;201;68;55;811
035606933844;1;237;163;167;78;83;728
088928522650;1;103;102;181;81;178;645
017371073094;1;142;181;295;76;101;795
006095212774;1;90;127;261;117;148;743
036899971593;1;251;158;277;76;115;877
018746524684;1;190;150;275;112;61;788
085385062886;1;262;139;93;109;116;719
094725338988;1;178;187;237;75;72;749
071715554882;1;135;105;106;77;138;561
028197968446;1;128;232;242;74;131;807
095701136556;1;130;240;113;74;66;623
051149376394;1;238;219;231;55;91;834
072928971244;1;217;110;273;114;148;862
076739307721;1;112;214;186;103;91;706
028841242817;1;208;252;150;103;89;802
067941190052;1;287;271;103;99;73;833
011311936202;1;227;283;120;59;134;823
071957066441;1;236;206;180;77;116;815
063406652106;1;109;161;262;111;144;787
018996668253;1;91;236;164;59;125;675
072736108725;1;111;241;204;113;175;844
025799066234;1;231;225;93;111;136;796
017534497938;1;196;111;114;62;159;642
083610606551;1;222;183;194;93;119;811
007993232363;1;228;92;277;91;156;844
084180459803;1;221;128;137;92;71;649
016256655232;1;258;154;228;68;164;872
064642882650;1;263;115;281;80;83;822
025431195769;1;106;117;164;57;115;559
010456016703;1;245;202;196;97;145;885
068829163951;1;192;110;228;61;97;688
066899747704;1;100;173;273;81;89;716
047227304724;1;290;224;206;114;83;917
055019451406;1;164;259;246;119;134;922
048584337108;1;271;225;268;82;174;1020
075571224086;1;288;213;237;78;117;933
087089194287;1;232;132;266;98;71;799
020152981020;1;94;163;166;62;96;581
093016612959;1;152;101;166;55;95;569
030451801196;1;228;91;196;93;96;704
088589960689;1;278;182;190;71;78;799
083987850293;1;146;114;236;75;91;662
043748205681;1;263;182;94;70;110;719
085561402676;1;241;253;190;77;103;864
006593299258;1;96;206;180;58;162;702
058422668368;1;132;228;104;79;107;650
002016118348;1;282;135;281;82;56;836
086458065895;1;195;128;267;113;51;754
075960562060;1;288;247;132;52;130;849
027323529897;1;152;252;277;57;90;828
042239358115;1;230;235;161;112;176;914
002415199023;1;110;275;211;50;144;790
000348114702;1;120;260;211;88;74;753
069033095921;1;209;284;287;98;167;1045
035175883015;1;192;127;203;99;167;788
046927456339;1;215;174;132;103;62;686
099798209308;1;83;272;251;113;143;862
068693987464;1;242;253;246;85;118;944
025538761931;1;279;197;174;113;146;909
067330742055;1;170;243;118;102;156;789
084785288669;1;271;278;261;116;117;1043
083281941750;1;195;276;160;74;173;878
073269365346;1;105;100;113;63;136;517
071971379484;1;270;155;202;112;62;801
087519249010;1;84;263;205;94;113;759
067267248416;1;105;266;94;73;122;660
064530181816;1;100;160;183;65;62;570
069711075379;1;224;244;183;105;76;832
054497987023;1;205;204;205;103;112;829
035906164522;1;233;197;133;50;136;749
094018118712;1;245;277;159;82;97;860
005638141994;1;203;191;170;101;117;782
070835751011;1;238;231;104;58;89;720
028360264610;1;116;96;285;113;75;685
061168796249;1;96;156;97;100;76;525
005755115361;1;123;226;289;51;82;771
052897880768;1;171;120;263;67;157;778
041759129974;1;146;140;273;74;106;739
038794400187;1;143;154;242;111;82;732
072982972179;1;234;184;152;59;85;714
008489643951;1;286;202;184;81;118;871
096228728633;1;150;109;260;106;82;707
059716321694;1;239;208;116;62;108;733
039678603689;1;175;81;211;60;144;671
029057340701;1;278;200;216;97;91;882
001888618724;1;154;141;116;111;101;623
084809311646;1;214;193;158;103;178;846
014115947814;1;241;97;184;75;96;693
094335783039;1;286;230;179;57;120;872
041851136283;1;84;267;254;110;80;795
068151350429;1;222;112;96;83;67;580
032688271197;1;144;131;98;97;91;561
001347278211;1;157;214;124;112;72;679
051197594898;1;171;136;131;82;73;593
020810332998;1;204;266;292;84;122;968
074286169400;1;88;287;216;57;59;707
008378062474;1;159;248;269;101;161;938
038143918475;1;289;158;225;101;169;942
069926934281;1;204;87;237;62;70;660
025924335556;1;233;187;218;111;139;888
041303394090;1;233;245;116;87;132;813
064460999106;1;164;199;114;105;76;658
010730658094;1;139;288;141;98;107;773
012108911101;1;285;82;202;55;129;753
067882092220;1;129;111;224;83;89;636
030817700042;1;252;122;200;105;178;857
073784695153;1;247;264;259;80;125;975
060071319013;1;275;227;146;118;92;858
038048596155;1;286;143;247;109;90;875
049263079462;1;228;131;267;106;126;858
078352091348;1;162;258;157;70;93;740
029207719529;1;176;266;97;77;92;708
021007232227;1;127;252;91;51;120;641
025956352241;1;128;267;159;111;67;732
038874775937;1;226;259;116;101;66;768
053212589550;1;142;246;134;92;157;771
074703797982;1;216;162;162;85;121;746
099135816122;1;175;95;174;94;168;706
003190496594;1;112;208;157;118;163;758
090710012915;1;102;187;245;113;118;765
078274557992;1;218;271;222;69;133;913
032052723700;1;175;249;179;99;52;754
091800339420;1;257;168;260;109;60;854
067624389383;1;245;183;287;113;121;949
066960327013;1;151;266;235;107;157;916
020177609404;1;283;97;268;85;177;910
004888305852;1;248;130;151;65;53;647
020123031018;1;117;229;112;86;118;662
076772740899;1;239;112;155;53;55;614
022244248769;1;205;183;286;51;107;832
079030293456;1;147;242;94;55;77;615
060984649041;1;235;177;225;78;55;770
021766481250;1;195;191;91;86;160;723
060469928057;1;255;143;93;92;123;706
096609803330;1;193;108;219;86;113;719
009792981015;1;251;191;155;113;117;827
069503981973;1;255;99;196;77;57;684
058914220744;1;236;88;187;91;81;683
023158235277;1;147;222;182;61;142;754
029880830799;1;175;273;245;83;141;917
012422523639;1;180;109;208;51;110;658
007775204978;1;138;198;126;57;144;663
018294093288;1;242;195;117;75;114;743
008306252175;1;171;140;237;56;80;684
048401553288;1;255;177;277;118;160;987
037809301979;1;129;109;190;53;164;645
016549217551;1;83;197;126;77;51;534
076496998435;1;95;161;238;58;151;703
086126283276;1;197;216;92;106;97;708
034912411483;1;252;247;257;54;144;954
007795955903;1;104;113;261;98;134;710
023336544299;1;248;157;194;82;135;816
034216087237;1;227;285;167;102;68;849
075656027627;1;261;187;297;64;66;875
011650623018;1;100;143;294;120;68;725
052892520737;1;210;264;165;79;91;809
087695278010;1;80;82;131;73;146;512
091856350114;1;275;177;170;77;162;861
087550284524;1;213;189;180;117;52;751
081707035918;1;92;252;209;107;102;762
090754430999;1;92;226;287;101;176;882
090658681300;1;126;208;210;50;129;723
062198708430;1;106;277;297;116;131;927
007703568184;1;100;192;235;98;131;756
093612771183;1;238;99;185;74;165;761
038390708986;1;211;148;174;117;83;733
037169630854;1;191;96;114;115;148;664
059690048278;1;93;224;227;59;172;775
084428181726;1;186;160;187;59;177;769
064094107734;1;256;97;203;88;112;756
088666883729;1;261;178;112;107;152;810
069371257879;1;261;286;182;120;149;998
033256340491;1;132;217;198;96;72;715
024907760182;1;120;143;206;106;82;657
049157037684;1;259;119;254;114;139;885
026794149432;1;190;235;97;114;165;801
056689204156;1;156;253;94;112;100;715
088506727841;1;227;288;255;110;153;1033
016700061587;1;224;153;209;79;134;799
016194739545;1;227;166;284;106;169;952
050061784443;1;189;189;268;55;88;789
020904427860;1;115;160;194;110;116;695
060822191014;1;98;206;136;61;114;615
038678667645;1;287;174;298;110;98;967
024285737309;1;249;273;206;114;53;895
075176080516;1;273;223;211;113;68;888
020855020205;1;253;252;152;111;73;841
013249967187;1;148;229;271;84;61;793
087687163507;1;187;119;178;105;52;641
078850459473;1;100;110;218;72;111;611
007076539886;1;228;241;149;89;142;849
087492597995;1;121;214;294;85;155;869
034787687028;1;109;275;173;59;172;788
033514398197;1;279;92;165;103;161;800
039705509655;1;119;281;269;117;174;960
047505806740;1;205;201;122;85;66;679
088080023319;1;289;137;259;106;117;908
034651438203;1;262;147;119;62;58;648
032670573304;1;288;228;153;112;156;937
064838215802;1;195;94;216;57;57;619
024154641232;1;182;195;218;102;71;768
023281696504;1;258;242;173;97;51;821
050989360550;1;237;284;232;87;146;986
053393206886;1;260;168;116;100;162;806
070399498014;1;119;184;229;52;148;732
069516736318;1;192;182;221;86;116;797
019877161440;1;246;194;224;74;121;859
055804065607;1;85;163;110;82;83;523
007005413973;1;169;142;102;120;137;670
026320470174;1;86;256;187;97;115;741
012075067244;1;231;127;286;53;160;857
008043131094;1;130;282;117;92;164;785
022750544051;1;146;240;101;107;117;711
084842628249;1;140;128;175;53;108;604
040252650979;1;189;173;220;74;79;735
096910517551;1;232;237;127;80;111;787
078301689097;1;166;233;140;111;94;744
070731932979;1;265;145;292;94;97;893
002616390857;1;267;97;158;101;156;779
029108554904;1;180;245;172;120;166;883
037003984323;1;267;253;168;88;67;843
092193607073;1;211;80;231;112;67;701
008564951974;1;117;229;188;55;156;745
099535454289;1;140;286;159;74;159;818
092169532463;1;237;173;163;53;114;740
047582463898;1;120;223;189;89;146;767
077027256575;1;181;148;226;85;174;814
033830501097;1;273;167;151;52;90;733
096145721610;1;210;162;97;77;141;687
079720149722;1;92;240;126;94;133;685
002336216774;1;120;127;223;104;67;641
006348601322;1;226;218;146;119;160;869
003079914942;1;254;149;285;62;66;816
050630580298;1;241;108;167;84;74;674
002913891525;1;288;84;259;50;151;832
088428080413;1;155;211;225;53;103;747
036885872067;1;246;94;123;100;109;672
028032353428;1;226;246;141;50;78;741
098998002124;1;209;269;153;59;80;770
025307328478;1;273;189;245;94;165;966
025387022284;1;115;140;135;98;65;553
019085378426;1;96;218;148;112;146;720
026851397624;1;82;167;142;96;55;542
007327047836;1;213;278;177;112;151;931
049489004410;1;270;267;278;76;144;1035
039477982467;1;237;155;102;86;165;745
012204497743;1;194;279;271;64;149;957
003814295015;1;210;249;231;107;61;858
035212228678;1;120;143;286;108;51;708
077703717544;1;87;81;106;63;86;423
012424601922;1;208;274;285;97;112;976
029202644861;1;206;238;125;67;65;701
097230541376;1;174;120;289;56;130;769
025110423552;1;248;137;227;113;150;875
037074952249;1;119;220;270;69;101;779
053078961370;1;96;282;272;50;92;792
083880137034;1;194;231;207;52;80;764
059251289416;1;135;111;266;101;90;703
072993222624;1;281;246;157;114;151;949
048977638063;1;191;222;182;114;153;862
081326020928;1;130;219;257;70;66;742
052929283106;1;281;170;243;111;146;951
074081393388;1;212;254;97;55;118;736
065429250738;1;181;257;256;112;51;857
038675930924;1;113;96;250;59;84;602
010332929347;1;162;217;109;96;81;665
017548675760;1;154;158;222;91;106;731
097579142833;1;277;232;181;117;142;949
050198877755;1;123;254;105;94;165;741
062255079116;1;90;124;107;82;178;581
094029206806;1;251;240;185;100;165;941
077656058006;1;174;217;209;81;122;803
057310370626;1;224;246;270;96;155;991
067342453579;1;225;160;192;119;165;861
072097162120;1;243;233;241;107;57;881
085767896407;1;83;119;182;69;126;579
087529925589;1;130;285;133;107;171;826
031213064349;1;185;221;211;100;169;886
020467886363;1;253;271;177;71;160;932
057786489265;1;86;134;271;78;154;723
087328991277;1;161;260;152;59;104;736
089038838646;1;104;83;262;66;131;646
079189264293;1;85;204;101;117;145;652
055954356332;1;194;149;162;86;137;728
052288397423;1;151;214;218;63;175;821
073027062365;1;171;238;137;111;124;781
093857548719;1;107;284;254;98;135;878
017318432695;1;266;217;211;119;172;985
012700776520;1;171;231;161;54;171;788
038217950569;1;225;190;164;60;156;795
076659522740;1;265;132;188;50;138;773
077152301253;1;104;231;256;94;83;768
059559627917;1;226;274;179;76;137;892
001609105182;1;124;220;95;89;51;579
002843126535;1;257;215;256;74;139;941
033098553196;1;277;239;299;60;51;926
054804477585;1;107;154;138;83;160;642
010330325834;1;149;234;253;74;141;851
030097053368;1;248;139;240;100;96;823
045851521105;1;113;278;287;111;170;959
021883899775;1;154;278;220;68;85;805
031460653408;1;274;240;188;51;60;813
050739442708;1;193;184;150;106;172;805
017004904664;1;287;93;289;97;172;938
067552997840;1;210;272;220;120;98;920
071694095798;1;99;214;265;54;154;786
025395337006;1;252;146;130;112;176;816
067697354167;1;289;247;225;64;107;932
036972221220;1;182;244;259;93;125;903
055762979973;1;146;219;95;93;136;689
036369362994;1;216;142;115;87;63;623
028765596914;1;109;250;188;106;167;820
097462173078;1;212;118;176;103;137;746
097343397851;1;176;205;274;98;87;840
005630852923;1;211;171;145;59;73;659
056829143527;1;261;147;175;111;59;753
033953215477;1;279;210;265;77;61;892
065735745031;1;222;281;219;97;53;872
035495477941;1;277;166;145;95;75;758
084579945987;1;108;177;270;103;58;716
018445493131;1;232;196;98;61;176;763
075408125920;1;149;252;241;115;98;855
024962941237;1;147;115;270;79;74;685
021430327451;1;134;153;284;104;121;796
064790926071;1;170;110;226;113;133;752
080712420285;1;214;173;115;65;65;632
024315836218;1;111;208;230;82;96;727
098660756348;1;153;143;281;58;142;777
015535348042;1;169;280;191;58;81;779
097572548163;1;213;234;182;68;176;873
030099658020;1;139;119;213;63;129;663
048527987705;1;175;103;129;56;164;627
017836093003;1;203;246;104;95;63;711
079621142555;1;164;205;90;53;107;619
037170543113;1;81;224;139;64;114;622
050229718144;1;124;240;218;73;160;815
002306502141;1;248;146;229;61;171;855
056457275608;1;133;159;142;101;162;697
006757652130;1;191;193;177;73;169;803
011603121199;1;99;250;299;76;80;804
012503056239;1;139;222;165;54;176;756
061934613758;1;148;83;186;64;150;631
007563304442;1;155;111;148;95;167;676
006826964545;1;265;103;227;101;109;805
048689074603;1;249;141;169;53;96;708
043560173052;1;86;94;119;72;107;478
047096046588;1;278;89;206;90;105;768
041666713171;1;87;98;204;111;113;613
009407837608;1;91;248;157;83;149;728
039718650698;1;150;80;245;85;75;635
006890863471;1;267;193;161;101;55;777
035393835658;1;136;95;256;61;108;656
044714763682;1;111;243;121;85;141;701
088939413842;1;93;106;121;86;162;568
092295893414;1;275;109;249;101;135;869
026963757684;1;266;92;107;114;157;736
053449092371;1;214;180;170;113;140;817
041695467237;1;222;123;253;51;86;735
055573682102;1;230;285;143;109;163;930
033836218019;1;175;90;120;120;173;678
080998882615;1;200;136;99;96;92;623
039619755520;1;259;135;272;106;60;832
097701293809;1;223;216;136;81;86;742
066771129299;1;180;157;299;86;66;788
045727689176;1;187;160;265;119;52;783
005012245807;1;146;196;254;77;101;774
016083976847;1;276;279;255;82;129;1021
066468372733;1;86;214;109;55;104;568
041564038480;1;115;280;172;86;97;750
051510612933;1;258;82;157;110;133;740
024167598467;1;200;122;263;50;162;797
046887310183;1;247;196;271;75;113;902
001329264742;1;114;198;121;95;133;661
092939393729;1;202;283;135;54;137;811
095536187818;1;120;252;244;119;152;887
055262266255;1;209;146;105;95;82;637
076354905575;1;83;123;297;97;178;778
012193972343;1;138;128;265;93;135;759
048013713750;1;153;155;208;106;130;752
011100547041;1;209;150;147;106;68;680
062678707767;1;170;170;189;64;151;744
059045914913;1;256;229;225;114;175;999
096676663353;1;83;85;266;76;75;585
098554966532;1;80;109;184;95;117;585
011309665627;1;124;135;249;79;117;704
012002684859;1;181;203;292;97;87;860
013126706964;1;122;92;114;109;122;559
022741792156;1;203;158;113;52;70;596
070155281531;1;83;135;289;50;167;724
044566421846;1;286;222;221;95;91;915
075709460879;1;190;179;248;75;164;856
088890657798;1;164;214;275;94;133;880
027290967398;1;225;193;144;55;139;756
062507095194;1;136;221;230;104;101;792
046929544973;1;138;208;192;82;170;790
062131660089;1;258;127;259;56;162;862
043158559843;1;243;248;278;52;134;955
011910947814;1;146;203;207;117;119;792
029727644908;1;217;128;236;108;154;843
042815611828;1;198;203;287;69;97;854
091413821907;1;152;231;265;75;150;873
087507921995;1;260;116;107;81;72;636
027245023811;1;217;205;135;110;111;778
022713588458;1;258;228;160;84;58;788
071511153436;1;248;286;145;70;102;851
008192218931;1;136;242;143;52;102;675
066157782726;1;84;288;154;88;158;772
006300334065;1;249;239;205;63;116;872
006644554634;1;162;160;106;87;67;582
088577166889;1;95;153;127;82;159;616
011448047822;1;90;112;205;92;139;638
079734473760;1;280;175;214;58;65;792
038087891307;1;247;178;162;100;162;849
012739365199;1;118;140;93;61;112;524
043160808228;1;255;141;177;55;171;799
055802382900;1;202;101;150;63;152;668
056748853835;1;155;249;136;66;159;765
093596748457;1;178;101;99;105;95;578
065249816728;1;212;229;274;73;108;896
055259671451;1;228;265;100;78;111;782
021857370507;1;114;118;297;57;175;761
097970341375;1;261;264;285;101;91;1002
079210519463;1;243;224;248;92;129;936
083223107606;1;152;188;164;52;127;683
075347243556;1;133;89;101;110;122;555
083457313566;1;207;216;290;59;88;860
078515468600;1;215;185;96;71;127;694
086168410682;1;193;143;161;98;77;672
035197143924;1;276;91;126;52;78;623
086502522497;1;94;164;145;119;75;597
098860882058;1;257;167;128;82;137;771
053914707635;1;280;88;152;66;90;676
080333971235;1;279;250;229;86;137;981
081079718855;1;202;143;159;88;155;747
061974990813;1;138;211;184;95;130;758
045145828950;1;239;169;94;95;113;710
059125094041;1;189;232;108;86;84;699
089211033169;1;232;104;271;82;115;804
065255571147;1;262;259;273;50;165;1009
017685311590;1;273;188;160;84;152;857
081479962081;1;186;119;276;87;59;727
086283155729;1;271;123;236;58;137;825
066326899670;1;227;159;202;66;83;737
084241830837;1;235;173;222;88;121;839
092648618136;1;218;241;210;74;143;886
060145292548;1;194;151;135;102;144;726
056636779626;1;270;288;220;83;69;930
091090839091;1;94;103;99;79;57;432
063831482503;1;104;278;212;63;75;732
021808727695;1;212;203;280;54;109;858
007798111340;1;250;169;188;81;123;811
087755421894;1;189;240;217;76;78;800
045648267949;1;227;176;214;95;107;819
017102284282;1;176;125;269;68;98;736
086727449525;1;218;165;299;51;142;875
009662895700;1;150;114;105;76;103;548
032520627984;1;88;161;264;56;103;672
021861719419;1;143;171;273;70;74;731
093031365828;1;135;164;176;58;162;695
096865810601;1;138;218;124;61;163;704
051804998999;1;100;82;263;116;170;731
029251909044;1;145;85;273;65;174;742
055275055326;1;147;282;109;86;92;716
083201659525;1;99;108;191;93;74;565
086193669078;1;144;282;153;95;115;789
020020493605;1;270;84;259;111;94;818
022432814638;1;205;141;123;118;167;754
012961960031;1;109;245;139;77;177;747
006411431831;1;228;213;192;61;113;807
087442285805;1;218;196;132;82;118;746
056989920799;1;123;103;289;92;95;702
058814614661;1;192;198;187;98;128;803
056968468722;1;137;266;99;69;119;690
080128886079;1;263;225;128;65;50;731
060323137351;1;280;152;196;108;174;910
067802445417;1;106;101;94;57;114;472
015914274129;1;172;131;149;70;120;642
075728962314;1;168;236;136;116;163;819
048454568372;1;186;232;287;93;130;928
078625177986;1;238;91;139;118;167;753
092863670483;1;163;81;244;105;147;740
064630380895;1;180;143;274;116;88;801
075657819549;1;87;169;116;94;121;587
081759597404;1;189;105;212;62;119;687
003030937065;1;214;271;256;71;175;987
054390264820;1;245;285;104;75;134;843
077692272166;1;227;269;267;95;171;1029
005385614673;1;249;135;270;56;122;832
067745663295;1;260;130;130;51;97;668
095228269239;1;169;85;92;76;155;577
073285158409;1;153;233;251;70;178;885
035274781707;1;219;117;98;115;137;686
063146610458;1;117;140;148;59;72;536
057247358965;1;264;122;125;93;112;716
029030630351;1;191;153;247;104;74;769
080533831767;1;190;255;157;104;124;830
003026639503;1;133;103;228;106;127;697
021852105378;1;201;90;187;108;79;665
054347147450;1;153;173;95;111;160;692
007883431302;1;230;172;93;58;84;637
018202068649;1;222;217;268;71;70;848
065516814041;1;260;82;127;90;102;661
094550255474;1;110;199;182;53;111;655
095569913523;1;94;211;134;110;95;644
086880517139;1;199;163;169;101;134;766
057992320332;1;279;165;159;103;99;805
006864657248;1;137;86;228;77;138;666
064144549310;1;114;197;100;52;108;571
045221859614;1;151;153;203;65;169;741
005170471517;1;87;282;202;101;86;758
008693547588;1;169;207;180;112;97;765
097245533160;1;185;165;110;101;143;704
075660986972;1;196;255;243;92;116;902
089962029650;1;93;86;235;114;109;637
077357826811;1;147;220;211;107;163;848
022891534798;1;273;176;281;92;165;987
089033056063;1;225;143;290;110;155;923
032446399644;1;176;117;246;83;173;795
062673212087;1;277;160;253;120;102;912
037548862642;1;264;234;111;71;142;822
004141111226;1;147;213;253;78;89;780
004038466888;1;182;228;257;105;82;854
017072040174;1;217;187;163;62;132;761
030992356704;1;281;192;251;66;67;857
029741494252;1;159;162;202;77;139;739
081721473820;1;200;113;174;101;54;642
034090575383;1;164;116;297;67;119;763
042800878997;1;286;199;106;82;111;784
065456677017;1;235;89;150;112;109;695
027950494588;1;197;279;95;61;160;792
064599719411;1;189;183;104;60;57;593
089853970168;1;187;202;290;118;110;907
055546918753;1;143;269;274;94;152;932
070967881895;1;91;215;147;77;83;613
087270612523;1;208;211;232;116;162;929
034914676975;1;154;85;278;109;67;693
084329545289;1;160;197;259;112;62;790
025911684352;1;189;126;195;110;162;782
023791349629;1;110;191;112;72;103;588
074978282693;1;158;209;175;97;138;777
045602066427;1;270;237;189;83;133;912
000416537790;1;163;225;252;67;61;768
070994961324;1;250;181;91;50;72;644
040125391868;1;203;135;156;88;98;680
078942094733;1;163;181;202;63;103;712
001790285821;1;156;272;259;94;148;929
076845771887;1;145;91;161;62;167;626
082901799281;1;138;105;272;98;79;692
079406354864;1;285;131;160;99;131;806
013805698392;1;142;113;137;59;148;599
063740430350;1;87;201;168;107;67;630
045664577900;1;109;101;96;81;51;438
000442720675;1;122;241;293;103;120;879
022878893331;1;258;156;115;114;173;816
018137847479;1;187;125;250;91;104;757
003880141960;1;83;265;263;67;142;820
029029508480;1;160;130;120;54;106;570
072508974955;1;287;106;297;115;115;920
071807913131;1;205;153;242;51;68;719
023853937833;1;183;115;280;101;129;808
073324202297;1;110;88;262;75;67;602
011424189616;1;160;205;201;75;67;708
036207840078;1;125;208;159;79;111;682
062432622482;1;287;145;206;56;176;870
061293267719;1;178;111;275;56;75;695
026700023151;1;276;256;241;65;71;909
065171285704;1;110;87;141;51;97;486
071051754386;1;240;259;212;66;80;857
056209470770;1;264;282;195;85;104;930
029452546160;1;256;271;214;87;119;947
023727885091;1;236;154;168;76;155;789
078283010670;1;288;106;103;99;131;727
053243328969;1;154;119;207;66;135;681
070774436800;1;245;244;196;111;111;907
030368733117;1;138;211;214;78;113;754
092669440964;1;260;244;100;116;73;793
041546691330;1;258;114;171;120;71;734
044529182763;1;257;132;96;69;126;680
032493172571;1;278;287;255;119;67;1006
001872184826;1;104;234;231;87;53;709
089988412502;1;254;231;164;99;111;859
051144097537;1;265;198;94;95;178;830
051605221115;1;211;282;244;110;105;952
037576031075;1;152;128;263;108;73;724
098263491902;1;238;161;167;108;53;727
097254823938;1;96;191;245;62;130;724
000770090199;1;160;228;148;92;55;683
053691637899;1;138;243;262;115;62;820
072870940996;1;189;199;125;62;170;745
077699245833;1;110;254;135;98;125;722
081136357911;1;141;251;187;59;66;704
060694090371;1;147;221;158;110;58;694
066338319120;1;125;83;284;57;122;671
051969204025;1;109;231;221;81;96;738
066767083754;1;264;228;296;51;69;908
089022451354;1;192;213;281;78;66;830
025727014653;1;238;137;106;109;82;672
072805962994;1;130;174;251;53;59;667
014338386695;1;226;227;183;79;126;841
018249189465;1;113;224;160;82;81;660
085390261636;1;181;93;132;112;124;642
069238656411;1;153;181;221;57;125;737
003315894423;1;190;110;178;51;143;672
004856403346;1;80;268;177;98;102;725
038615608540;1;154;272;141;107;66;740
022087322170;1;119;277;232;92;94;814
055124246104;1;120;262;219;79;94;774
038715931042;1;113;167;262;62;82;686
025180267495;1;104;195;287;76;54;716
039593695853;1;126;190;164;90;58;628
040705608705;1;86;109;152;113;82;542
056820453358;1;176;124;180;72;61;613
086576361870;1;201;158;256;89;104;808
014024753679;1;123;133;188;97;163;704
038862364670;1;263;105;184;120;162;834
093057434947;1;166;149;253;79;106;753
085982422984;1;94;192;252;119;65;722
081873935267;1;263;147;98;87;93;688
072372641025;1;162;269;99;50;126;706
043354251388;1;127;185;174;92;144;722
006029904334;1;140;269;276;109;121;915
010678162699;1;135;228;204;87;130;784
057413854322;1;261;141;280;89;113;884
032442400424;1;113;175;135;83;144;650
002964856712;1;250;268;120;57;171;866
034271756728;1;279;175;90;90;81;715
062099552489;1;83;242;240;55;126;746
068837456860;1;209;162;300;79;118;868
013951824149;1;159;249;139;92;67;706
031053348885;1;232;93;169;64;114;672
075200838514;1;131;182;142;104;165;724
033701152236;1;288;252;100;115;172;927
059304074798;1;209;98;239;96;127;769
083335571628;1;251;121;247;56;90;765
058444181974;1;161;84;215;114;54;628
045115343693;1;80;259;202;55;50;646
061933011703;1;120;124;132;70;103;549
096530138167;1;173;171;150;120;159;773
002458042597;1;255;124;164;110;166;819
017444078685;1;109;86;279;70;95;639
016110577885;1;185;234;237;119;71;846
026912384414;1;219;128;100;99;56;602
083107359493;1;116;245;99;119;127;706
011809994118;1;273;269;144;70;65;821
061667764770;1;163;160;222;61;74;680
052959427695;1;148;185;206;58;137;734
079212421485;1;102;195;256;58;79;690
007000170542;1;256;90;119;111;57;633
023868278091;1;108;225;120;104;128;685
073775207630;1;200;127;296;60;144;827
048062868211;1;165;182;143;80;122;692
060492295117;1;228;273;168;60;118;847
088171615661;1;244;217;235;109;141;946
036060048204;1;91;141;143;95;68;538
031535246259;1;119;101;266;105;119;710
007422533402;1;125;214;208;105;143;795
072760227556;1;140;259;99;92;58;648
095531532716;1;256;273;139;111;106;885
029109982057;1;95;164;119;94;69;541
031823082994;1;203;84;172;50;112;621
047094368244;1;140;143;146;120;146;695
015005888792;1;97;140;113;61;147;558
046673869838;1;140;141;263;92;66;702
065807584619;1;104;101;270;107;153;735
071230477824;1;265;99;159;82;118;723
074856080662;1;117;236;230;57;147;787
045623614011;1;219;126;165;73;170;753
004425227576;1;100;222;239;50;173;784
093777639384;1;169;100;182;95;123;669
012700797649;1;115;97;170;71;176;629
066207062684;1;147;171;178;67;62;625
027797526648;1;93;114;151;74;124;556
021024440412;1;155;136;128;69;98;586
067937967517;1;280;225;155;85;52;797
063321203498;1;162;273;290;87;81;893
049237036744;1;143;219;221;110;54;747
056783874122;1;165;233;258;77;170;903
016513164629;1;259;141;280;71;111;862
096998900726;1;283;195;131;79;51;739
080630691038;1;139;192;266;79;122;798
003866249176;1;183;97;145;107;151;683
019238868343;1;193;227;219;105;152;896
060055751227;1;125;137;181;50;99;592
037431742758;1;103;92;212;107;118;632
024190574678;1;259;86;295;73;121;834
011477245509;1;222;146;243;74;71;756
036707459179;1;221;177;96;61;175;730
004815112153;1;167;111;207;62;173;720
093980107853;1;131;248;290;113;77;859
057466460239;1;125;254;296;109;127;911
034416504631;1;147;105;207;76;174;709
019244485514;1;133;118;131;60;57;499
090314103538;1;141;117;185;72;102;617
052334236196;1;165;278;190;109;129;871
090638219918;1;110;111;129;88;122;560
016474888404;1;197;191;237;102;50;777
011145216389;1;254;170;288;51;120;883
066923452448;1;114;85;272;57;170;698
072126106392;1;284;94;164;111;104;757
093919963699;1;215;134;263;92;90;794
040501414164;1;142;226;223;86;67;744
028419347865;1;236;278;157;93;127;891
000084092761;1;157;119;296;69;99;740
084809010806;1;277;195;109;59;68;708
003495166785;1;285;237;184;55;63;824
053452976084;1;138;210;282;65;159;854
044975003575;1;164;276;278;107;74;899
067938940694;1;104;214;242;54;109;723
097406202327;1;113;86;166;61;116;542
077441881733;1;213;132;106;65;100;616
079725212203;1;90;240;168;90;158;746
098308289025;1;225;81;108;99;130;643
050896875138;1;187;182;95;106;175;745
027860859917;1;237;247;221;96;122;923
099845829280;1;244;220;295;81;175;1015
043429159147;1;111;80;178;84;132;585
087700553387;1;215;95;155;95;72;632
006837082984;1;220;248;112;74;144;798
097374512776;1;273;147;93;113;132;758
091365905691;1;263;96;298;51;52;760
059196337744;1;152;284;227;96;60;819
077001073752;1;190;248;254;107;101;900
069554104003;1;187;144;150;103;119;703
072826870328;1;143;161;115;70;88;577
032364117449;1;185;107;215;76;108;691
095884731785;1;140;188;152;103;57;640
006920263985;1;269;283;209;96;115;972
034239382669;1;123;224;253;97;109;806
094698334911;1;83;182;224;62;89;640
048909664077;1;130;217;146;118;151;762
063095557193;1;181;109;101;72;114;577
094269710021;1;277;163;280;113;137;970
013822949955;1;128;227;203;74;170;802
085887522360;1;211;171;264;83;142;871
099474005485;1;144;265;193;83;160;845
045633275723;1;142;248;294;78;155;917
024210377638;1;192;287;114;87;88;768
008586370210;1;203;156;240;54;76;729
086275630644;1;241;190;147;84;91;753
018966502396;1;110;110;297;113;116;746
047869521633;1;113;177;273;67;112;742
077438069673;1;260;100;298;71;99;828
075133233642;1;286;284;229;64;129;992
036367488766;1;151;269;120;75;80;695
090491815584;1;252;88;161;97;155;753
031110812532;1;99;156;190;58;163;666
015564816664;1;201;161;254;106;62;784
073638578971;1;290;262;95;72;91;810
050187775679;1;162;158;183;95;160;758
094427484354;1;183;241;225;87;147;883
079503405576;1;113;151;284;82;50;680
036668934457;1;155;262;260;78;86;841
063381316782;1;184;286;213;61;120;864
006435359218;1;103;219;176;55;112;665
013094487854;1;186;179;170;101;76;712
053928309860;1;113;274;131;113;132;763
008308856922;1;285;224;264;113;118;1004
073551135110;1;282;203;108;54;109;756
019880788133;1;114;227;171;93;92;697
018287488527;1;163;268;270;71;159;931
062294718104;1;143;111;224;108;63;649
070993579179;1;194;242;260;57;113;866
061060056169;1;87;219;172;77;117;672
047627781774;1;205;237;103;72;101;718
018086967463;1;186;90;152;87;172;687
063953629170;1;195;255;299;105;94;948
060973165155;1;258;111;259;58;125;811
043976631550;1;180;85;108;51;147;571
033225002876;1;203;232;120;119;61;735
021990154986;1;148;101;103;108;117;577
026635341642;1;149;220;200;101;138;808
013872250763;1;193;244;300;91;161;989
026410757372;1;115;204;184;109;103;715
011017685989;1;154;273;240;60;136;863
076685843867;1;240;144;139;87;51;661
099162692834;1;226;159;299;93;132;909
013995022763;1;250;231;130;71;99;781
004437815759;1;123;229;187;104;71;714
001512461421;1;196;86;232;95;58;667
053466492632;1;170;144;205;107;174;800
068358793343;1;109;262;147;116;169;803
001359367479;1;287;130;138;60;108;723
010401086078;1;275;186;276;120;100;957
081540675876;1;133;181;210;52;113;689
019575264712;1;187;285;273;93;123;961
099765273631;1;211;142;196;120;159;828
098410475377;1;147;149;209;79;160;744
018693927270;1;179;256;138;70;105;748
019959934238;1;105;189;281;111;170;856
044148607177;1;191;124;145;75;178;713
039023210489;1;280;195;181;67;119;842
073338185065;1;283;117;300;68;61;829
003637270318;1;285;261;264;117;121;1048
039176195943;1;135;220;231;56;134;776
054190332676;1;253;159;261;85;81;839
076385790931;1;157;118;288;51;87;701
073871451625;1;231;117;256;115;142;861
016862917984;1;122;243;157;102;88;712
094178133181;1;109;210;220;80;57;676
069690298497;1;255;272;212;80;59;878
066081622077;1;282;141;170;103;95;791
008273977418;1;87;257;291;106;125;866
049996649917;1;190;138;174;109;93;704
025246527404;1;244;179;195;64;126;808
025695565826;1;241;242;103;109;91;786
025168708670;1;92;81;165;54;107;499
099901769213;1;124;282;252;86;53;797
059206616455;1;287;124;285;60;68;824
057240410334;1;131;209;252;98;64;754
052668746468;1;205;277;289;56;89;916
047669175842;1;125;201;94;89;56;565
042987576678;1;242;269;153;66;167;897
012714868734;1;99;237;217;120;129;802
077674759915;1;214;161;255;70;74;774
067595292498;1;152;128;118;89;174;661
041619044778;1;219;236;246;100;97;898
064183173779;1;116;109;179;66;103;573
093379106478;1;160;165;239;108;104;776
019547347591;1;174;272;116;111;177;850
083019624390;1;189;106;267;104;119;785
036456964067;1;220;81;263;90;93;747
099678321093;1;240;117;148;84;166;755
080143884040;1;174;149;222;90;51;686
015854353327;1;203;232;229;67;118;849
017131474556;1;190;114;274;94;70;742
085451979953;1;274;142;191;117;142;866
071401000719;1;269;195;192;104;127;887
051473844831;1;111;165;270;112;75;733
055234980046;1;283;221;135;69;120;828
095939410437;1;220;211;298;51;123;903
025983923355;1;204;221;97;83;105;710
086732626849;1;221;258;220;94;108;901
013441113906;1;267;170;217;86;66;806
098368207810;1;283;133;147;118;155;836
044096736200;1;192;229;210;81;147;859
095989498300;1;80;186;187;99;66;618
075458902962;1;84;102;103;101;91;481
067023071328;1;224;262;263;98;145;992
083561593571;1;173;258;270;104;64;869
094140519853;1;204;89;124;103;146;666
082870478747;1;194;166;289;102;153;904
049443301959;1;207;241;123;101;116;788
000157441846;1;191;269;278;56;140;934
092319880117;1;278;199;262;110;69;918
021012406890;1;221;205;261;50;108;845
042587201447;1;166;173;250;111;76;776
006535326037;1;107;97;206;102;100;612
051191531259;1;238;163;136;84;164;785
047051413625;1;122;256;146;53;153;730
087556719016;1;288;218;146;82;151;885
097560710527;1;138;271;168;114;142;833
009984335882;1;116;98;219;61;170;664
061996425326;1;190;282;249;65;102;888
018852125049;1;168;235;172;74;127;776
010732718696;1;288;174;157;80;96;795
048644043640;1;136;179;283;55;61;714
002465556937;1;127;87;165;62;167;608
090347853298;1;210;206;135;119;68;738
083710116991;1;215;112;175;51;134;687
091585619937;1;227;156;182;103;73;741
096973661707;1;185;122;148;110;53;618
044535259887;1;90;265;227;62;143;787
099068052501;1;169;119;115;102;159;664
064051418614;1;169;234;262;78;105;848
030231502631;1;241;170;288;120;93;912
059495177812;1;146;284;218;67;85;800
083966872503;1;291;172;242;89;73;867
047251615211;1;283;132;251;103;128;897
071583732835;1;131;112;179;82;87;591
085754140318;1;205;118;232;51;171;777
022816376942;1;126;248;222;107;164;867
092332650943;1;238;209;227;116;89;879
031140753100;1;236;154;216;87;70;763
072379940533;1;210;158;179;102;96;745
094522541122;1;118;149;201;50;159;677
074016691595;1;174;145;271;100;71;761
022497016862;1;224;114;211;96;174;819
081359877526;1;92;80;183;95;176;626
009395943132;1;179;229;129;56;120;713
045603389493;1;219;198;95;82;121;715
009719921044;1;283;154;105;84;52;678
032057506380;1;284;287;137;54;96;858
054357420124;1;169;221;224;83;114;811
025501297692;1;267;229;120;105;89;810
014988126276;1;91;80;213;59;170;613
059253898410;1;123;249;274;80;90;816
035641155690;1;153;182;298;97;79;809
014954519382;1;141;193;230;86;58;708
077817133845;1;116;206;215;87;67;691
004386607375;1;116;119;112;85;82;514
084544976561;1;271;271;252;101;109;1004
050748583288;1;84;138;221;107;147;697
021953605084;1;285;81;294;98;118;876
045830503711;1;183;162;207;109;120;781
053417427308;1;225;163;236;76;112;812
022647751418;1;91;114;262;57;127;651
095686574761;1;161;222;143;76;162;764
018496613440;1;274;112;125;110;113;734
000522639058;1;107;266;96;116;97;682
029032087299;1;168;224;196;119;89;796
074897322258;1;219;136;121;105;74;655
039031943855;1;125;197;221;104;114;761
087859197315;1;170;254;123;67;124;738
033990928904;1;292;264;202;79;77;914
015387099659;1;80;169;159;87;72;567
002991614734;1;277;287;95;70;80;809
028899886636;1;92;140;247;51;91;621
015441694702;1;130;175;146;75;163;689
079293336613;1;232;106;290;102;55;785
029210187013;1;156;157;266;96;174;849
068912618633;1;280;119;235;66;61;761
023098403728;1;157;209;226;74;170;836
076584519031;1;248;278;215;93;83;917
054283404535;1;136;80;97;74;164;551
000252019640;1;235;116;241;89;178;859
068971925520;1;215;274;267;103;169;1028
098862917709;1;150;231;179;75;123;758
026509095873;1;256;235;124;97;79;791
073220812900;1;255;217;231;56;66;825
009887452083;1;182;149;97;66;84;578
068737479028;1;116;210;262;59;172;819
062246777456;1;163;219;290;101;136;909
031672160798;1;115;129;104;55;119;522
035527269927;1;280;273;101;58;53;765
090266860308;1;138;170;113;66;151;638
064511494997;1;190;131;161;101;74;657
026507992872;1;199;228;239;64;78;808
001309273440;1;120;262;194;68;150;794
093219855105;1;255;256;246;70;96;923
032120488497;1;221;284;130;103;174;912
084595578066;1;257;82;159;119;151;768
019949984390;1;253;171;111;67;114;716
094459610729;1;216;100;216;110;59;701
096864227447;1;134;122;174;81;79;590
001096405998;1;221;121;188;87;177;794
002238145196;1;85;184;195;60;80;604
062119338356;1;239;212;281;111;85;928
076963543377;1;199;245;262;63;107;876
094709031150;1;185;193;247;114;65;804
065450140371;1;160;287;182;117;89;835
043119421221;1;210;184;214;98;165;871
005214249479;1;101;93;183;82;71;530
046977165279;1;267;176;289;60;75;867
094475064017;1;237;238;223;53;118;869
099023382754;1;107;80;255;93;136;671
018645242720;1;124;284;223;111;55;797
085695432318;1;187;279;184;52;133;835
008248957369;1;120;285;151;80;98;734
085205966629;1;239;279;143;90;157;908
027521487540;1;216;215;100;112;166;809
063090924583;1;182;157;235;63;151;788
079306133782;1;292;192;204;69;87;844
060888281301;1;264;270;286;72;111;1003
007545343428;1;144;180;271;73;149;817
084388865493;1;102;259;185;54;66;666
022550289429;1;285;116;244;86;95;826
052428489708;1;177;241;226;71;114;829
007157162166;1;119;206;220;119;156;820
033644637328;1;164;160;245;105;120;794
056643246398;1;121;221;215;64;156;777
063170213573;1;91;199;221;116;131;758
073126159204;1;263;204;98;58;161;784
021794901243;1;273;204;148;70;143;838
085742042917;1;227;227;291;118;89;952
065315508118;1;89;183;298;64;51;685
045877072969;1;109;233;169;78;135;724
082625652521;1;190;149;239;105;65;748
014268889058;1;100;168;193;51;110;622
001584145115;1;108;96;115;54;117;490
063328288154;1;255;232;214;58;111;870
013786935648;1;158;225;129;78;126;716
022955330470;1;143;261;210;112;73;799
053237294166;1;159;259;211;70;135;834
078766947185;1;183;136;174;116;171;780
092378494192;1;286;95;199;70;76;726
052474059918;1;273;253;176;63;129;894
078467193379;1;139;253;151;55;82;680
063995375595;1;147;86;229;72;93;627
089825211496;1;250;149;109;77;89;674
002120509665;1;80;233;275;56;70;714
092466986320;1;283;226;170;118;84;881
006006523153;1;270;137;300;51;84;842
075214008236;1;193;200;187;90;68;738
021063149376;1;210;200;177;69;164;820
067712796537;1;128;129;234;69;130;690
067080948205;1;291;268;289;64;111;1023
080247224244;1;219;97;179;60;132;687
068033291315;1;211;147;239;98;69;764
051920411665;1;261;190;290;72;122;935
061040605180;1;132;221;187;83;110;733
012994942549;1;181;86;139;82;54;542
089702790910;1;210;276;289;101;89;965
011151175294;1;176;233;250;94;135;888
081835065965;1;124;121;183;90;65;583
093172763616;1;216;131;93;78;77;595
043881080735;1;108;176;247;76;59;666
081748541039;1;118;170;134;89;132;643
028339881227;1;288;99;100;120;57;664
049706437943;1;172;178;266;95;152;863
045092244500;1;175;115;278;98;105;771
044521861497;1;152;226;271;95;83;827
059827146466;1;223;165;234;117;103;842
071503869967;1;274;198;114;94;94;774
021845136403;1;283;220;184;109;72;868
085397385547;1;177;260;193;68;162;860
030545399207;1;159;103;152;61;118;593
094512593634;1;249;194;230;60;84;817
009821824769;1;222;281;275;70;115;963
046444000961;1;115;131;234;66;62;608
093377673939;1;261;96;288;110;76;831
081329534896;1;138;150;106;69;77;540
008610701034;1;196;272;204;101;128;901
063323895648;1;137;136;259;111;136;779
049420209879;1;90;136;289;116;114;745
066801697827;1;161;166;300;106;63;796
077947925055;1;169;163;283;97;133;845
018095079018;1;245;280;249;93;61;928
014082455772;1;195;215;156;108;56;730
093656530844;1;260;179;258;110;128;935
095050520833;1;247;97;257;103;151;855
057832735551;1;167;229;179;99;61;735
070497348123;1;126;132;138;81;78;555
036549948136;1;81;131;132;63;133;540
099502443670;1;275;225;150;90;112;852
010670419337;1;92;149;107;95;177;620
051577926311;1;187;236;238;74;111;846
025885350891;1;281;178;267;107;55;888
081603054542;1;247;149;210;58;63;727
089828833303;1;190;220;221;103;173;907
006444661565;1;106;80;116;54;77;433
023679682126;1;221;186;203;95;126;831
041068340718;1;272;165;259;107;62;865
066080847017;1;215;225;267;104;120;931
049426349304;1;239;227;142;84;122;814
010639808867;1;274;88;162;62;73;659
047654112081;1;120;117;228;93;149;707
062856483807;1;169;80;119;108;155;631
011404595960;1;135;265;219;51;143;813
069153911816;1;259;89;291;97;78;814
022713646117;1;93;82;207;80;151;613
078965023804;1;210;252;90;74;148;774
036498024154;1;245;116;274;96;135;866
028021983405;1;198;241;128;106;116;789
063151082754;1;146;172;165;98;164;745
020714588133;1;123;265;292;57;79;816
074553283328;1;175;284;275;55;85;874
038667046282;1;182;91;147;90;88;598
028994065814;1;292;279;267;67;115;1020
061450760028;1;125;285;242;88;143;883
012049349616;1;273;278;109;65;151;876
039294138748;1;237;284;293;81;130;1025
048980315719;1;259;85;263;60;116;783
098504253750;1;275;99;148;59;97;678
011857016384;1;215;274;208;82;78;857
051705573272;1;91;185;296;113;136;821
016077780792;1;143;208;150;102;67;670
009878370816;1;287;107;205;58;99;756
088086860051;1;172;270;140;114;74;770
021189026041;1;167;247;125;85;94;718
001625327300;1;237;185;291;112;155;980
090843681237;1;127;100;186;61;164;638
040869902858;1;269;255;152;67;166;909
072296542773;1;114;125;259;78;50;626
062331631411;1;227;218;132;113;89;779
052684335633;1;198;159;165;116;114;752
051802880925;1;170;220;279;72;57;798
079778258780;1;153;136;186;75;122;672
034750763352;1;235;227;261;111;82;916
007864520670;1;286;96;270;118;135;905
051015213644;1;211;244;144;66;163;828
093674223209;1;173;189;102;101;97;662
049250604942;1;167;158;292;74;82;773
033545537550;1;221;231;162;107;60;781
011640602337;1;214;100;177;107;177;775
011153346809;1;146;174;298;105;143;866
085974079588;1;84;216;236;102;140;778
034612011107;1;185;90;296;75;86;732
002772685375;1;270;238;115;52;146;821
053068158957;1;100;261;254;60;177;852
019971143127;1;229;279;287;87;145;1027
038496040708;1;94;157;124;117;94;586
070728676767;1;236;240;118;65;52;711
061754554360;1;149;186;296;74;128;833
053834284533;1;147;96;218;99;160;720
042048818708;1;178;254;97;106;51;686
095372623206;1;204;96;151;120;116;687
068696844865;1;279;110;223;95;77;784
033382221627;1;112;125;126;109;140;612
021120025324;1;220;143;119;66;114;662
026085919058;1;141;279;167;109;64;760
032101159253;1;86;275;183;82;97;723
031774217954;1;238;244;193;73;62;810
094149170286;1;124;220;211;94;59;708
020348178720;1;215;187;149;103;116;770
075853811933;1;204;184;170;91;71;720
071971724761;1;92;212;225;50;163;742
045407264356;1;260;116;206;64;154;800
043755263707;1;266;275;269;72;169;1051
038221492701;1;223;163;188;51;130;755
043272448243;1;152;184;115;71;92;614
075737893311;1;137;134;227;80;135;713
002724161932;1;171;212;181;71;92;727
085436750089;1;245;119;234;77;152;827
066204227151;1;251;103;277;96;172;899
029222126021;1;168;149;192;63;53;625
024656558321;1;132;135;232;104;66;669
083103084001;1;287;209;185;61;155;897
069717697633;1;178;268;140;80;158;824
031255384158;1;260;197;191;101;150;899
083705573550;1;134;84;252;110;134;714
028375719516;1;255;259;117;105;62;798
062080068305;1;82;126;216;78;89;591
097496291500;1;188;93;283;50;172;786
018644869367;1;131;188;216;119;86;740
036299440923;1;164;246;272;70;88;840
039210663852;1;196;269;250;82;169;966
038901540093;1;151;211;102;73;73;610
011434166806;1;220;166;93;84;163;726
096027813103;1;250;115;124;53;93;635
041894603368;1;154;202;115;63;169;703
060557905244;1;99;98;143;58;58;456
082293587660;1;244;285;120;113;99;861
054535825974;1;144;182;99;58;85;568
088757197325;1;291;131;232;60;148;862
074937623516;1;110;147;177;95;165;694
036736261517;1;244;111;102;105;95;657
062272064646;1;216;210;129;89;67;711
047281604225;1;279;150;202;104;165;900
054004987927;1;240;283;295;117;100;1035
024830232509;1;283;97;131;119;118;748
042126246160;1;211;119;270;98;54;752
068017054250;1;132;120;240;55;83;630
054812381763;1;94;180;174;72;130;650
023272134002;1;224;164;121;51;71;631
096895529443;1;292;251;204;83;151;981
018354179127;1;165;287;94;59;152;757
067219955869;1;200;232;116;108;121;777
010418524853;1;192;270;206;83;62;813
014551426379;1;236;113;221;85;122;777
088598397581;1;188;169;287;110;143;897
089259221661;1;223;105;125;97;125;675
020284704619;1;161;131;144;52;99;587
077115564062;1;257;197;124;94;140;812
075750439569;1;188;152;149;96;94;679
058031318242;1;164;231;147;102;165;809
093336836405;1;244;235;274;103;70;926
098380899174;1;116;216;279;73;101;785
066292343082;1;162;172;134;92;162;722
069503842707;1;276;233;138;100;155;902
098343580670;1;248;259;115;110;134;866
043158699548;1;201;166;248;108;129;852
089034896898;1;269;124;207;83;172;855
075140087497;1;244;165;287;109;172;977
056614405149;1;160;112;146;68;166;652
037753629137;1;98;246;123;53;76;596
016773147696;1;89;201;103;91;174;658
000950435007;1;211;101;104;120;161;697
015188478912;1;136;281;150;97;140;804
025938247444;1;115;234;294;51;110;804
021495083976;1;152;286;229;60;113;840
020162961470;1;99;148;280;103;93;723
010175307171;1;273;122;172;96;170;833
049705031588;1;286;238;140;67;124;855
017227633849;1;127;271;194;75;172;839
004161394277;1;254;218;252;86;178;988
035780930197;1;183;153;90;107;65;598
056912137722;1;191;166;294;78;91;820
098259143055;1;242;186;196;109;115;848
057177232408;1;247;163;107;109;148;774
021166741100;1;206;83;251;82;50;672
008436029324;1;127;104;165;57;127;580
045551975328;1;219;257;283;86;171;1016
023716083987;1;227;217;196;75;91;806
032585799998;1;160;158;123;116;103;660
057928068585;1;196;116;293;83;125;813
016435099101;1;287;211;92;109;136;835
058836941585;1;266;243;264;93;77;943
064664865520;1;231;222;136;77;75;741
079219015454;1;190;196;116;100;72;674
006954530715;1;242;132;275;94;63;806
077899269535;1;132;90;295;59;75;651
064543725956;1;214;178;297;89;91;869
021911022073;1;124;183;257;60;60;684
017416153159;1;143;183;288;57;151;822
039178937726;1;80;113;137;107;174;611
066071182418;1;267;108;161;107;147;790
078488441341;1;144;186;112;53;79;574
043327097897;1;106;156;191;91;90;634
092726183432;1;142;271;274;120;80;887
090828001586;1;276;164;173;87;151;851
070728989393;1;289;94;203;87;136;809
069947837108;1;132;238;293;101;50;814
099327826288;1;223;207;113;105;85;733
045543123207;1;234;98;115;73;159;679
079714500063;1;168;180;188;86;150;772
071802081066;1;235;99;223;101;158;816
035653024548;1;137;186;202;78;84;687
091064810089;1;113;193;164;62;138;670
012995533452;1;260;215;154;94;157;880
019564914201;1;98;84;147;109;154;592
049868248480;1;125;88;130;66;55;464
070187480449;1;142;85;134;60;154;575
066505844619;1;137;184;223;80;73;697
081460948286;1;178;262;199;106;58;803
030130681838;1;215;154;278;89;76;812
037487561266;1;221;97;170;103;77;668
070055225995;1;244;117;245;104;146;856
013341136253;1;233;260;283;108;158;1042
076193576759;1;161;207;209;92;64;733
044910991029;1;202;206;143;91;90;732
019653837847;1;254;132;153;96;175;810
085575914805;1;121;110;96;108;89;524
030965497264;1;252;287;287;73;157;1056
008570237190;1;202;126;290;108;113;839
062864412377;1;160;84;267;67;54;632
099838738140;1;256;168;160;78;83;745
009927084358;1;120;244;142;54;71;631
038067236428;1;221;198;287;61;144;911
058293273095;1;289;251;183;89;99;911
043119460374;1;194;247;172;112;120;845
004669433494;1;172;191;221;65;78;727
082034919726;1;184;84;167;65;146;646
099242971950;1;233;285;177;54;165;914
034517644583;1;228;134;243;119;71;795
047369352712;1;228;215;106;76;109;734
094000982500;1;243;204;209;87;145;888
031312371736;1;190;264;208;91;155;908
033983058916;1;261;104;213;109;167;854
046973098182;1;220;218;144;51;139;772
059274482566;1;272;257;226;85;105;945
021406661846;1;228;286;134;80;144;872
052379251737;1;153;280;263;70;92;858
038345147373;1;175;221;214;113;176;899
001654071532;1;219;200;159;69;172;819
088960170918;1;197;98;107;71;89;562
033701309248;1;189;183;193;89;175;829
060444485442;1;202;116;240;58;131;747
079722178714;1;226;212;274;61;81;854
079598666260;1;192;179;234;113;88;806
014501052848;1;95;215;199;68;163;740
031192279407;1;234;272;189;86;108;889
087200576294;1;133;208;132;65;78;616
089854820197;1;177;251;152;97;133;810
009912576368;1;93;288;143;70;131;725
031202111660;1;132;126;262;80;152;752
099027276380;1;154;222;99;59;123;657
085815940735;1;218;159;154;76;96;703
044735367013;1;285;90;173;75;144;767
041966371052;1;118;171;241;66;50;646
077203913417;1;135;219;281;114;70;819
046041096876;1;110;239;103;92;127;671
048965231154;1;148;122;257;105;55;687
040496577666;1;279;229;216;89;112;925
011781025100;1;245;83;167;51;87;633
071337225926;1;197;224;155;117;115;808
060329187966;1;163;199;184;109;55;710
007954638470;1;138;228;132;116;61;675
097670888152;1;183;276;218;79;56;812
093099512618;1;199;202;232;84;128;845
053935946623;1;270;141;234;83;99;827
010716551252;1;278;87;278;111;168;922
069493890160;1;162;240;137;67;169;775
026136933246;1;143;270;90;118;103;724
094986484310;1;208;179;276;107;63;833
085882338152;1;101;287;168;117;93;766
007060384418;1;114;161;229;50;116;670
012584841913;1;101;170;276;109;166;822
084162285709;1;287;162;267;55;130;901
005484003178;1;199;81;227;73;94;674
084189407718;1;161;161;202;83;160;767
038196087257;1;227;81;233;65;150;756
082013442753;1;150;159;131;114;168;722
001760998639;1;204;151;95;52;172;674
070643671081;1;186;83;121;64;77;531
072758771499;1;107;150;225;86;108;676
065421563162;1;203;91;250;108;127;779
028264672791;1;111;175;98;105;72;561
038697551881;1;122;88;203;54;140;607
056583047034;1;109;180;133;120;145;687
039978521573;1;227;205;129;64;122;747
007085557604;1;171;118;113;63;169;634
010053620249;1;94;184;252;107;161;798
025661809903;1;274;261;95;58;106;794
060930719874;1;132;251;182;99;146;810
056170676600;1;221;212;276;108;170;987
060124345861;1;137;135;197;118;118;705
055703484902;1;232;122;99;96;141;690
022559659607;1;264;187;274;111;161;997
013979934417;1;158;201;259;105;87;810
037493642668;1;127;94;255;88;55;619
057413850617;1;84;135;285;68;132;704
002391760768;1;273;207;157;77;120;834
015705739748;1;83;286;186;100;124;779
029468578475;1;94;105;212;80;73;564
000102076333;1;111;161;118;110;88;588
083324777001;1;190;83;147;69;104;593
036167761538;1;291;195;172;85;101;844
096551026401;1;257;239;195;58;126;875
076051788951;1;129;255;110;68;158;720
096072935379;1;107;155;254;98;123;737
011088330078;1;244;272;300;50;73;939
066109060006;1;251;241;242;81;131;946
043751508226;1;188;258;284;117;153;1000
070178357323;1;231;181;229;56;153;850
082881492939;1;271;138;151;56;86;702
092346407429;1;80;82;225;87;149;623
015057010429;1;232;219;109;90;112;762
069542570988;1;118;263;219;50;127;777
078405404274;1;195;267;222;103;130;917
030491880540;1;224;151;276;120;163;934
017219326728;1;85;133;268;113;121;720
001438189816;1;279;283;232;61;106;961
075694221035;1;180;203;256;101;59;799
053600215040;1;146;268;109;97;150;770
087796451009;1;283;177;128;96;81;765
037870782690;1;109;97;117;92;86;501
089363111128;1;220;228;176;96;57;777
093345991511;1;193;196;299;75;83;846
050412847690;1;162;259;289;110;123;943
004659370300;1;209;276;255;117;145;1002
041738535244;1;278;120;236;50;73;757
064232574642;1;241;142;264;114;87;848
086086270523;1;99;242;239;80;121;781
083542907362;1;145;129;102;87;87;550
065016980286;1;152;256;132;94;120;754
074820454532;1;134;142;213;61;66;616
040398966586;1;180;186;133;91;56;646
083717731854;1;235;237;138;92;102;804
030205526277;1;217;228;287;114;90;936
022851065152;1;209;88;176;89;98;660
009465172602;1;241;243;282;120;65;951
032123724557;1;219;175;239;79;176;888
019882572510;1;176;138;236;112;77;739
056988848330;1;230;193;178;66;90;757
010680484085;1;237;224;160;85;155;861
075617643958;1;273;194;204;116;86;873
009287859406;1;261;215;98;60;96;730
075136518219;1;156;107;254;57;75;649
045676280437;1;134;175;180;111;87;687
056128292012;1;152;282;241;74;112;861
048981284335;1;278;135;262;116;174;965
035337783056;1;290;260;167;75;122;914
078950721894;1;143;231;257;115;117;863
098668815612;1;229;250;179;93;153;904
078717588505;1;264;280;156;50;105;855
092835103807;1;160;164;166;108;67;665
093859408235;1;88;167;213;105;151;724
047515075950;1;236;253;179;65;86;819
073421826401;1;164;158;224;113;100;759
099878381277;1;238;123;92;63;86;602
036942299914;1;210;160;247;116;158;891
050435199427;1;250;80;217;106;58;711
040488930587;1;232;267;232;93;76;900
012113452946;1;188;112;107;87;62;556
036364842127;1;143;105;186;91;178;703
055855124446;1;251;275;182;97;167;972
016366640695;1;270;243;217;56;142;928
028453110296;1;176;176;222;73;131;778
065301491221;1;182;172;282;120;158;914
084264427911;1;254;128;218;68;142;810
017591171815;1;117;228;145;69;110;669
021270259285;1;115;111;229;118;73;646
083667328733;1;274;202;194;91;67;828
059073373078;1;130;224;97;107;120;678
038024288531;1;117;261;162;91;159;790
053259632816;1;131;221;187;111;97;747
065209915286;1;193;270;234;107;83;887
052904640659;1;218;166;293;51;61;789
091691516395;1;200;210;249;84;77;820
015642847322;1;270;129;263;62;173;897
042860559329;1;171;160;279;117;132;859
044221144880;1;278;227;126;74;66;771
061401688850;1;248;101;271;80;147;847
074151774524;1;260;287;257;93;157;1054
041570925235;1;285;222;148;89;60;804
019362898239;1;181;111;92;94;170;648
002370202184;1;88;190;156;61;145;640
043756509049;1;155;221;252;113;169;910
019106351080;1;233;139;196;79;166;813
012619171086;1;266;273;109;78;149;875
006340288015;1;289;166;184;50;152;841
081055005074;1;204;119;110;102;67;602
056129599810;1;272;189;148;117;109;835
065901757551;1;235;168;241;73;117;834
020297341464;1;253;278;180;106;97;914
028542712659;1;292;156;201;73;96;818
045584175200;1;80;255;102;110;76;623
041583637079;1;154;236;289;56;175;910
033356522388;1;225;82;275;84;85;751
078229383607;1;261;261;134;110;67;833
047410157495;1;87;133;114;92;116;542
019007082154;1;257;181;265;80;99;882
098994230770;1;187;98;102;109;72;568
059785469941;1;244;238;204;118;83;887
040079155890;1;160;117;116;72;127;592
030722346524;1;198;207;117;85;106;713
022373514062;1;238;108;227;68;134;775
078089827573;1;188;231;171;61;141;792
013672939910;1;127;125;252;51;176;731
066197252663;1;156;95;296;108;176;831
093793923675;1;242;91;235;102;97;767
011125882665;1;217;233;106;98;162;816
024937672795;1;155;283;266;111;87;902
083101807159;1;136;274;94;107;167;778
090215839773;1;205;186;241;63;73;768
099056872903;1;227;167;154;120;148;816
094202788415;1;221;171;279;104;143;918
014224220027;1;125;199;259;58;177;818
002836880455;1;164;123;292;105;95;779
034772415279;1;135;158;248;85;125;751
021975103889;1;108;109;231;72;164;684
077538787922;1;189;135;290;70;170;854
043092760030;1;162;105;259;97;119;742
059274402900;1;182;269;137;85;53;726
030046859156;1;84;131;252;86;173;726
085054405759;1;231;136;229;84;51;731
045815472787;1;130;204;169;97;98;698
075917833623;1;282;138;125;104;84;733
019709495218;1;106;148;114;59;120;547
010763531434;1;237;210;113;106;149;815
092309966289;1;164;121;234;71;145;735
000397894326;1;187;150;246;116;128;827
066872872629;1;278;249;299;112;101;1039
063088547639;1;197;260;268;94;108;927
074627961224;1;147;117;238;108;142;752
075483189915;1;254;282;112;56;140;844
033909281716;1;171;142;97;87;113;610
021137663477;1;258;281;229;102;129;999
057014014471;1;185;92;199;80;62;618
018021767895;1;176;127;109;63;68;543
050793735776;1;218;284;139;95;154;890
091616306348;1;272;194;114;59;89;728
054114602914;1;147;241;178;90;72;728
070833300985;1;201;180;277;76;117;851
046355216132;1;216;114;256;92;112;790
052007844778;1;274;230;188;92;122;906
042371424200;1;84;183;131;67;84;549
035857617682;1;168;104;108;74;97;551
039401049708;1;107;170;135;101;83;596
078261741308;1;259;202;113;78;158;810
093517494230;1;274;245;256;103;65;943
099991332956;1;186;102;269;52;146;755
017713063509;1;187;183;123;82;94;669
065959859497;1;84;84;226;81;147;622
068927254876;1;232;233;193;116;62;836
008672407409;1;114;122;300;62;141;739
050888647646;1;187;288;261;79;130;945
066451977004;1;109;183;268;104;135;799
091156059901;1;147;98;224;86;144;699
076533205574;1;237;100;238;120;135;830
076937904101;1;284;178;111;80;102;755
096601615641;1;134;156;101;99;63;553
067946499765;1;182;80;128;68;125;583
084367781759;1;158;103;189;119;62;631
081410018419;1;106;214;237;84;76;717
048386721715;1;219;230;224;100;70;843
050742265954;1;235;151;151;79;117;733
003352014723;1;217;227;153;112;68;777
021606457140;1;141;187;173;90;132;723
006727714177;1;107;253;214;59;174;807
001759722359;1;270;206;121;94;162;853
050289309905;1;118;176;192;64;166;716
029606208939;1;120;269;153;63;102;707
047701990956;1;200;221;285;69;94;869
037009436928;1;99;208;103;82;139;631
079023378091;1;154;115;110;72;147;598
023046714054;1;154;218;156;65;52;645
035996210620;1;117;170;144;68;135;634
061130263308;1;119;190;232;82;164;787
037703689969;1;89;232;296;53;103;773
002344875910;1;262;89;205;73;127;756
085417118556;1;269;132;221;85;114;821
024447321000;1;170;238;240;101;115;864
025214791332;1;238;278;154;92;125;887
080844352736;1;88;153;249;53;141;684
066507187710;1;283;118;236;51;90;778
016600598584;1;291;91;143;109;77;711
049613454627;1;120;248;133;90;167;758
059568694054;1;150;143;159;120;138;710
016922910076;1;277;163;288;94;69;891
002466157594;1;247;285;169;80;111;892
025685724850;1;116;220;184;72;115;707
024522478911;1;118;283;170;107;82;760
078737495382;1;106;249;236;60;62;713
032276975885;1;220;177;247;77;139;860
093140524476;1;93;263;251;97;148;852
057450845787;1;155;189;160;57;122;683
080427045199;1;136;198;94;96;87;611
021332696350;1;163;87;259;95;50;654
046572820238;1;268;242;255;55;50;870
079457510533;1;86;160;214;78;51;589
086144475720;1;163;117;207;53;104;644
063228929866;1;92;275;243;110;128;848
058468595040;1;96;260;254;87;158;855
044542543373;1;213;127;206;63;58;667
031570342067;1;213;177;246;75;69;780
024062905605;1;89;282;159;98;112;740
010078438172;1;290;181;177;117;149;914
061736273640;1;284;229;155;104;169;941
075706863530;1;151;203;173;86;150;763
010532802972;1;145;110;173;93;78;599
013565951416;1;205;216;124;65;86;696
028308871140;1;135;247;150;115;171;818
037329192687;1;134;147;133;99;134;647
035371911825;1;261;153;90;59;108;671
075940976734;1;192;236;240;115;112;895
000031590106;1;274;110;141;110;117;752
089758513166;1;242;137;112;58;124;673
023258540011;1;275;123;176;100;78;752
094669973409;1;106;114;291;57;104;672
084601701489;1;151;162;143;101;155;712
081993090838;1;230;113;263;73;116;795
073961358938;1;263;189;281;71;73;877
077778308589;1;113;93;179;57;164;606
032656000710;1;151;175;258;55;64;703
042342333154;1;281;274;119;61;133;868
073952014501;1;200;234;119;85;124;762
053980539352;1;190;171;98;115;147;721
050702350798;1;129;96;177;94;151;647
008798015605;1;156;181;234;96;151;818
065027423030;1;163;272;121;71;149;776
048562977913;1;285;254;235;97;94;965
028435222168;1;165;221;205;59;123;773
035448433176;1;282;105;167;83;173;810
015282039787;1;84;116;206;79;77;562
003560441101;1;150;187;253;109;70;769
027888641844;1;204;248;205;60;103;820
008968457236;1;151;98;117;72;99;537
018891641898;1;208;169;247;99;123;846
083950019609;1;164;163;154;71;71;623
011953721525;1;80;191;232;82;151;736
091969567870;1;166;144;245;119;166;840
007968011296;1;266;172;244;104;120;906
053103490007;1;88;144;193;101;87;613
008703683229;1;189;106;210;85;102;692
033167432260;1;166;139;179;104;87;675
071963863990;1;229;168;91;75;98;661
044163662124;1;81;159;203;74;145;662
007402517938;1;223;189;287;68;171;938
051610711423;1;141;263;180;89;116;789
066697393668;1;153;238;218;68;99;776
057207989300;1;236;257;130;119;100;842
061489440285;1;142;236;204;68;68;718
058855552763;1;243;134;150;73;162;762
082635917179;1;132;147;281;91;95;746
030476640349;1;264;287;100;74;97;822
094885742237;1;216;145;273;58;93;785
035598085766;1;186;269;93;114;68;730
038592915752;1;122;121;288;50;109;690
084999207597;1;176;171;93;77;168;685
015119733573;1;192;217;110;59;128;706
035554038908;1;268;176;107;76;145;772
095221160621;1;217;259;159;112;57;804
020194993648;1;169;114;262;95;134;774
035961164444;1;135;146;141;94;59;575
024478808795;1;255;199;273;79;158;964
027648306582;1;188;216;204;94;173;875
015751596682;1;220;283;279;97;122;1001
083638121413;1;91;146;213;87;141;678
050724006870;1;186;260;197;55;104;802
024534318853;1;159;231;119;57;157;723
095601709915;1;256;90;257;107;155;865
097354687581;1;102;243;153;117;164;779
077804115157;1;95;280;217;94;71;757
083919972558;1;174;256;123;51;140;744
063309626175;1;155;253;137;82;91;718
021058245315;1;192;253;254;88;117;904
083342498245;1;240;113;104;100;151;708
050646862385;1;91;129;238;116;148;722
052758541236;1;210;215;206;118;154;903
025432817660;1;269;282;220;99;116;986
038409778406;1;93;102;291;119;96;701
046811890186;1;264;101;197;86;131;779
017195645409;1;284;209;178;60;78;809
058191864853;1;85;231;152;91;148;707
058524392120;1;122;199;203;58;92;674
017053446218;1;98;222;293;101;68;782
043076320859;1;129;90;91;52;98;460
063060089301;1;112;130;264;100;50;656
066034198238;1;257;191;279;94;144;965
000473849290;1;134;267;138;77;166;782
084270070084;1;235;278;279;92;87;971
074344717135;1;276;174;130;62;83;725
072718450279;1;157;212;233;82;92;776
076937847111;1;179;139;210;70;90;688
077415372817;1;284;262;225;92;158;1021
029081818762;1;263;267;188;114;112;944
026197901381;1;290;143;265;103;59;860
041289592774;1;144;204;157;88;63;656
014764776807;1;233;191;206;119;130;879
038323335626;1;230;250;158;68;163;869
036332548727;1;152;153;127;75;66;573
050028320735;1;150;191;106;84;149;680
024466023103;1;124;145;131;86;147;633
016837710461;1;253;273;296;86;154;1062
056671543678;1;91;287;170;73;75;696
037068246810;1;96;226;97;69;94;582
097097470953;1;134;132;246;104;75;691
023905497953;1;111;237;131;50;139;668
037644266991;1;160;88;159;52;87;546
038687312528;1;291;229;127;60;146;853
095410465703;1;175;163;148;63;160;709
093897666080;1;171;134;235;52;138;730
011269706136;1;197;182;168;69;170;786
064677936619;1;253;120;248;79;167;867
086312804254;1;282;254;151;66;53;806
044686940110;1;156;81;166;88;73;564
039264636175;1;253;142;204;69;106;774
034019817344;1;239;195;260;67;81;842
042760628123;1;200;261;274;108;92;935
050716647073;1;208;170;240;60;122;800
073314675659;1;98;136;123;52;96;505
089475998376;1;189;136;183;77;55;640
068737712655;1;152;217;173;67;128;737
065542919175;1;168;241;285;51;131;876
081619217996;1;107;175;146;90;120;638
020916371047;1;110;209;107;112;56;594
084170460097;1;176;106;300;114;147;843
052170732406;1;206;124;274;65;100;769
045114688900;1;269;244;188;81;137;919
067849079980;1;243;266;197;100;174;980
049525291728;1;123;248;247;68;156;842
049067075472;1;106;185;215;81;126;713
008792867489;1;145;191;202;115;150;803
097763107477;1;280;157;185;103;126;851
034921819045;1;200;267;186;102;69;824
042057777655;1;101;114;270;59;96;640
067738333283;1;94;205;102;55;137;593
073572929958;1;168;231;114;112;154;779
076507026925;1;110;114;286;96;80;686
080575088352;1;276;240;232;53;160;961
004597423567;1;259;197;105;101;145;807
094159781766;1;191;253;99;101;104;748
028411287047;1;220;250;135;84;139;828
078282862669;1;160;213;239;51;138;801
043000830807;1;194;264;123;111;94;786
099110590631;1;103;232;291;97;145;868
037103975722;1;194;280;189;81;53;797
084993645466;1;190;268;179;50;123;810
002156550886;1;152;278;145;80;160;815
006903155999;1;287;189;133;88;173;870
084258090954;1;93;159;109;53;66;480
052836332220;1;182;179;120;113;157;751
085023475717;1;238;215;94;91;137;775
072616833252;1;138;262;293;52;75;820
069551516458;1;131;104;292;64;61;652
033557714614;1;103;113;234;77;162;689
018155618127;1;267;232;152;69;169;889
087675381446;1;122;162;133;112;59;588
056253657252;1;96;227;191;51;64;629
014551869987;1;109;288;256;118;159;930
087782632199;1;91;288;97;58;120;654
094336423886;1;86;175;297;64;90;712
010758918659;1;102;116;224;107;87;636
014350093771;1;111;219;245;87;71;733
084841461449;1;281;93;172;68;145;759
016727762184;1;201;120;155;61;134;671
099614607908;1;271;113;170;80;139;773
017994344235;1;170;113;194;89;74;640
039633071284;1;103;100;155;50;76;484
083945991876;1;202;160;148;54;158;722
048201601200;1;247;140;293;73;171;924
051727231860;1;291;177;173;82;171;894
074060989252;1;190;160;140;109;137;736
006521505761;1;110;150;176;97;59;592
076653921744;1;90;149;141;101;96;577
024453891563;1;250;194;93;87;96;720
020957025406;1;256;180;172;65;164;837
070125367809;1;150;80;247;79;119;675
065696997122;1;102;235;245;77;69;728
024871868340;1;276;154;287;113;51;881
061019710423;1;101;93;287;56;177;714
054582112049;1;101;139;232;62;139;673
087620396651;1;266;198;133;100;67;764
045881657275;1;222;145;131;54;52;604
018345312131;1;170;127;198;67;108;670
009208114787;1;272;192;201;97;178;940
034420712042;1;277;83;163;111;147;781
058607789988;1;134;232;188;118;139;811
083222650995;1;160;160;119;113;60;612
003154695334;1;251;185;235;58;159;888
091149842779;1;144;90;105;104;86;529
008365389943;1;211;111;115;64;99;600
005864323465;1;254;238;232;90;81;895
038604741799;1;223;161;110;51;135;680
044751933768;1;270;267;156;68;59;820
098578817641;1;266;154;277;104;89;890
018707839082;1;222;191;142;51;52;658
056943463749;1;153;116;260;52;69;650
089111787802;1;198;114;190;99;95;696
054843749837;1;109;170;296;71;102;748
084946739194;1;90;201;267;94;112;764
042216525928;1;205;179;95;98;95;672
067525442849;1;142;171;187;105;79;684
028692371671;1;248;188;117;114;77;744
080342082536;1;151;276;133;50;132;742
025336996470;1;142;145;223;70;97;677
034275856325;1;267;204;169;73;170;883
030045163075;1;155;206;267;77;97;802
020344331766;1;286;130;204;76;159;855
022318236779;1;233;90;132;94;125;674
021325060569;1;155;247;134;56;134;726
014284108873;1;256;198;269;83;177;983
088613006901;1;117;179;202;120;71;689
097067931870;1;175;103;125;117;157;677
037006425161;1;84;168;275;87;154;768
085015531159;1;246;177;294;74;127;918
054968653123;1;154;281;195;50;156;836
069719306508;1;281;159;226;92;105;863
079040731178;1;291;228;145;59;76;799
086832228174;1;157;161;207;71;56;652
095648211519;1;102;132;240;88;163;725
011492255870;1;241;182;292;71;52;838
050329843552;1;182;260;291;108;74;915
024053733956;1;224;192;203;108;160;887
042330325238;1;204;85;259;96;68;712
078001628971;1;279;191;93;91;121;775
042264880164;1;216;228;179;62;68;753
039492314273;1;200;82;220;99;71;672
052601460468;1;173;235;93;120;82;703
084387547778;1;215;207;99;67;136;724
057176470493;1;249;138;263;58;114;822
051821248014;1;113;157;105;70;166;611
067172501542;1;182;179;168;80;90;699
097445639224;1;255;182;128;76;108;749
060155307264;1;275;172;283;105;61;896
047802895708;1;288;197;155;108;57;805
018352860688;1;121;262;205;64;103;755
000266550519;1;167;133;226;108;89;723
075530597575;1;125;275;204;50;139;793
099724057475;1;249;263;260;66;145;983
054663627042;1;256;100;238;114;176;884
005319889598;1;169;277;93;75;82;696
021114205131;1;219;173;168;89;51;700
036472424291;1;209;113;104;91;105;622
080034362663;1;103;219;237;109;115;783
097041385239;1;286;230;198;75;86;875
084770970800;1;152;124;220;110;178;784
066565520232;1;264;129;224;95;173;885
066643043844;1;283;186;106;52;125;752
022794261664;1;167;166;126;51;61;571
074173622757;1;105;97;93;106;125;526
043160106141;1;111;173;218;94;52;648
025600135563;1;204;147;204;92;104;751
041275585018;1;131;166;263;75;94;729
070936428240;1;209;86;112;60;69;536
068298264459;1;242;110;222;62;161;797
017414915828;1;164;236;286;108;87;881
077112130436;1;275;113;290;77;147;902
095137711294;1;230;251;200;104;88;873
013372556876;1;247;182;161;94;104;788
075804323058;1;287;94;120;62;75;638
074815337651;1;173;236;230;91;110;840
058174458985;1;113;113;127;89;149;591
078246806849;1;84;175;162;91;144;656
019190406739;1;119;221;280;51;134;805
070784440181;1;126;103;184;93;130;636
021966841716;1;136;212;254;56;90;748
048094601057;1;132;262;172;107;165;838
072711556721;1;266;205;192;103;152;918
078444101824;1;212;160;117;81;91;661
090399933892;1;140;162;239;92;170;803
056064593678;1;167;248;293;65;145;918
048206014683;1;147;191;238;86;111;773
029652603116;1;239;97;152;60;64;612
021404224286;1;231;178;234;88;159;890
028908869316;1;163;228;127;103;52;673
062141891030;1;221;233;290;67;113;924
016783720030;1;252;260;285;112;102;1011
031635475178;1;175;198;171;77;85;706
017383102307;1;248;87;135;84;132;686
079934504237;1;153;223;255;63;90;784
023013468062;1;92;272;151;84;78;677
038092111645;1;95;144;167;72;86;564
002593047360;1;197;196;101;119;83;696
029467370357;1;108;173;94;60;132;567
022626779105;1;221;146;197;76;151;791
047469701401;1;197;184;219;74;174;848
086288802799;1;280;265;296;95;79;1015
079738423895;1;168;217;204;100;163;852
039365229193;1;125;105;146;73;126;575
041805868681;1;120;228;101;93;136;678
077137577427;1;278;168;255;100;106;907
062525141279;1;142;215;114;64;151;686
089829779274;1;147;173;280;112;129;841
090083679384;1;234;220;112;62;62;690
084201393483;1;193;92;293;52;138;768
033342078019;1;253;126;266;112;77;834
031310313693;1;137;129;108;81;69;524
095869857191;1;138;112;225;97;178;750
070512782004;1;91;194;168;70;85;608
024010830516;1;226;249;272;79;62;888
074804321029;1;119;98;170;120;144;651
061810458616;1;259;146;291;64;146;906
023604464608;1;260;141;192;70;62;725
022000224192;1;162;206;161;63;97;689
050907668203;1;96;207;207;85;173;768
084659815955;1;148;88;244;86;80;646
078836265460;1;271;90;176;60;53;650
064017217924;1;246;132;117;86;117;698
056684994747;1;149;92;107;73;154;575
032428804453;1;226;128;106;111;139;710
077223315400;1;248;121;127;52;176;724
008888856106;1;176;167;150;58;54;605
040419110606;1;235;116;186;90;169;796
035741309077;1;104;117;168;53;156;598
079348405808;1;123;117;206;84;166;696
074988144937;1;110;126;299;69;73;677
084637537394;1;84;165;131;106;119;605
025042401833;1;276;176;111;107;143;813
023358504569;1;222;223;111;103;89;748
050723838381;1;108;245;236;81;119;789
077016383817;1;177;122;275;82;65;721
099481199429;1;209;283;275;72;90;929
015415671689;1;137;161;110;78;145;631
022180082116;1;143;120;208;54;60;585
087981707213;1;277;274;267;61;123;1002
003598114042;1;236;194;116;94;67;707
008308178267;1;197;104;131;117;109;658
052467214021;1;264;267;119;110;140;900
057906159184;1;260;263;270;96;51;940
045117569776;1;189;99;202;114;66;670
039017171851;1;151;274;178;59;173;835
017192858251;1;208;245;267;81;101;902
008446515896;1;138;132;298;70;170;808
022962510104;1;184;288;268;78;92;910
083378808849;1;198;138;257;96;59;748
035748287678;1;189;190;273;120;164;936
088106681802;1;96;93;179;73;166;607
002796154488;1;157;123;297;58;51;686
052640681631;1;213;129;180;108;141;771
067232753264;1;133;107;136;118;172;666
071440453827;1;282;204;257;55;58;856
042764342187;1;267;261;96;72;114;810
038699995747;1;193;136;261;66;76;732
007594742215;1;146;207;292;85;178;908
032708526148;1;139;122;137;69;80;547
063888684103;1;186;209;230;116;177;918
007379180184;1;271;104;132;60;102;669
022225980374;1;285;182;211;96;51;825
022491943310;1;91;283;278;112;104;868
079694066947;1;279;142;111;51;128;711
071598910778;1;209;142;209;70;87;717
020188918956;1;93;235;152;62;175;717
011895394702;1;113;283;249;67;110;822
028374890261;1;136;213;239;112;71;771
089390985125;1;82;138;284;105;135;744
025871493229;1;260;260;135;77;150;882
051662941240;1;98;228;269;113;110;818
099348832771;1;117;99;238;78;72;604
012519804297;1;121;97;146;117;54;535
039465276051;1;155;260;284;97;148;944
010844202190;1;149;269;290;52;70;830
072285200914;1;182;98;91;55;103;529
058303787920;1;188;137;221;118;172;836
055757130491;1;231;284;118;80;155;868
059067880159;1;167;263;191;56;67;744
005922560030;1;291;221;104;83;103;802
040618877138;1;225;261;180;83;164;913
008907330184;1;275;275;170;108;149;977
020042039760;1;201;116;190;71;78;656
090530202602;1;157;273;167;75;87;759
043888875123;1;187;155;165;76;166;749
069053224899;1;116;172;109;66;124;587
000018609374;1;128;137;193;99;170;727
029703027704;1;209;135;96;86;80;606
027140268146;1;200;167;189;81;60;697
005742316553;1;130;97;129;89;96;541
071247889067;1;92;283;228;89;117;809
085307760380;1;152;273;293;107;159;984
003463950914;1;257;199;174;82;85;797
012840421562;1;231;278;289;86;144;1028
048575507305;1;89;222;262;115;75;763
039687901183;1;164;283;100;59;130;736
086188314372;1;114;276;127;113;95;725
026620440794;1;110;286;144;107;128;775
069851958315;1;180;231;214;88;91;804
034316703631;1;209;127;268;102;109;815
077599217948;1;134;153;240;106;106;739
020897577999;1;120;251;284;82;164;901
029891460832;1;140;169;212;80;159;760
053315976784;1;152;186;245;58;70;711
045119152845;1;271;124;171;52;74;692
052412658613;1;143;288;102;118;107;758
082584128982;1;235;247;153;105;167;907
074398230744;1;106;128;164;97;97;592
052963853649;1;93;161;197;94;142;687
010414336549;1;93;86;127;100;118;524
060124992265;1;161;116;268;83;144;772
002802560828;1;216;109;198;63;153;739
035007814678;1;149;150;136;106;115;656
070428311104;1;153;149;153;52;96;603
060491391756;1;202;133;283;80;132;830
061352289785;1;82;135;223;110;51;601
085476047992;1;183;186;200;109;149;827
033995022038;1;151;279;129;102;153;814
007662984119;1;165;236;271;79;149;900
058722104333;1;112;122;229;77;101;641
015895370390;1;145;269;213;101;119;847
084966032542;1;239;260;216;120;52;887
075301885992;1;125;262;290;113;144;934
095258750467;1;113;85;274;56;125;653
055542311375;1;117;194;112;71;138;632
013404064610;1;175;149;198;80;123;725
031025741556;1;288;90;118;104;68;668
011915372624;1;103;96;198;82;82;561
082240648375;1;190;88;254;77;74;683
074774574593;1;179;242;174;66;149;810
054163666982;1;209;243;206;88;87;833
084650461972;1;267;127;268;65;115;842
017125437170;1;191;251;220;83;170;915
058298955237;1;119;168;205;103;90;685
075377619996;1;169;176;95;82;68;590
090093125745;1;258;207;175;55;177;872
096515422823;1;140;84;101;95;126;546
046173785226;1;258;265;269;81;148;1021
004374060405;1;243;253;141;64;58;759
076525149091;1;152;234;158;91;136;771
018527016424;1;221;134;197;77;114;743
058996056265;1;104;86;277;107;84;658
067303291299;1;164;132;195;74;86;651
000214131860;1;271;98;149;97;110;725
087764581296;1;292;188;153;50;69;752
039529210795;1;139;81;296;93;73;682
063522164992;1;172;155;300;118;158;903
043586410594;1;288;216;200;86;83;873
005151359918;1;83;194;176;102;110;665
091439584376;1;267;95;216;68;122;768
055861049769;1;154;185;281;63;58;741
039211780334;1;150;229;131;63;120;693
048443712114;1;173;191;124;51;105;644
016029953091;1;267;81;209;68;139;764
024501771732;1;161;195;176;106;102;740
087248044309;1;226;97;206;107;135;771
001808145481;1;209;205;255;91;60;820
081268505620;1;283;166;203;74;114;840
073452747607;1;111;194;189;103;51;648
022590422392;1;110;253;212;59;145;779
068071424181;1;150;88;143;120;166;667
025402896250;1;99;233;256;84;55;727
024238255502;1;199;104;263;53;121;740
053949761662;1;155;257;163;87;63;725
077547420413;1;133;257;258;66;149;863
077646532273;1;81;173;112;86;133;585
051432915975;1;149;249;127;86;147;758
050545225480;1;114;244;288;109;61;816
030269669611;1;270;198;151;67;91;777
013940972228;1;197;186;142;101;139;765
040719203326;1;269;134;246;57;114;820
085923171712;1;250;136;104;115;141;746
020879535569;1;188;255;260;100;120;923
034049542968;1;168;242;184;91;169;854
082447699007;1;245;282;269;51;55;902
080029750968;1;269;193;191;92;177;922
099233330700;1;254;140;286;89;94;863
030190699092;1;276;191;298;56;79;900
073935214068;1;234;104;285;74;127;824
035097012637;1;132;258;95;107;161;753
034584249714;1;194;225;224;54;111;808
083159657952;1;166;254;179;54;122;775
010491570897;1;168;115;238;115;88;724
029697490841;1;160;109;222;86;134;711
048099185124;1;116;162;224;83;54;639
074080328064;1;111;203;261;53;160;788
004359355557;1;207;141;144;84;112;688
078942211832;1;176;282;93;82;164;797
010876957198;1;291;213;166;111;82;863
093518968548;1;135;276;273;67;83;834
086943435669;1;221;191;228;111;119;870
038679832515;1;253;146;148;84;147;778
012926892256;1;255;239;241;60;99;894
023572953361;1;273;199;222;106;66;866
018133912324;1;196;167;105;83;174;725
069403634825;1;228;136;167;78;66;675
074609128349;1;277;221;135;70;115;818
081692676185;1;199;145;108;103;53;608
055400300247;1;226;231;250;116;159;982
040871938692;1;127;99;265;120;82;693
019035479232;1;235;270;180;53;178;916
060032521260;1;287;266;121;117;132;923
072052610003;1;264;129;221;66;154;834
026989634971;1;216;254;102;54;104;730
024313268879;1;108;130;231;72;57;598
094656202915;1;140;149;226;101;56;672
070520659674;1;180;202;235;68;75;760
023457535777;1;251;189;118;106;149;813
061237875334;1;258;141;174;63;136;772
083212152458;1;221;155;235;112;105;828
067494523996;1;212;207;130;51;176;776
000783109626;1;202;84;120;113;98;617
012778529394;1;187;198;293;71;102;851
039437252588;1;215;214;114;101;54;698
011493406145;1;146;161;161;115;55;638
022124384481;1;267;121;214;101;66;769
030741718610;1;210;244;189;68;69;780
046287813721;1;261;206;286;105;175;1033
075773481062;1;290;107;191;82;117;787
085681309906;1;266;285;124;100;92;867
010885235708;1;246;97;180;109;58;690
059949079512;1;238;255;266;92;123;974
011590899117;1;280;265;233;83;101;962
044759153267;1;152;234;176;92;109;763
020241213510;1;234;179;120;94;123;750
015376327661;1;162;185;231;62;137;777
041766280720;1;135;119;251;99;96;700
044813700309;1;280;232;275;100;85;972
004918865064;1;195;101;121;74;80;571
046493518745;1;178;280;97;87;117;759
097271502880;1;152;247;284;59;69;811
006172863987;1;194;129;213;50;115;701
096633930987;1;250;125;220;81;65;741
070138443180;1;197;110;255;76;134;772
000433066477;1;199;280;232;90;173;974
049879368481;1;97;253;267;106;115;838
017104687758;1;289;266;295;58;73;981
091469594509;1;272;236;241;87;118;954
067045695296;1;102;212;176;64;167;721
036991987719;1;129;152;284;58;127;750
048968978423;1;193;118;160;60;138;669
016229453775;1;165;251;103;98;110;727
056899984130;1;271;232;259;59;164;985
013272680247;1;112;131;265;103;80;691
055720928664;1;106;187;300;77;163;833
083090230498;1;116;267;172;68;136;759
097988001400;1;117;119;230;86;59;611
081646662867;1;176;184;160;60;83;663
063138513143;1;206;100;150;108;67;631
070818514436;1;188;267;277;62;149;943
030011342424;1;125;114;120;91;162;612
051825655174;1;173;138;162;95;56;624
055411870614;1;206;97;206;102;115;726
030356161710;1;292;96;148;55;64;655
080283198729;1;226;91;244;80;169;810
030920645203;1;231;202;253;113;158;957
080374492336;1;113;83;257;58;71;582
067849799517;1;223;158;129;73;56;639
011472578378;1;222;143;207;108;100;780
003961424803;1;135;224;175;116;107;757
051883476263;1;128;197;297;114;82;818
033606404037;1;83;173;208;51;123;638
057966645054;1;83;209;251;112;67;722
077921286558;1;204;265;208;55;70;802
036749745958;1;117;273;273;71;126;860
033487761174;1;238;232;273;75;79;897
077111921677;1;219;192;213;87;139;850
079055136529;1;106;179;116;67;88;556
045096796829;1;83;135;233;118;174;743
047788504193;1;263;108;101;94;140;706
073470190567;1;283;112;194;86;87;762
019836087203;1;125;179;162;61;61;588
037608467066;1;241;174;206;65;170;856
065634777935;1;137;116;95;75;73;496
011009931475;1;177;85;158;77;59;556
084418466704;1;93;253;142;89;164;741
021623262600;1;148;144;202;73;79;646
072894995562;1;100;100;263;52;98;613
001037556172;1;283;99;209;114;147;852
070209767538;1;105;218;236;71;108;738
057506520784;1;137;151;122;91;115;616
071774160416;1;98;229;184;98;92;701
002680213683;1;96;171;253;104;52;676
021619356335;1;214;80;272;116;132;814
036222926615;1;137;234;98;78;83;630
009999191205;1;179;186;218;99;57;739
022734014003;1;222;140;232;91;89;774
054587810901;1;186;128;111;57;56;538
086619959075;1;215;170;298;81;146;910
029059241419;1;219;265;186;99;158;927
012008489092;1;242;101;100;53;107;603
012799310715;1;253;276;105;92;124;850
030111891303;1;248;87;101;97;158;691
067811744384;1;241;148;93;81;157;720
056805292624;1;219;247;228;113;136;943
089978337202;1;221;97;117;85;130;650
045656176963;1;137;168;141;64;135;645
044252394148;1;223;120;251;60;69;723
079896772813;1;288;244;209;116;97;954
075251119775;1;256;129;212;59;71;727
091672330993;1;239;94;275;68;80;756
097136039493;1;179;255;173;115;115;837
044339610650;1;223;82;125;111;79;620
067806542308;1;148;281;150;96;125;800
032314030198;1;288;209;233;69;89;888
019755788377;1;285;163;163;66;178;855
096502522086;1;84;210;222;100;91;707
069765086430;1;81;211;227;80;136;735
086565196617;1;124;144;271;74;93;706
087170377347;1;212;156;285;77;129;859
096065946531;1;100;151;142;54;158;605
001276557799;1;282;108;247;83;169;889
062253416350;1;186;170;192;89;53;690
045707669606;1;190;282;233;110;159;974
019032128637;1;108;106;194;62;57;527
076723986462;1;275;151;244;71;73;814
080105163597;1;201;131;160;107;175;774
059096432601;1;213;272;126;67;110;788
081644081980;1;163;148;148;99;177;735
003637865643;1;161;228;284;75;172;920
087664647131;1;97;162;280;64;155;758
005969394989;1;113;215;275;60;168;831
018288676958;1;112;195;122;71;168;668
081917149216;1;143;213;271;117;63;807
062381065428;1;204;185;132;78;123;722
029202255448;1;115;141;146;79;129;610
043213162985;1;269;231;223;71;87;881
042393611316;1;89;208;180;56;168;701
025432423054;1;88;280;126;103;105;702
057893122197;1;188;180;144;87;126;725
009050980623;1;261;101;106;104;145;717
098393124893;1;268;252;282;77;120;999
031302073242;1;184;143;239;93;108;767
067299458094;1;153;197;245;86;174;855
047103001299;1;259;86;161;86;165;757
070228972425;1;221;230;272;52;107;882
032572373962;1;98;217;173;71;161;720
059688226211;1;119;210;127;119;159;734
032318334846;1;140;261;123;100;141;765
070590060759;1;206;239;218;74;118;855
026057136443;1;84;213;134;99;96;626
005366542541;1;92;144;200;74;157;667
075923132677;1;84;157;131;55;107;534
094851424205;1;288;134;199;80;74;775
024081400917;1;267;98;219;101;124;809
042886608066;1;191;271;250;94;130;936
075905935288;1;174;144;153;99;61;631
090808429012;1;252;122;206;71;123;774
046428660092;1;157;117;159;98;129;660
095231207557;1;96;194;202;85;70;647
045746438735;1;182;93;160;74;76;585
096927791236;1;250;208;240;68;97;863
021751322065;1;81;124;229;116;54;604
071691842522;1;146;266;296;112;164;984
091081737493;1;288;223;111;69;114;805
072985365222;1;241;284;149;59;82;815
050652419134;1;208;115;229;100;106;758
049230987207;1;232;287;150;58;103;830
086301828744;1;95;166;213;109;178;761
009843414153;1;276;285;211;65;139;976
049142199051;1;278;170;179;72;122;821
095581608027;1;213;263;247;68;112;903
019114656280;1;178;188;190;102;87;745
029044093383;1;246;122;163;64;92;687
039046331027;1;133;108;244;78;133;696
026133948989;1;284;146;262;89;133;914
020321561286;1;125;263;170;56;57;671
014243454085;1;137;147;270;99;69;722
015975448753;1;248;113;188;69;113;731
031471598654;1;92;184;112;75;132;595
037088279254;1;196;219;294;95;107;911
080032684726;1;237;216;235;65;118;871
000269683249;1;129;263;174;50;122;738
094277744439;1;104;148;232;78;68;630
031685955684;1;186;274;282;57;132;931
079099547254;1;163;120;264;94;153;794
080634774354;1;290;195;263;116;139;1003
047775710349;1;281;125;178;72;74;730
012475982931;1;122;134;187;74;161;678
004782918979;1;265;196;281;53;50;845
040043624121;1;261;136;174;81;174;826
058088745909;1;131;268;279;53;68;799
072949702439;1;193;188;203;98;83;765
077272497248;1;109;91;121;79;178;578
002222357540;1;115;101;237;53;60;566
035863439026;1;210;261;284;63;140;958
027310565362;1;88;124;252;101;138;703
042565913752;1;248;258;228;88;144;966
078435399632;1;103;107;279;115;141;745
092521446686;1;129;105;135;56;126;551
092135318495;1;247;236;148;95;131;857
098953971737;1;140;259;232;98;123;852
011077548080;1;111;172;169;92;62;606
012105108412;1;89;203;181;112;67;652
068785234987;1;123;137;122;78;96;556
056957011571;1;287;263;120;69;108;847
014043578787;1;132;200;278;107;110;827
043775668618;1;194;135;277;76;152;834
069263900675;1;101;89;287;79;108;664
017587947478;1;120;123;137;91;156;627
007660597212;1;288;273;238;97;94;990
062239405926;1;268;115;197;74;119;773
002552055532;1;270;182;292;112;137;993
095336882238;1;230;125;271;112;146;884
060031203551;1;110;218;255;97;109;789
082620602634;1;239;188;284;101;176;988
053953229076;1;168;120;272;95;159;814
011795601427;1;252;136;236;102;120;846
094502715829;1;228;138;112;102;126;706
087483836501;1;156;177;139;66;54;592
046369278264;1;126;92;275;74;156;723
007867639062;1;176;170;266;106;84;802
098852773524;1;190;218;298;98;149;953
079557558713;1;288;244;258;83;138;1011
072630464463;1;109;210;290;99;177;885
068637906911;1;106;228;135;106;131;706
023420489885;1;172;210;266;114;162;924
087299610003;1;151;148;126;94;83;602
045149367458;1;270;251;117;89;61;788
027390086101;1;107;254;240;56;139;796
068216366992;1;224;216;160;107;159;866
003120190121;1;187;252;223;113;79;854
083025120200;1;235;196;296;112;58;897
087116524378;1;268;275;290;58;77;968
072605442645;1;202;123;157;65;174;721
006077786989;1;111;161;273;102;78;725
009582393264;1;207;97;218;51;116;689
077276308119;1;128;200;221;66;84;699
095946538590;1;230;107;135;64;165;701
038445702795;1;265;258;203;116;167;1009
076696340260;1;101;201;158;98;176;734
080367827131;1;130;271;96;98;59;654
083775768175;1;238;250;222;50;162;922
041532636839;1;227;105;237;101;144;814
003314171905;1;121;267;242;97;134;861
096291760358;1;144;169;207;112;54;686
061748339722;1;238;122;111;98;177;746
063125053780;1;281;212;123;51;81;748
072767099963;1;157;216;283;111;114;881
005114069920;1;115;100;195;71;55;536
092331185754;1;192;110;96;73;165;636
068099076405;1;144;234;292;61;161;892
095267406545;1;111;100;141;74;60;486
030600153766;1;290;122;104;77;61;654
054093448436;1;89;110;275;97;108;679
072701068519;1;162;249;281;80;104;876
076123063420;1;128;88;92;100;132;540
051258024513;1;85;97;266;93;127;668
019264786532;1;174;129;208;104;56;671
045680292700;1;169;195;257;71;88;780
071566695519;1;159;141;219;68;150;737
088038919146;1;266;92;165;62;158;743
030898078356;1;269;160;139;59;168;795
045943046760;1;114;191;204;93;61;663
072262774789;1;88;200;182;86;117;673
091032127050;1;207;274;165;52;161;859
015110149666;1;105;158;244;84;57;648
010521927310;1;182;125;121;73;133;634
049080193299;1;109;263;227;62;126;787
097070111528;1;108;183;100;56;101;548
090367725963;1;124;145;210;85;68;632
095181138631;1;265;187;287;74;65;878
048743621172;1;98;80;202;66;174;620
077607777329;1;120;127;241;107;126;721
056142750465;1;165;199;275;92;137;868
066942747313;1;238;231;114;80;174;837
028682847756;1;161;250;221;83;74;789
037047097943;1;245;80;204;117;67;713
091134813987;1;216;121;169;80;160;746
033096892923;1;276;98;114;95;131;714
027676652971;1;103;125;90;65;80;463
075099920577;1;222;259;233;94;135;943
029045377395;1;172;253;182;92;53;752
035984782234;1;206;92;291;83;52;724
019489770073;1;105;259;257;56;88;765
009794320995;1;119;152;167;112;131;681
044249346762;1;128;253;235;56;62;734
067865099615;1;133;125;213;67;63;601
091555898703;1;121;133;100;95;79;528
041160120639;1;185;220;193;96;165;859
085633436842;1;133;124;264;116;175;812
083325823949;1;217;209;220;59;88;793
077125315667;1;134;171;266;99;92;762
089420776481;1;223;193;244;77;152;889
063133730637;1;104;148;230;106;119;707
058252883144;1;152;83;230;56;66;587
016628021110;1;232;82;135;75;176;700
070732803227;1;152;154;210;66;101;683
049991973460;1;92;86;245;107;66;596
008963460059;1;253;143;205;62;67;730
064325482133;1;146;107;294;65;64;676
005172446726;1;220;241;232;105;81;879
036923544227;1;105;148;253;55;94;655
020578839297;1;205;196;295;57;67;820
048804399149;1;229;80;109;65;119;602
055283449486;1;133;115;241;71;135;695
083653050299;1;123;274;231;91;106;825
020507117874;1;261;132;241;75;168;877
063318738299;1;152;89;285;62;81;669
099394355691;1;271;159;156;115;175;876
020098565606;1;88;208;160;105;55;616
084341127522;1;161;235;149;77;97;719
041680422197;1;193;241;96;89;127;746
062657087996;1;123;102;149;91;101;566
017542787370;1;142;174;176;85;93;670
019135940810;1;187;127;94;95;56;559
066100024183;1;128;170;271;89;174;832
026407713543;1;232;107;166;102;148;755
043686791195;1;179;265;237;70;159;910
060947788243;1;193;172;289;108;113;875
022651660818;1;172;125;283;93;171;844
042454651375;1;219;119;190;75;114;717
046293840865;1;108;161;233;105;106;713
087124308207;1;191;251;209;103;78;832
045250634018;1;139;169;166;76;139;689
087307302619;1;247;208;194;95;83;827
041002474377;1;199;90;154;84;175;702
034529050031;1;188;84;103;70;107;552
010148110252;1;289;248;264;73;148;1022
030892652852;1;103;233;149;71;173;729
031513777019;1;188;268;288;117;75;936
015699730642;1;143;99;227;74;167;710
017292667272;1;134;284;126;110;113;767
056353698809;1;86;232;249;82;143;792
022433145519;1;168;218;124;71;52;633
048366988472;1;269;277;137;107;75;865
055230115017;1;270;173;126;79;86;734
009025921662;1;175;85;185;75;82;602
037503613619;1;257;128;279;108;156;928
070760709959;1;92;200;156;111;154;713
097412439801;1;273;228;90;79;64;734
095752708785;1;259;100;209;99;124;791
009451216775;1;265;105;94;120;133;717
095698960676;1;165;153;234;98;159;809
086720203742;1;102;230;204;103;68;707
018942716377;1;231;273;199;75;118;896
053108228373;1;237;206;149;56;83;731
071285907054;1;238;212;158;107;141;856
049807909880;1;227;288;190;80;51;836
006003757305;1;217;170;194;83;62;726
048947015979;1;273;81;277;51;109;791
085169007329;1;174;114;196;52;153;689
022110237415;1;170;235;238;88;105;836
043883031418;1;271;263;149;50;148;881
086540740026;1;192;211;175;84;79;741
096183366396;1;259;82;290;50;145;826
031728141149;1;274;170;130;74;163;811
051941535900;1;270;127;275;77;166;915
078388245394;1;288;270;161;84;122;925
093139696219;1;170;111;261;91;75;708
081150054296;1;156;219;135;91;156;757
013038584142;1;101;154;260;111;68;694
067473195119;1;252;122;142;79;117;712
045423700982;1;154;241;295;104;138;932
033188672954;1;236;286;248;92;106;968
028864226325;1;273;178;142;112;176;881
092432224797;1;183;275;95;70;160;783
080455121601;1;185;237;254;60;143;879
046416087720;1;174;270;184;54;136;818
094947525962;1;155;185;239;100;163;842
014625038530;1;133;255;221;90;81;780
063917991180;1;182;205;260;91;141;879
063202749021;1;272;263;228;50;100;913
066910082397;1;164;98;266;99;144;771
062253736609;1;170;257;94;116;95;732
014237707420;1;212;139;211;87;156;805
074789705494;1;223;114;272;70;98;777
057216379529;1;157;275;143;88;174;837
018991688922;1;133;162;115;58;66;534
013153020131;1;126;142;150;111;82;611
036152573216;1;258;118;117;92;125;710
062128236326;1;211;210;240;55;177;893
018714591594;1;152;140;118;79;177;666
088000133746;1;253;283;286;52;146;1020
028377666156;1;112;111;236;113;160;732
048721570241;1;227;185;256;99;173;940
069442747314;1;153;137;248;75;57;670
083054694844;1;236;132;109;56;139;672
017169414025;1;221;149;207;107;100;784
071904275689;1;222;153;288;51;158;872
094250995309;1;145;126;291;117;160;839
055574099305;1;288;104;173;94;136;795
097358178828;1;268;250;104;88;78;788
076681645813;1;215;88;280;80;175;838
089928294278;1;279;220;260;119;65;943
077765604328;1;153;260;172;51;111;747
012228239976;1;147;92;211;54;54;558
016479305499;1;106;171;232;95;154;758
018741174791;1;136;276;108;87;140;747
027660577315;1;106;86;177;110;132;611
076187414063;1;236;92;243;81;112;764
052177969974;1;184;278;163;115;52;792
055405468604;1;274;234;143;86;102;839
008561194889;1;233;152;238;96;151;870
034923022466;1;156;277;111;54;60;658
092900473966;1;117;278;288;88;92;863
048918838625;1;270;187;286;50;127;920
067147915419;1;237;100;287;99;50;773
038634248795;1;120;263;228;93;50;754
059865658299;1;276;109;230;98;74;787
047037865006;1;237;194;176;55;93;755
068544469090;1;212;238;93;55;146;744
088664803851;1;82;103;185;82;95;547
046922325747;1;182;201;254;77;62;776
066324644434;1;83;128;177;106;101;595
061976605940;1;234;203;277;84;61;859
009524543012;1;283;176;120;120;106;805
098577342900;1;140;196;93;67;168;664
068900933528;1;109;251;121;73;58;612
049267649963;1;112;230;270;98;104;814
059907422796;1;138;94;126;101;136;595
001837468504;1;232;185;133;74;123;747
005446857774;1;269;183;190;87;166;895
011571538211;1;147;235;161;100;174;817
075360706918;1;178;258;91;89;165;781
060202647455;1;170;147;215;118;82;732
029709934536;1;194;241;98;75;85;693
007320900903;1;196;81;212;73;87;649
057894692908;1;169;123;297;55;149;793
020572423841;1;187;186;213;64;71;721
020411049197;1;258;281;213;112;71;935
085165722940;1;145;137;226;74;77;659
077673653751;1;283;277;195;56;72;883
036518116453;1;252;151;275;71;103;852
038888069491;1;184;127;197;117;66;691
032325305918;1;148;104;143;86;79;560
016001022523;1;80;192;249;93;167;781
024609990144;1;136;87;190;101;89;603
064518996336;1;262;89;291;90;59;791
031675415992;1;276;90;92;115;118;691
021532652978;1;169;136;293;67;160;825
004574582808;1;222;254;255;69;61;861
073032018078;1;188;248;203;69;95;803
017373238598;1;208;104;222;83;87;704
093866396125;1;194;152;201;85;157;789
039229747840;1;160;288;127;69;82;726
050839895389;1;188;245;106;113;94;746
007950414961;1;275;148;223;95;140;881
024518526928;1;176;178;190;54;109;707
080787380686;1;115;273;117;90;178;773
017595767732;1;284;206;161;93;78;822
022223612333;1;87;190;261;90;126;754
047569224224;1;101;216;242;109;65;733
039102854929;1;113;131;173;106;70;593
073114466611;1;219;249;191;51;96;806
060819025065;1;258;148;229;110;93;838
005125686419;1;288;188;285;91;62;914
051390403593;1;100;212;179;77;53;621
023061611002;1;136;110;161;86;170;663
062964343224;1;269;214;167;75;118;843
030116311923;1;152;168;251;55;136;762
061675292086;1;127;281;170;81;58;717
019545971098;1;233;127;253;75;72;760
009928074416;1;220;177;162;64;142;765
082516973065;1;186;208;253;69;76;792
008867740260;1;252;228;298;75;176;1029
087843289920;1;136;93;172;81;63;545
075268498914;1;255;207;259;83;124;928
066158645790;1;229;105;294;75;127;830
087476505183;1;94;160;288;86;62;690
092004574723;1;157;136;248;51;117;709
011888505347;1;95;195;218;113;176;797
061536523764;1;126;230;265;104;63;788
098346982512;1;179;196;259;64;110;808
016698048560;1;134;97;211;99;56;597
011181507552;1;224;165;103;63;143;698
024506814158;1;257;134;266;84;133;874
094272568321;1;126;271;254;76;51;778
029057096369;1;85;82;111;84;80;442
025686909718;1;206;285;253;70;121;935
092493812787;1;129;268;94;110;178;779
044120342168;1;152;186;267;70;137;812
038869525524;1;163;141;135;87;108;634
090766893984;1;146;142;194;77;76;635
019028423982;1;134;196;245;57;140;772
032095856553;1;200;227;244;107;115;893
055925963780;1;210;105;288;71;75;749
000028908111;1;228;125;138;70;149;710
035297709302;1;176;143;158;90;73;640
053119629192;1;172;283;295;81;167;998
053567023603;1;104;193;236;77;150;760
029074950107;1;134;211;278;97;127;847
016851978549;1;126;114;117;106;87;550
062135711826;1;102;101;179;91;177;650
082545866217;1;245;133;261;115;144;898
051941439101;1;160;140;270;86;107;763
086399380539;1;125;232;238;82;73;750
028373132046;1;124;96;265;60;102;647
024431944773;1;113;155;195;101;155;719
011769841640;1;125;252;294;57;68;796
056370264639;1;196;198;284;52;50;780
070464509329;1;127;94;212;79;152;664
048835107739;1;286;97;136;97;64;680
012316990907;1;268;180;157;55;100;760
028229166925;1;203;128;155;59;87;632
091115925573;1;84;103;220;62;156;625
021624087439;1;284;253;253;54;51;895
004356618900;1;158;194;198;119;71;740
050146654885;1;153;86;172;58;163;632
053016018777;1;163;111;94;78;168;614
058528357653;1;259;283;146;78;162;928
026820978758;1;279;224;207;86;151;947
099469599447;1;235;162;299;114;124;934
032863355217;1;97;132;194;90;77;590
089528183787;1;82;201;210;86;135;714
031105953652;1;173;218;229;80;95;795
073143202743;1;275;92;112;93;51;623
047174745340;1;132;224;141;113;52;662
096386458215;1;260;261;92;55;83;751
041656493727;1;151;248;166;105;170;840
019633993766;1;269;174;142;61;87;733
062297820348;1;188;153;201;115;61;718
050903381801;1;137;217;117;96;70;637
006432637881;1;188;187;186;111;139;811
008426608739;1;157;263;155;73;112;760
061637306014;1;255;230;289;54;115;943
085390483006;1;161;175;194;51;71;652
010918770027;1;288;182;259;111;67;907
076895427107;1;201;280;117;111;175;884
094827674314;1;137;215;243;74;91;760
014047003104;1;165;193;167;69;60;654
071930703429;1;215;199;296;100;120;930
094704525406;1;255;106;160;108;153;782
045672216168;1;214;97;169;50;113;643
046293839214;1;178;134;196;103;162;773
003688665268;1;239;282;237;55;146;959
004012259156;1;175;150;97;64;99;585
008699068084;1;213;198;256;95;70;832
018291987734;1;104;82;195;83;150;614
069172473298;1;160;104;289;94;133;780
013484719512;1;194;155;169;61;158;737
071546767382;1;286;173;163;95;73;790
041008439173;1;142;271;201;66;95;775
035834881742;1;237;105;105;64;143;654
043825978404;1;147;260;260;91;127;885
065207329759;1;260;269;131;70;133;863
038943188735;1;111;273;208;94;101;787
045073611447;1;149;88;192;70;167;666
079560704868;1;149;99;211;51;119;629
052647736285;1;212;287;126;52;111;788
028695720852;1;217;107;288;73;63;748
017096579775;1;283;129;145;100;143;800
020928206423;1;87;191;245;120;115;758
068951333594;1;227;288;117;57;168;857
092970118069;1;95;203;195;64;51;608
025246107990;1;160;167;147;75;64;613
031583136036;1;226;218;260;111;86;901
008154372829;1;234;276;292;119;147;1068
081782221589;1;114;211;248;63;112;748
000544807775;1;136;160;121;50;62;529
001377713571;1;88;264;182;61;68;663
010483203553;1;243;178;298;73;96;888
091174135311;1;268;232;109;111;148;868
059033330018;1;164;174;233;111;169;851
094793885249;1;137;257;261;98;162;915
028860149995;1;257;151;103;55;155;721
011329333392;1;169;168;251;100;63;751
010516287677;1;222;271;256;62;139;950
054777306743;1;154;136;104;120;143;657
083992230691;1;108;99;228;114;141;690
015475693815;1;114;165;208;103;167;757
066192545283;1;207;280;229;55;137;908
036343216104;1;115;267;190;92;138;802
014332523258;1;135;95;200;62;155;647
022580865251;1;287;104;299;100;107;897
065320070848;1;240;286;120;77;74;797
008792886607;1;163;113;177;77;124;654
001545709365;1;165;210;241;74;174;864
036370605212;1;235;213;138;115;155;856
097352856759;1;81;221;269;90;153;814
071062237582;1;178;143;172;57;53;603
099727563439;1;137;183;207;98;85;710
003584468041;1;98;233;212;112;98;753
025651137699;1;258;149;188;74;99;768
054445432372;1;159;91;94;64;170;578
063041238739;1;238;255;182;56;135;866
029898313130;1;147;89;243;96;124;699
072398155633;1;116;89;230;50;162;647
052402515875;1;232;146;186;63;143;770
036064559172;1;246;217;223;94;102;882
018323811614;1;229;244;251;111;162;997
071433761968;1;113;103;216;120;80;632
058836430870;1;207;183;296;60;79;825
099188367976;1;189;268;247;59;149;912
087472607710;1;141;137;238;58;55;629
090543945767;1;180;218;182;79;135;794
045405863488;1;248;168;139;91;135;781
065665121058;1;254;265;167;98;52;836
052450863108;1;165;199;275;81;71;791
052720307685;1;177;95;163;52;128;615
032515658566;1;127;151;100;77;94;549
079469759921;1;209;126;275;62;165;837
085164056157;1;128;288;150;61;112;739
073256807023;1;172;212;103;56;56;599
043068656825;1;253;104;110;61;132;660
004391687876;1;269;100;236;54;161;820
094826694877;1;163;150;238;73;145;769
043367307902;1;224;195;274;54;97;844
082483559464;1;80;88;197;92;66;523
059310036496;1;247;235;170;120;66;838
070553088230;1;282;262;258;56;103;961
065825306216;1;108;120;288;88;62;666
033351283842;1;149;217;283;78;62;789
075097274951;1;103;191;209;106;85;694
040212770074;1;252;214;97;99;90;752
048403189709;1;290;147;271;54;153;915
094651669616;1;112;199;145;105;116;677
021818800152;1;272;108;240;90;137;847
091238043406;1;134;173;249;82;52;690
084293174165;1;251;97;151;86;149;734
058916105659;1;291;91;237;88;78;785
054112274121;1;158;187;95;64;146;650
016877137823;1;189;284;107;120;75;775
071582862313;1;127;87;158;102;166;640
018500618207;1;275;249;102;88;73;787
069572062339;1;239;227;138;56;89;749
031680087107;1;250;113;111;52;56;582
093937048633;1;260;246;222;99;175;1002
076444235668;1;204;227;220;107;69;827
097238952020;1;282;111;151;70;118;732
028442169026;1;169;103;234;103;165;774
001345649896;1;194;127;240;69;142;772
038451376942;1;108;166;92;120;131;617
075105938636;1;103;83;258;101;119;664
027961383645;1;142;177;118;72;172;681
014471027835;1;94;213;244;83;108;742
066541811922;1;104;157;206;73;131;671
007750368253;1;246;264;90;92;86;778
017927471569;1;182;80;218;105;59;644
004240337137;1;258;108;173;70;108;717
066385033846;1;86;268;95;99;91;639
055542978867;1;82;231;265;71;165;814
066906285044;1;200;254;210;61;155;880
036532427026;1;203;89;258;58;160;768
027283168362;1;249;134;253;74;70;780
003587796914;1;233;271;229;120;125;978
018083858044;1;117;92;129;86;84;508
091562181628;1;286;194;209;80;177;946
016389221098;1;250;258;166;52;137;863
066055379675;1;89;218;131;86;101;625
070453617387;1;96;166;293;58;152;765
098061239917;1;214;192;159;51;113;729
027081783210;1;220;108;212;54;83;677
035996970639;1;139;207;220;117;89;772
032395046583;1;225;114;232;95;70;736
083616118020;1;208;180;283;87;158;916
060571035377;1;292;131;264;88;64;839
044170826202;1;144;191;292;88;167;882
022243726975;1;101;238;154;77;135;705
038464817035;1;214;231;217;55;96;813
028952423587;1;281;115;130;67;77;670
023308326394;1;281;129;165;99;96;770
040046643093;1;112;149;251;98;84;694
090379240542;1;227;222;263;56;135;903
073231815620;1;249;270;259;50;166;994
012811770708;1;218;180;123;104;61;686
011179823602;1;158;188;117;113;76;652
015351539922;1;151;204;187;102;135;779
039033962021;1;235;255;98;60;129;777
043829697930;1;242;258;99;118;100;817
090742058706;1;162;178;93;93;121;647
038036390860;1;103;224;211;85;123;746
004233692615;1;274;220;124;52;174;844
092702166443;1;268;172;175;109;125;849
049162856982;1;211;87;164;69;166;697
036125206158;1;254;260;112;100;87;813
019952689676;1;188;211;133;98;139;769
024919745627;1;86;142;296;113;69;706
093942947761;1;260;190;175;113;107;845
093019308369;1;219;216;256;119;112;922
082331677874;1;291;205;99;57;111;763
089066327283;1;190;82;291;67;123;753
030866208331;1;124;237;174;93;111;739
056032754368;1;99;113;163;80;164;619
021074510890;1;290;156;102;109;172;829
045778439735;1;163;219;172;109;133;796
059643810362;1;90;268;100;59;175;692
081147717030;1;267;87;208;87;174;823
009391266342;1;103;192;230;51;53;629
094270259763;1;151;179;226;101;56;713
015196534682;1;219;142;204;60;169;794
032146699509;1;130;189;272;107;148;846
058922639951;1;249;155;271;94;156;925
090385552673;1;272;154;265;71;125;887
011294888136;1;183;252;173;94;68;770
031913414976;1;260;83;105;109;120;677
009312894408;1;133;216;267;110;74;800
020724916305;1;225;190;203;90;62;770
036792966890;1;267;85;298;67;111;828
013500767805;1;138;117;172;77;111;615
085537163575;1;117;100;234;119;142;712
092137864137;1;259;246;269;98;86;958
002202608923;1;229;288;279;65;97;958
012342708509;1;135;238;176;90;65;704
032885675781;1;231;261;94;98;113;797
081303797871;1;145;86;195;116;98;640
032373370419;1;275;104;131;52;125;687
025462723174;1;254;150;125;51;162;742
023790611036;1;172;103;229;104;105;713
025329240796;1;234;164;116;64;134;712
091204953640;1;255;255;111;114;99;834
019522238694;1;125;143;249;75;178;770
006528888620;1;169;181;100;96;139;685
072475964730;1;118;185;215;108;138;764
024699374686;1;230;194;117;83;126;750
087876200742;1;227;202;260;52;127;868
018433960582;1;137;163;119;84;70;573
077154487125;1;289;274;135;95;135;928
097763406049;1;160;208;121;91;169;749
006136832587;1;235;138;184;116;128;801
018910677719;1;130;167;211;81;57;646
089087788386;1;249;266;278;92;72;957
051213391298;1;233;229;294;118;157;1031
012094846475;1;82;248;143;114;69;656
061351416671;1;147;243;274;73;62;799
021109399076;1;179;272;291;102;130;974
046918630378;1;190;126;252;67;65;700
044454558936;1;117;221;95;110;121;664
001379255850;1;283;272;242;85;142;1024
021211263739;1;270;89;149;107;159;774
068688992055;1;160;110;219;66;176;731
032364762731;1;100;206;300;64;76;746
044478573851;1;243;231;210;84;130;898
032546375901;1;236;217;129;64;82;728
041696007738;1;157;177;127;56;104;621
073104971681;1;175;201;231;119;91;817
031082762138;1;129;214;297;116;51;807
061980309856;1;125;128;103;78;56;490
021075393086;1;163;266;130;70;73;702
084276249673;1;140;130;154;93;159;676
039815441552;1;149;177;221;101;98;746
073561031112;1;254;285;256;73;51;919
056401427369;1;183;124;110;104;114;635
000912102763;1;210;231;133;86;71;731
026453442769;1;139;117;255;64;147;722
028921259684;1;277;166;200;67;100;810
081379602386;1;119;184;230;118;85;736
090851375462;1;277;170;160;91;113;811
055027209745;1;97;144;224;115;148;728
005107307639;1;111;101;238;103;170;723
075505342511;1;128;193;95;99;123;638
002283524159;1;155;88;186;88;82;599
070173884778;1;244;242;119;111;52;768
061728725389;1;184;171;164;106;108;733
017881296792;1;166;96;233;79;105;679
004959060420;1;101;123;239;93;169;725
026793772931;1;252;119;201;85;108;765
091817170927;1;134;186;265;102;145;832
025466352111;1;264;116;231;50;150;811
007117642570;1;227;187;228;105;143;890
020048874340;1;98;244;188;68;130;728
011868347145;1;237;175;131;66;61;670
074599127830;1;260;151;113;95;141;760
085201820019;1;152;180;98;78;59;567
091560368326;1;208;257;297;95;88;945
035120424910;1;153;240;263;75;53;784
086903495888;1;182;103;226;50;96;657
051791659439;1;201;268;161;108;88;826
002360189123;1;201;186;201;101;178;867
055322116759;1;275;182;215;59;155;886
004631918965;1;94;188;245;109;115;751
085941215690;1;243;138;207;83;61;732
032756365828;1;152;276;122;98;101;749
061921689085;1;223;233;162;98;74;790
065900528140;1;218;195;136;111;157;817
057115937715;1;146;280;235;66;147;874
028943896466;1;223;239;245;111;162;980
014686488677;1;248;156;223;68;153;848
092331649926;1;252;97;113;68;96;626
074202954887;1;134;227;291;114;157;923
006938357113;1;188;206;187;100;113;794
080513174400;1;266;278;92;105;138;879
063047754185;1;99;98;293;76;169;735
031193136686;1;196;128;277;118;137;856
036897758595;1;228;155;94;93;114;684
012744211581;1;291;80;106;71;147;695
086783179807;1;127;179;212;78;172;768
066453478620;1;164;215;250;74;153;856
097898655714;1;186;126;194;96;81;683
059253646283;1;265;109;169;77;55;675
082632625538;1;130;217;216;81;157;801
017729383592;1;276;217;111;98;132;834
027266438007;1;224;107;145;75;137;688
083493104705;1;113;274;149;116;168;820
088535211746;1;270;142;267;92;104;875
028195153257;1;244;247;247;96;72;906
087390520471;1;270;156;122;93;139;780
034563986422;1;234;275;212;80;126;927
065213597766;1;231;246;225;93;96;891
072086198848;1;91;80;141;109;115;536
090890832917;1;192;233;209;114;120;868
002587744934;1;154;287;120;81;113;755
045258960006;1;144;244;244;114;142;888
081282422740;1;106;182;267;103;80;738
074294192750;1;191;125;183;82;81;662
095800486744;1;149;113;161;63;98;584
014072647510;1;124;154;166;72;105;621
021376670864;1;113;278;194;82;116;783
075896805297;1;283;86;225;93;106;793
068331905528;1;271;118;246;79;143;857
060473375587;1;206;80;224;100;79;689
073089647145;1;207;135;255;107;139;843
020517533364;1;274;191;134;90;108;797
028470796302;1;220;80;128;53;62;543
081674113772;1;229;217;282;69;56;853
003523117100;1;142;142;193;60;118;655
007147538790;1;194;133;240;88;126;781
065256609449;1;185;82;123;100;58;548
058411033088;1;147;264;167;97;124;799
006764257661;1;87;250;190;68;129;724
037438630686;1;155;216;143;96;72;682
094665732685;1;81;230;164;115;174;764
059632668077;1;192;145;287;68;155;847
069111741544;1;91;276;289;104;148;908
054117112300;1;255;174;206;87;155;877
045004975634;1;235;144;270;56;107;812
078825889223;1;290;264;125;80;148;907
057239487289;1;277;132;175;53;61;698
018627192761;1;146;215;295;55;135;846
078803116993;1;156;221;90;102;128;697
023404638083;1;220;139;182;79;99;719
056275480136;1;156;227;133;102;159;777
092611692023;1;275;245;283;77;174;1054
033923369812;1;265;93;210;61;130;759
004112321056;1;103;138;160;71;139;611
040397099968;1;237;107;112;118;89;663
019374872113;1;261;197;192;69;58;777
092067136162;1;103;117;287;102;84;693
015937924764;1;210;134;184;86;177;791
015139744933;1;135;181;130;84;120;650
000751548086;1;244;145;108;91;116;704
067224693395;1;93;281;110;116;177;777
002196082281;1;136;150;210;66;114;676
067519795998;1;115;214;100;108;58;595
092612290140;1;236;270;277;64;121;968
089836781174;1;215;223;90;109;74;711
027535910000;1;268;115;198;89;53;723
005051669988;1;176;221;123;99;88;707
005329420029;1;103;106;257;80;53;599
052613187332;1;227;254;151;90;178;900
067770584833;1;271;285;253;51;143;1003
049997060249;1;200;147;97;66;84;594
012425431050;1;212;165;183;80;91;731
074754312346;1;146;150;264;63;158;781
020883846891;1;291;143;296;55;96;881
012268444525;1;280;220;171;104;86;861
011345898688;1;266;134;262;73;139;874
077642911612;1;226;285;195;53;123;882
018750174790;1;244;183;197;106;103;833
037510144059;1;227;86;162;72;126;673
096002203498;1;214;105;146;58;153;676
074125459140;1;158;132;277;120;95;782
033168330828;1;96;256;224;62;81;719
097937694646;1;183;240;121;60;94;698
080495157272;1;164;171;299;84;178;896
077356031971;1;250;166;295;74;52;837
002105024078;1;284;128;161;94;80;747
057254054192;1;174;88;151;95;71;579
038478214202;1;274;99;212;117;112;814
058544460332;1;112;137;273;56;87;665
001840758018;1;267;116;142;90;161;776
004272230910;1;189;253;214;98;63;817
062748952035;1;197;278;118;115;51;759
072278345992;1;255;243;199;84;56;837
096118469521;1;203;182;244;114;134;877
081509990034;1;217;184;158;104;74;737
076692610867;1;196;191;178;76;149;790
073015690002;1;169;172;297;106;68;812
025982837956;1;212;282;250;76;137;957
058191369671;1;266;239;208;81;149;943
048456215990;1;124;186;277;119;131;837
084315904945;1;284;85;298;81;126;874
033092733268;1;263;252;219;99;156;989
040127322363;1;287;87;235;113;63;785
015879422228;1;280;86;156;51;85;658
051396830673;1;138;123;279;99;105;744
000941673410;1;178;269;299;71;57;874
054358868843;1;124;156;288;67;67;702
065722198511;1;230;240;273;72;142;957
078197254938;1;224;244;279;54;76;877
026518632807;1;105;238;223;72;81;719
026362625429;1;275;80;212;89;103;759
063925342148;1;222;213;108;107;87;737
024126994517;1;204;122;257;99;158;840
013196213478;1;186;144;227;75;60;692
033715283572;1;139;120;248;90;55;652
004924222392;1;138;199;283;60;54;734
062253389319;1;129;226;92;71;126;644
080701001535;1;186;111;105;95;85;582
033979637386;1;253;130;208;120;84;795
082243055032;1;109;138;162;103;75;587
022975213196;1;224;191;137;80;55;687
086422082108;1;234;144;101;106;77;662
084536503496;1;188;223;137;109;56;713
054855773839;1;202;149;242;97;53;743
036655884107;1;229;100;99;74;101;603
038715164846;1;219;212;219;80;55;785
005654628114;1;108;144;102;110;156;620
021883718960;1;146;212;190;51;126;725
034351029044;1;217;129;287;93;161;887
077369750867;1;165;129;123;109;135;661
052375485834;1;227;276;177;72;170;922
012586531837;1;141;240;216;65;161;823
052974064659;1;286;248;130;74;74;812
051902049047;1;94;250;194;61;119;718
082660863894;1;228;254;139;113;50;784
060632832723;1;234;97;114;56;136;637
074107550096;1;260;226;170;74;127;857
092201009514;1;282;210;276;106;128;1002
006742064568;1;108;224;290;109;89;820
052007662265;1;91;160;204;78;143;676
096052119388;1;273;93;254;95;142;857
042515862239;1;131;137;125;89;114;596
048865306953;1;128;99;173;88;55;543
048352895523;1;113;93;269;70;172;717
035995958888;1;251;193;234;108;106;892
010764931545;1;271;136;211;85;148;851
015260370375;1;187;225;212;107;62;793
090407921943;1;196;165;139;106;106;712
053567056797;1;187;254;91;113;76;721
003402316810;1;259;250;100;118;119;846
071075443977;1;129;167;98;68;65;527
003233268308;1;112;209;179;64;79;643
071012026929;1;138;90;295;56;177;756
017726492594;1;187;220;131;105;121;764
080805569493;1;146;119;298;99;135;797
041325141288;1;274;227;255;63;119;938
086753736632;1;256;123;225;68;138;810
035573961767;1;167;233;118;119;50;687
025450260216;1;149;114;145;63;54;525
073761422281;1;257;159;255;109;118;898
060459082760;1;169;217;259;97;92;834
089416615206;1;262;251;148;57;61;779
082542237180;1;129;120;295;70;158;772
009407803566;1;109;189;98;76;59;531
011593123805;1;105;193;247;101;123;769
034563516533;1;188;257;249;71;93;858
023812106880;1;204;92;129;96;177;698
061276309154;1;104;95;293;78;77;647
053872225155;1;135;200;156;109;65;665
033623782452;1;204;142;240;82;98;766
079642846279;1;236;249;195;98;68;846
062957522973;1;162;142;253;78;101;736
064984659331;1;226;89;206;56;89;666
069767771923;1;116;183;175;74;55;603
092717924567;1;265;131;127;113;153;789
073289348561;1;280;208;217;85;109;899
022033427052;1;288;109;115;51;157;720
017002867570;1;285;170;149;101;107;812
081447817957;1;92;224;275;92;87;770
014334810633;1;274;275;131;100;168;948
040839325183;1;185;132;150;108;139;714
020466028618;1;88;81;193;51;69;482
080684283097;1;158;270;188;81;161;858
006310174569;1;289;83;181;62;51;666
045427271806;1;230;123;178;82;173;786
006392879047;1;167;286;221;120;96;890
077207058930;1;180;90;91;116;138;615
018435766304;1;206;258;115;55;53;687
082362389487;1;269;94;94;61;89;607
059835303713;1;198;83;197;109;110;697
031206541186;1;199;190;268;52;86;795
020968784394;1;220;159;255;119;177;930
042206154519;1;234;257;174;84;168;917
005282733628;1;208;119;244;54;98;723
010708748873;1;169;281;289;107;75;921
027424800317;1;252;179;226;57;70;784
074730403059;1;285;193;167;73;64;782
019945576602;1;210;119;238;118;146;831
095719550554;1;220;124;260;117;172;893
073994523328;1;274;123;191;92;54;734
017354242312;1;219;201;145;52;52;669
022702623524;1;89;158;263;80;152;742
051544172235;1;248;218;148;66;55;735
016042236086;1;212;153;226;102;70;763
055861950379;1;245;250;190;61;143;889
041311507401;1;287;152;209;84;104;836
019606361754;1;118;196;262;90;115;781
099136935921;1;151;259;152;64;155;781
025260058962;1;259;110;250;108;131;858
088732348760;1;171;275;278;75;114;913
062462194705;1;147;221;225;80;102;775
040896171800;1;291;165;218;103;159;936
056893806264;1;280;220;205;51;147;903
047185200021;1;116;150;154;97;149;666
005113991273;1;98;168;167;53;82;568
042929159708;1;81;164;196;96;104;641
023650769059;1;250;100;101;94;129;674
031677645156;1;227;158;99;119;125;728
001038121924;1;107;222;163;76;109;677
051180754161;1;201;247;210;100;125;883
015869239106;1;223;164;219;82;136;824
066108867653;1;221;89;288;81;170;849
080834385050;1;101;145;107;63;76;492
037748022343;1;251;265;104;97;135;852
079068298257;1;281;223;198;108;63;873
014903569257;1;160;197;188;109;119;773
015105557356;1;187;187;182;59;84;699
054623037288;1;232;236;258;74;82;882
095158574926;1;215;184;125;97;138;759
049932884388;1;265;211;137;68;99;780
098932151633;1;206;234;298;95;173;1006
030649310505;1;274;232;221;112;70;909
060988023226;1;179;118;143;120;166;726
048777736112;1;220;110;149;85;78;642
019947515041;1;242;265;188;99;173;967
053604586203;1;116;191;164;100;73;644
018231078640;1;184;190;144;96;126;740
060882246712;1;205;99;178;90;155;727
090629609401;1;224;177;141;70;140;752
000601510424;1;204;280;162;65;87;798
088854291821;1;222;166;120;112;154;774
065270856220;1;234;281;114;79;156;864
038157987817;1;225;277;217;119;150;988
041607040943;1;276;171;234;57;141;879
081065326168;1;93;129;250;57;58;587
091420787887;1;142;131;163;109;62;607
063800320619;1;224;82;159;85;64;614
011113130891;1;166;254;228;100;131;879
046964379964;1;154;210;185;110;91;750
055533126074;1;284;135;270;99;87;875
067204135918;1;172;241;191;120;141;865
091258872807;1;265;100;125;90;171;751
000814118065;1;236;276;186;97;116;911
028301378069;1;181;139;192;52;154;718
058889988836;1;176;101;125;89;126;617
041368576548;1;247;237;193;52;101;830
093706796705;1;146;280;143;60;62;691
045378841175;1;286;111;133;80;84;694
021228160747;1;260;255;100;119;159;893
010794124555;1;284;279;206;83;138;990
049355866112;1;103;158;189;81;92;623
023235338677;1;266;135;248;66;142;857
090823496693;1;87;270;201;96;136;790
076023495572;1;97;233;299;56;177;862
027707344610;1;199;261;222;99;126;907
045160046901;1;139;206;223;96;121;785
075686097426;1;268;270;202;117;114;971
064106197304;1;172;258;159;65;156;810
003028567411;1;252;119;122;55;85;633
093028299281;1;248;169;102;80;60;659
067000909875;1;213;123;300;70;119;825
007555104556;1;153;207;260;102;102;824
071498828495;1;120;276;97;120;118;731
029498171948;1;266;138;296;82;129;911
042069028685;1;109;152;94;93;141;589
092013497725;1;122;280;249;104;153;908
052661383972;1;98;137;119;71;54;479
028299890457;1;264;99;193;93;151;800
061007653326;1;123;161;100;119;125;628
024908869560;1;93;249;154;52;171;719
057255200508;1;250;215;216;85;92;858
067351509198;1;205;182;190;77;152;806
087625852141;1;93;287;202;110;132;824
036809368260;1;149;116;282;67;88;702
033469978689;1;258;227;227;54;55;821
085411068099;1;128;158;126;99;66;577
018151626507;1;164;158;202;107;109;740
018371917424;1;244;263;126;96;172;901
027024333897;1;169;278;236;60;155;898
071212999292;1;270;269;104;108;103;854
006154612610;1;114;218;262;64;55;713
014817112951;1;169;253;222;71;166;881
016650856840;1;268;190;294;64;139;955
006353076601;1;131;228;285;113;56;813
078751345878;1;113;107;164;116;147;647
055275122376;1;210;252;208;108;177;955
014825979976;1;107;186;261;110;70;734
089208759185;1;137;128;280;84;107;736
097125516389;1;198;265;146;114;172;895
028271095949;1;91;161;101;90;62;505
056526335138;1;90;187;272;91;163;803
060696768151;1;202;253;103;70;104;732
059970157219;1;233;252;256;67;160;968
077220166029;1;187;255;205;75;121;843
065504053881;1;207;134;184;78;125;728
005141243935;1;114;232;137;87;141;711
050546897422;1;269;156;287;105;55;872
057041797834;1;279;125;238;110;61;813
026860368894;1;121;109;125;50;83;488
086407382720;1;201;185;178;120;76;760
053421692380;1;169;191;111;83;86;640
062151561224;1;118;277;285;68;68;816
088239025770;1;121;188;166;86;122;683
018823170132;1;97;156;201;83;168;705
084206452054;1;249;232;288;116;142;1027
009820818033;1;184;172;172;94;75;697
032068252014;1;101;181;210;58;146;696
077724283683;1;109;288;130;68;71;666
095192321580;1;105;160;158;71;114;608
028816240666;1;289;251;271;75;142;1028
031628576063;1;202;265;206;65;78;816
086915828882;1;155;139;195;85;178;752
001427268237;1;100;263;283;88;116;850
028818520727;1;235;196;140;97;126;794
066479349613;1;224;242;135;101;148;850
049374239398;1;130;263;156;79;113;741
002358276850;1;121;158;147;100;121;647
056972467555;1;83;263;210;104;160;820
029197524952;1;174;132;258;70;134;768
028027683594;1;251;231;172;70;95;819
001762559806;1;111;154;224;57;167;713
019966280529;1;160;119;235;86;176;776
000056171466;1;278;133;288;82;142;923
080572543320;1;174;280;249;75;92;870
055574204226;1;117;234;275;76;155;857
055186240375;1;97;188;248;110;161;804
038094415918;1;225;186;241;88;176;916
019398253275;1;197;153;267;51;78;746
088933587752;1;174;133;178;55;63;603
040153191941;1;151;200;245;69;117;782
019451394871;1;274;110;95;54;72;605
011568917762;1;87;120;269;59;103;638
014401816677;1;86;138;131;72;59;486
025789992601;1;230;167;158;51;86;692
016934663083;1;282;210;281;91;141;1005
037119115869;1;287;257;109;99;138;890
080176991480;1;195;85;145;115;94;634
014785736149;1;177;203;189;71;101;741
009028360987;1;227;105;247;103;67;749
005088148828;1;199;270;127;114;62;772
079487649069;1;250;94;121;111;99;675
036587482192;1;258;251;90;99;155;853
013953741781;1;254;99;117;73;50;593
099474251433;1;219;249;113;85;96;762
004666662041;1;196;82;201;61;55;595
076862037111;1;254;182;105;96;124;761
035646490055;1;214;247;262;92;76;891
062646157846;1;266;138;275;80;176;935
074748139125;1;250;263;108;66;110;797
098428279142;1;83;182;147;88;132;632
008394133356;1;121;243;104;76;87;631
073023403879;1;254;206;147;87;128;822
047238058578;1;89;220;185;55;171;720
082481996627;1;243;250;210;56;155;914
003972748911;1;254;157;281;83;141;916
013339338836;1;192;247;233;61;160;893
093505591436;1;117;265;129;77;175;763
070272780142;1;252;141;225;97;73;788
059963310651;1;132;213;297;105;124;871
016516609948;1;129;285;113;59;57;643
031516051566;1;210;91;198;66;90;655
087141162104;1;159;94;244;58;106;661
053113229348;1;277;242;278;88;113;998
067513248625;1;242;176;257;107;134;916
072231228940;1;129;250;249;66;120;814
096906992314;1;189;112;158;83;146;688
005010699499;1;81;188;220;96;91;676
015545701111;1;238;124;96;98;57;613
076919800752;1;276;280;92;114;151;913
002027240362;1;145;283;245;117;107;897
000037839540;1;146;191;238;93;96;764
069595014102;1;268;257;146;103;144;918
073696780394;1;191;130;119;83;110;633
003411586322;1;124;139;165;58;63;549
022776599118;1;202;100;106;81;170;659
018551667928;1;140;267;277;91;97;872
071832789846;1;82;150;205;52;71;560
096710991125;1;119;205;133;108;107;672
021309154984;1;90;221;125;79;68;583
040519695519;1;260;228;92;119;162;861
025808616445;1;258;135;117;94;117;721
005775576871;1;221;149;273;75;81;799
051633386524;1;183;260;110;55;119;727
058142587703;1;121;268;117;50;151;707
053072484193;1;198;123;215;96;111;743
095338113843;1;89;273;239;70;123;794
062290173457;1;169;200;185;85;93;732
072331584423;1;102;115;182;96;119;614
072366113430;1;99;112;160;108;128;607
031867591401;1;236;106;253;106;106;807
043839925020;1;149;214;176;76;80;695
039816039798;1;198;279;300;107;58;942
002731633279;1;168;193;205;111;59;736
063228788258;1;234;222;215;95;164;930
021598837781;1;279;199;201;83;130;892
078936664878;1;142;85;113;97;60;497
053867220884;1;82;193;126;96;140;637
022110118682;1;276;136;164;79;149;804
027519338282;1;115;163;234;90;55;657
012325180601;1;116;180;236;60;123;715
086658690605;1;151;134;100;116;176;677
087786457435;1;234;217;180;85;113;829
067585512927;1;207;131;251;79;82;750
043762312186;1;164;288;290;56;143;941
070002549651;1;288;92;93;97;133;703
087764221879;1;269;229;177;69;85;829
060302317422;1;159;284;160;68;111;782
072034747048;1;110;271;237;97;64;779
065943079024;1;176;111;145;77;142;651
054243048259;1;245;271;157;63;138;874
082185433010;1;121;83;282;105;72;663
045983302235;1;283;249;238;84;106;960
039882391648;1;269;146;239;50;112;816
023442354211;1;208;127;253;100;112;800
060741305454;1;157;242;103;79;146;727
030207982919;1;83;269;90;90;93;625
053697093037;1;98;192;289;68;132;779
056256997312;1;285;154;90;98;173;800
077546722007;1;127;212;148;82;120;689
002834913001;1;133;134;124;97;76;564
046294622750;1;204;168;160;119;152;803
024041596755;1;169;200;249;53;157;828
065440103969;1;132;93;186;101;130;642
073778634198;1;174;153;137;65;112;641
009559928347;1;104;199;107;101;114;625
078407267468;1;149;258;97;59;130;693
054780842681;1;105;84;139;56;115;499
006095442692;1;267;206;156;64;171;864
030201765801;1;117;216;143;59;178;713
094527435136;1;122;97;279;95;121;714
007809464659;1;84;149;202;111;79;625
005442179700;1;221;85;146;106;73;631
037201819901;1;118;183;239;100;93;733
054946865709;1;176;210;186;99;174;845
080242346529;1;151;188;194;66;167;766
092595743995;1;148;211;203;93;70;725
090217148158;1;220;250;265;107;126;968
001246516517;1;197;107;179;107;115;705
043372445668;1;216;241;257;109;128;951
052599604239;1;104;261;278;109;140;892
068922380304;1;266;113;226;85;63;753
030694455283;1;242;263;178;84;67;834
018046175034;1;276;288;175;61;95;895
065339521285;1;261;185;261;62;163;932
099611157585;1;239;154;127;86;54;660
093817573659;1;284;265;166;58;140;913
041920875220;1;176;182;99;110;100;667
062652181913;1;211;151;96;92;80;630
049862646804;1;115;258;252;86;58;769
090841129058;1;155;187;224;50;106;722
084773836997;1;157;80;279;108;170;794
095880721296;1;82;139;202;80;157;660
047464551183;1;132;191;114;119;54;610
060384105493;1;173;231;230;117;73;824
012744275040;1;289;130;171;79;83;752
074901692256;1;245;120;101;119;139;724
084527321417;1;147;95;105;87;123;557
044596107240;1;214;121;279;118;147;879
072149964690;1;133;196;213;118;69;729
055656522720;1;212;82;147;93;99;633
090845358611;1;99;287;167;89;156;798
079936825684;1;213;145;156;64;156;734
003071320597;1;207;144;298;66;84;799
016935419791;1;137;143;274;58;93;705
050008825447;1;288;269;100;112;72;841
041322260814;1;227;112;300;88;54;781
096809876432;1;271;99;117;69;88;644
074045413366;1;233;100;219;81;140;773
075383495339;1;268;129;101;57;60;615
079395568871;1;114;143;192;96;155;700
060947463803;1;242;237;112;108;135;834
028192787645;1;251;257;121;91;77;797
081233081789;1;242;166;152;89;154;803
089966470515;1;241;98;149;75;151;714
062046907608;1;85;208;236;82;158;769
085551502036;1;251;99;254;78;110;792
046144897864;1;266;90;213;83;135;787
068199691736;1;259;186;181;52;102;780
064441461328;1;247;88;288;81;113;817
068055557763;1;265;102;137;96;51;651
017079015784;1;230;166;256;81;102;835
093266462624;1;80;232;168;64;62;606
008613173299;1;183;196;264;115;139;897
094725378684;1;222;167;245;116;162;912
041553788215;1;89;205;206;62;140;702
006708527207;1;237;87;208;92;118;742
065833430581;1;130;135;188;99;109;661
093646248951;1;277;164;149;74;114;778
054585908196;1;177;277;109;53;60;676
096055323900;1;267;96;220;74;172;829
062390425522;1;252;235;178;77;160;902
043328399847;1;241;255;295;75;86;952
014115918910;1;290;192;263;71;139;955
039111331171;1;167;215;155;61;116;714
085980789579;1;260;135;203;115;78;791
031839185510;1;230;98;242;86;147;803
087201350846;1;129;124;123;57;130;563
084537208134;1;233;91;189;53;146;712
011817238944;1;141;227;297;117;159;941
068466857544;1;200;192;208;104;178;882
063415873788;1;215;185;225;85;168;878
081342923879;1;188;244;285;55;57;829
057915827972;1;152;219;128;91;115;705
010685216064;1;287;153;216;68;109;833
069748906641;1;219;90;160;69;132;670
041965399100;1;273;279;279;116;105;1052
071667161122;1;124;175;215;56;146;716
014865199155;1;251;237;100;108;56;752
093431827946;1;246;285;257;67;63;918
062642128331;1;99;121;221;117;128;686
074754185195;1;87;123;174;114;54;552
051315331171;1;143;173;213;64;139;732
090705381169;1;122;144;283;83;150;782
086340615185;1;270;185;184;119;133;891
001006776966;1;191;216;164;55;95;721
075308103317;1;109;144;226;60;59;598
061748618336;1;83;188;248;110;63;692
021025557996;1;90;110;147;76;167;590
054020098114;1;188;130;241;88;62;709
099340451290;1;193;233;246;72;153;897
067684651209;1;105;195;171;70;135;676
076730627027;1;230;92;164;107;125;718
063079784746;1;119;169;95;58;115;556
000672267176;1;96;155;260;75;66;652
036679874723;1;151;181;274;101;173;880
051384785279;1;201;147;274;56;61;739
038703821287;1;194;111;247;99;147;798
095985420649;1;209;278;257;71;87;902
003985590485;1;154;134;259;66;68;681
079420620458;1;161;152;224;72;168;777
052325832207;1;252;111;246;116;57;782
004193119460;1;282;111;241;64;140;838
025463849905;1;289;124;294;96;118;921
035556906594;1;140;108;163;118;97;626
094003558692;1;110;168;158;56;59;551
022780870571;1;229;148;198;62;117;754
031567967883;1;280;107;157;114;56;714
067566375111;1;236;246;181;77;53;793
013235086943;1;84;223;122;85;88;602
019974494815;1;201;152;261;105;113;832
061929230957;1;141;94;92;76;140;543
085557314449;1;90;172;178;104;53;597
008825254120;1;163;253;197;83;103;799
003236272491;1;172;81;101;101;92;547
059624642051;1;180;158;293;74;122;827
021039599590;1;262;280;213;113;68;936
006796536357;1;86;208;203;55;59;611
036766262767;1;160;192;202;55;160;769
016938176765;1;119;276;288;119;65;867
068562310230;1;187;188;178;62;167;782
001549525650;1;274;210;182;54;111;831
082045325092;1;284;149;288;72;57;850
090289998695;1;195;287;267;89;75;913
050640945747;1;98;114;280;54;118;664
058563132784;1;203;234;115;69;166;787
005897390023;1;98;114;111;65;88;476
027183329648;1;111;170;251;119;57;708
014129302377;1;173;176;296;100;53;798
007840908171;1;200;253;277;50;76;856
056069083081;1;244;121;124;114;149;752
085914843376;1;225;177;202;103;69;776
055851694577;1;117;171;99;74;83;544
083421892167;1;145;214;297;102;146;904
029207300926;1;146;179;107;59;78;569
017184884256;1;220;281;95;88;138;822
046867677323;1;105;137;213;118;138;711
068135914764;1;112;241;246;61;111;771
007798879066;1;241;158;152;87;116;754
005766709271;1;271;260;129;76;117;853
028487692256;1;104;165;282;90;166;807
032756630822;1;244;269;123;116;109;861
053436174886;1;267;215;277;82;90;931
009696326841;1;176;176;151;118;74;695
063030547895;1;177;211;245;118;141;892
066230491961;1;260;98;125;92;98;673
088505382043;1;167;234;155;67;109;732
060277721866;1;123;179;254;53;138;747
096171690737;1;143;85;98;120;132;578
072209380989;1;233;127;175;63;154;752
000529569621;1;200;271;257;69;105;902
052163229371;1;275;271;277;81;107;1011
042416545531;1;245;249;230;72;175;971
097005073038;1;168;234;188;84;122;796
088484703891;1;247;163;203;95;124;832
036964149431;1;191;120;201;53;130;695
093247789168;1;292;117;98;108;119;734
001806817140;1;269;263;106;64;157;859
083146728433;1;207;160;128;84;165;744
039791271757;1;167;137;298;90;99;791
088736234426;1;91;215;285;86;127;804
078593979729;1;80;109;191;79;159;618
064134680971;1;288;258;186;72;143;947
007126995349;1;203;83;110;103;103;602
018582097776;1;243;99;90;53;119;604
031090209300;1;127;87;249;107;57;627
040345143943;1;198;99;165;86;155;703
035381784124;1;263;84;177;71;115;710
074550504604;1;98;103;110;112;93;516
094362181514;1;290;222;186;54;145;897
099646232023;1;181;162;207;98;108;756
029428670814;1;185;129;168;69;133;684
008774372795;1;161;109;224;51;77;622
062688995395;1;149;276;299;91;156;971
046245667263;1;284;286;115;102;55;842
018174738624;1;254;204;232;113;115;918
090907488655;1;270;286;282;55;65;958
055198110808;1;133;161;277;66;50;687
006363991989;1;157;259;97;93;160;766
089700682565;1;235;208;202;58;136;839
090526483868;1;268;122;237;83;157;867
036517182752;1;225;175;192;99;87;778
056415448153;1;192;228;179;83;101;783
054892002479;1;251;255;111;88;129;834
034534877716;1;213;257;214;76;94;854
088302428670;1;255;220;222;90;128;915
043583238754;1;219;86;163;116;153;737
055831064641;1;216;96;182;91;157;742
010674558911;1;151;99;96;120;105;571
038215064042;1;131;194;273;109;88;795
039071333539;1;86;218;101;66;131;602
079463694026;1;238;88;276;59;132;793
009406356515;1;237;126;237;70;159;829
017732118338;1;108;181;231;88;169;777
089695423294;1;128;90;140;111;134;603
032035999583;1;88;279;175;93;55;690
032460896990;1;208;150;111;60;77;606
016764372745;1;124;93;171;87;115;590
068763579246;1;272;114;281;104;60;831
016268441640;1;152;167;205;66;144;734
051606469191;1;198;258;103;74;117;750
085134952489;1;171;136;229;106;99;741
052400141567;1;84;104;211;103;56;558
018796847332;1;228;275;144;50;90;787
023350102183;1;118;96;149;53;155;571
024290496124;1;244;154;152;68;55;673
029470667194;1;104;184;215;77;165;745
023385406767;1;82;250;270;91;130;823
067093458107;1;225;217;167;54;68;731
068240965346;1;137;204;224;95;147;807
023752272775;1;246;123;126;82;177;754
082023300318;1;255;213;97;60;177;802
010353031516;1;152;124;254;54;169;753
035354258412;1;239;105;94;78;61;577
080178586774;1;271;131;178;87;140;807
004784532015;1;169;283;185;88;56;781
090497400972;1;91;201;181;66;84;623
039035492669;1;266;135;174;86;57;718
076011845840;1;136;153;248;100;113;750
082265484064;1;89;206;280;57;113;745
098710040725;1;138;212;136;84;104;674
013355005394;1;269;128;216;66;56;735
045515280262;1;133;126;172;50;65;546
074930210304;1;104;285;249;113;165;916
009799845803;1;185;148;123;53;142;651
059169280876;1;111;269;137;103;96;716
035775627562;1;186;286;204;86;52;814
007931620220;1;206;265;132;67;130;800
089787797637;1;286;185;297;55;67;890
046041720268;1;216;105;287;120;175;903
063852557220;1;241;274;296;89;120;1020
029961181196;1;159;185;262;104;62;772
030999692827;1;91;226;94;93;130;634
005888442193;1;206;154;162;97;104;723
038792262005;1;291;188;141;85;152;857
057424020398;1;164;200;213;76;72;725
038587202682;1;291;251;227;81;129;979
014550970388;1;122;142;245;81;70;660
021855500875;1;80;141;112;100;153;586
019701138011;1;228;227;296;118;152;1021
066970835506;1;264;153;267;110;71;865
054089890610;1;133;182;95;85;121;616
044235751067;1;133;221;108;69;81;612
031443670095;1;226;117;90;119;166;718
049370384739;1;267;180;222;68;69;806
057529481037;1;117;252;274;109;146;898
020440369934;1;86;191;257;75;72;681
016459694383;1;105;264;258;104;71;802
097329761431;1;163;157;147;55;147;669
006880667746;1;184;162;199;53;169;767
042494364826;1;118;178;236;80;163;775
006616664966;1;153;242;132;56;174;757
060405542525;1;254;258;234;88;143;977
069087672940;1;249;101;145;55;96;646
068100481556;1;251;121;283;105;121;881
077548209315;1;269;88;257;109;71;794
097792969435;1;147;284;177;105;130;843
023218653802;1;165;90;112;54;92;513
072548812532;1;110;280;146;106;97;739
074036368954;1;133;171;293;80;98;775
042689365001;1;241;285;228;72;79;905
038983384724;1;273;274;176;88;67;878
092662193848;1;100;141;208;62;58;569
031363648039;1;194;226;218;97;50;785
057891251660;1;143;258;228;101;71;801
071741062951;1;259;270;145;53;173;900
029962379037;1;210;152;212;58;152;784
096500515802;1;202;181;200;106;129;818
096623415830;1;149;138;95;107;155;644
041048993088;1;88;95;201;77;87;548
098485442051;1;129;105;199;95;153;681
059124454198;1;177;197;150;115;126;765
021008072362;1;236;285;294;81;82;978
055703441645;1;116;248;101;70;135;670
067154506419;1;159;202;264;89;159;873
018302362040;1;292;277;298;73;80;1020
003279235882;1;197;283;150;60;86;776
009725072343;1;181;101;281;91;83;737
025476304497;1;204;263;123;95;108;793
091950773253;1;179;141;158;104;79;661
062223549955;1;193;241;125;78;60;697
088633311764;1;160;142;227;81;152;762
008200653114;1;107;97;115;52;177;548
032810942453;1;133;98;169;73;52;525
022540760012;1;263;112;119;65;91;650
082351270385;1;195;201;125;103;68;692
018016463158;1;125;253;239;103;128;848
021724799645;1;251;115;132;64;69;631
041252971031;1;107;246;153;55;102;663
074859898129;1;130;186;206;102;97;721
078390545285;1;179;134;246;83;69;711
028308549511;1;227;233;208;62;152;882
025899516024;1;277;248;132;72;104;833
088619370895;1;121;230;272;51;146;820
059466483826;1;148;101;150;76;129;604
032485867802;1;120;288;192;76;147;823
029858408494;1;235;102;236;76;145;794
030527545750;1;248;128;160;60;94;690
021239214969;1;86;217;258;95;74;730
079480725181;1;87;204;266;50;168;775
014386977448;1;211;106;178;54;69;618
045368672652;1;250;92;177;105;163;787
080348706758;1;161;189;169;86;85;690
073141598318;1;224;271;161;54;121;831
066184686397;1;87;222;110;75;93;587
072063356318;1;199;249;180;98;90;816
066630466397;1;204;136;268;54;92;754
079012851829;1;95;153;243;78;82;651
077049339164;1;124;102;261;93;57;637
094469754576;1;100;120;126;94;119;559
037328926821;1;92;122;281;72;130;697
083836092947;1;158;207;205;64;159;793
045970104677;1;197;276;206;84;150;913
005436215959;1;258;193;150;96;142;839
042469482447;1;176;150;268;79;59;732
054017153836;1;178;243;111;85;85;702
087429588702;1;271;183;207;69;90;820
050386598856;1;264;166;207;101;158;896
042834168307;1;179;212;158;69;166;784
023767144586;1;207;201;292;95;59;854
001096392542;1;104;231;155;59;68;617
026764140180;1;222;174;171;79;154;800
032712825475;1;283;148;299;114;106;950
013170331956;1;232;110;276;95;54;767
057894376418;1;89;239;262;111;153;854
071649519536;1;135;122;229;115;137;738
047015326741;1;282;134;292;92;142;942
010098296004;1;248;148;259;62;131;848
074290928252;1;141;144;237;52;73;647
018892174809;1;121;182;147;116;95;661
029480479589;1;176;236;270;83;66;831
060548307749;1;84;128;202;85;141;640
033531641030;1;211;186;103;111;161;772
071898311146;1;91;267;277;63;71;769
018327063213;1;92;259;229;77;177;834
012705721591;1;172;183;104;104;57;620
091367053069;1;141;117;155;87;153;653
040274145900;1;241;278;101;98;52;770
004827857765;1;122;268;225;68;177;860
022774986134;1;236;175;251;118;142;922
070186974801;1;163;253;254;112;119;901
077509326000;1;271;210;108;90;105;784
069551556423;1;166;233;221;102;59;781
046816342615;1;244;211;173;77;56;761
067613489491;1;138;264;292;55;132;881
038891798010;1;292;251;123;107;71;844
007380686615;1;272;202;111;67;150;802
003322561957;1;94;213;157;87;103;654
060180353676;1;244;287;165;69;152;917
053934660465;1;204;127;139;114;58;642
030792002343;1;82;253;191;68;153;747
080031935395;1;246;245;151;56;80;778
056233788707;1;177;232;259;94;167;929
047337842308;1;177;232;114;54;147;724
050843429683;1;287;85;134;100;153;759
081555364070;1;103;131;116;70;160;580
088994526584;1;142;260;266;93;87;848
067939466309;1;114;126;157;60;174;631
009075928161;1;156;287;275;78;163;959
085860665207;1;287;208;206;75;134;910
036510061534;1;126;219;138;81;143;707
096650874699;1;156;256;245;96;75;828
087344975807;1;223;188;249;97;174;931
098700326495;1;162;196;216;96;106;776
067521918812;1;187;165;294;80;165;891
011466862118;1;277;150;282;99;66;874
028471424744;1;123;263;230;109;132;857
065878298415;1;242;286;143;113;82;866
036867623983;1;238;264;142;103;100;847
040476760770;1;284;81;139;71;101;676
015211903657;1;176;91;259;105;134;765
032860513552;1;132;185;262;74;124;777
093813489847;1;100;242;292;86;149;869
022984072000;1;193;229;159;111;166;858
036634315460;1;205;149;99;76;103;632
042012800856;1;179;259;134;116;65;753
085670364554;1;287;111;121;107;110;736
024564087007;1;276;88;104;75;107;650
052907734995;1;241;160;230;64;79;774
015307309631;1;95;141;168;115;120;639
026702380778;1;187;184;276;52;63;762
016585647181;1;140;178;116;80;113;627
062700594873;1;267;237;112;51;149;816
056178696972;1;262;249;156;103;64;834
006270465564;1;100;257;136;99;109;701
003878238066;1;268;240;188;102;160;958
051889051289;1;229;186;105;78;105;703
070781383588;1;246;129;169;59;123;726
058362821624;1;119;176;283;112;122;812
010877422139;1;289;272;184;119;168;1032
062589889077;1;99;247;206;92;118;762
090461608010;1;190;217;175;58;98;738
046673950972;1;282;263;293;67;149;1054
003480185196;1;206;267;219;105;138;935
046750257322;1;148;172;93;83;126;622
063874342152;1;267;196;284;116;115;978
080954964317;1;160;140;225;92;69;686
080888491122;1;146;158;173;64;136;677
053709390180;1;251;135;260;93;114;853
098286467345;1;93;206;136;119;100;654
042293524864;1;136;285;112;114;173;820
026418537354;1;259;212;158;71;61;761
089561119052;1;141;143;101;107;115;607
099549951156;1;164;273;144;85;82;748
035511660768;1;83;156;202;100;173;714
002985388854;1;179;199;295;106;142;921
012722831860;1;132;194;147;120;61;654
042004171492;1;218;195;113;100;163;789
009235482036;1;237;255;266;96;136;990
074830146319;1;213;177;135;50;163;738
011307858951;1;247;191;239;111;131;919
004697994911;1;271;211;127;73;74;756
056507496662;1;107;138;222;70;59;596
068563302680;1;120;257;111;68;59;615
040322137371;1;139;110;108;87;176;620
011921651703;1;200;196;136;92;88;712
056746180582;1;146;198;134;94;140;712
079191939244;1;267;249;194;63;57;830
098228686703;1;112;257;119;95;170;753
010356345129;1;211;273;158;64;117;823
099403240071;1;214;154;218;115;54;755
026097153445;1;192;250;215;84;56;797
097522433502;1;217;91;253;71;57;689
001670577294;1;233;141;197;62;83;716
055283815742;1;196;227;238;65;55;781
080153056857;1;178;234;211;64;70;757
084376789565;1;254;232;273;107;132;998
011084323780;1;274;236;193;63;140;906
099384732396;1;244;226;269;103;175;1017
066069657055;1;140;112;180;94;153;679
087323445519;1;288;245;135;94;133;895
034361435534;1;250;217;108;58;122;755
000556284435;1;94;159;240;93;142;728
009490792821;1;215;82;184;81;133;695
014536994883;1;292;199;259;81;148;979
027454145424;1;166;187;194;119;114;780
092559637699;1;94;187;143;75;95;594
072421467385;1;173;146;148;97;72;636
072532680676;1;144;86;300;54;114;698
082926902202;1;96;260;116;54;147;673
034255784200;1;235;224;196;84;88;827
038151607086;1;243;193;252;72;70;830
090565877888;1;123;188;299;95;59;764
092293404881;1;229;213;212;80;142;876
028824214617;1;91;106;233;98;62;590
070199882695;1;116;286;106;71;82;661
055600085709;1;94;154;130;57;165;600
098516990546;1;186;209;202;82;149;828
033519793521;1;254;272;120;78;177;901
063364012255;1;184;285;138;56;118;781
018404791360;1;205;181;199;84;175;844
035781759331;1;183;177;180;69;116;725
008982427515;1;196;153;244;86;177;856
059101119787;1;200;178;122;98;161;759
098569077690;1;201;270;123;56;92;742
096602910463;1;109;268;104;50;84;615
079494436100;1;291;214;273;116;72;966
066065859562;1;110;222;258;54;116;760
002732316931;1;286;99;203;115;117;820
039222634475;1;251;212;277;59;130;929
020706712620;1;237;256;182;105;124;904
006233174233;1;98;159;116;88;132;593
035779645096;1;141;147;99;101;86;574
001779467955;1;148;179;274;90;88;779
000628320064;1;116;94;160;109;116;595
041332149489;1;260;250;123;93;87;813
086566431051;1;83;172;228;51;58;592
092233856365;1;176;172;122;61;174;705
088084062840;1;216;241;125;73;79;734
017620280288;1;274;163;97;99;54;687
026540175271;1;263;261;249;54;115;942
008018608298;1;117;232;266;70;171;856
014538016131;1;214;180;259;116;134;903
052808685654;1;132;192;96;51;122;593
071744454849;1;161;286;130;91;71;739
089339688385;1;136;253;278;105;109;881
065419108117;1;241;276;176;115;90;898
031797027730;1;126;247;247;93;92;805
015520880881;1;251;122;160;103;177;813
044810289209;1;276;167;281;58;145;927
070445421825;1;111;182;133;102;136;664
099594372034;1;112;144;147;74;112;589
087822333050;1;187;165;109;68;107;636
010638123717;1;195;278;189;54;90;806
029219683345;1;176;193;258;65;143;835
076560333960;1;160;118;258;55;111;702
017247174678;1;240;83;284;80;150;837
050009934692;1;221;239;291;94;64;909
003504222562;1;176;151;200;79;120;726
090840467434;1;169;109;218;84;138;718
066497698325;1;159;154;280;54;162;809
038035261411;1;154;186;245;83;152;820
031638616722;1;95;87;253;78;54;567
088781032979;1;255;274;122;62;72;785
092793909423;1;254;260;272;99;130;1015
035623471411;1;181;89;290;79;70;709
075641195040;1;208;137;199;105;127;776
086107917854;1;186;248;294;108;90;926
096534066965;1;253;145;263;97;153;911
050526312693;1;217;184;241;58;100;800
083320031410;1;187;81;256;52;92;668
064087225709;1;113;182;208;96;108;707
067967654612;1;104;224;292;99;161;880
038327953506;1;116;88;171;50;53;478
028052687593;1;194;130;121;106;152;703
094396611761;1;104;191;257;90;93;735
007361069143;1;249;108;290;50;74;771
054112105215;1;148;203;137;102;54;644
084472173868;1;154;127;200;83;74;638
003267461589;1;219;110;137;71;89;626
091913726003;1;172;286;245;68;89;860
066124481956;1;153;265;132;89;67;706
053576269466;1;204;208;253;51;158;874
024101099631;1;198;269;246;111;167;991
064147987559;1;114;257;176;65;50;662
068395699015;1;282;229;253;64;101;929
034014075101;1;104;190;241;90;93;718
024171948881;1;102;234;95;54;55;540
061641491950;1;109;269;120;89;101;688
087127060126;1;236;208;96;118;104;762
087999333933;1;245;221;138;116;103;823
092972424109;1;156;217;194;104;66;737
017989622610;1;140;286;175;67;164;832
084212894344;1;99;261;278;80;83;801
083635193827;1;103;268;127;86;94;678
073678885597;1;98;82;218;67;115;580
012330089566;1;188;184;264;102;141;879
018683139469;1;137;139;260;65;82;683
077225161118;1;254;174;116;95;99;738
054934912780;1;224;152;181;108;166;831
034474763611;1;136;225;207;76;112;756
091800933210;1;228;198;101;86;177;790
010614812954;1;121;185;225;103;128;762
019496605621;1;102;134;146;112;178;672
034957553021;1;84;194;294;103;142;817
068937148763;1;202;134;192;104;160;792
049127987973;1;224;257;298;60;75;914
076203904875;1;169;220;270;74;147;880
099141582929;1;91;116;159;68;64;498
039682551176;1;218;219;224;80;93;834
084937042105;1;280;191;284;88;122;965
019596927864;1;264;85;96;87;177;709
052033453315;1;105;205;284;92;118;804
085600975280;1;199;217;131;85;62;694
065231730869;1;235;119;236;73;117;780
053536317608;1;263;92;154;115;78;702
070757347914;1;139;184;229;58;175;785
042666518046;1;113;239;282;98;165;897
012622485253;1;111;124;150;51;112;548
017186546953;1;227;232;256;117;58;890
031631732444;1;283;168;178;56;65;750
014870995498;1;194;81;104;75;141;595
035135904873;1;278;256;211;50;129;924
048019213930;1;191;175;248;68;162;844
060826463707;1;189;214;176;73;142;794
022224012621;1;100;114;148;110;155;627
019214799552;1;168;179;128;110;143;728
029625508668;1;144;133;144;52;166;639
064628794278;1;109;154;197;74;168;702
048522991067;1;160;217;133;119;144;773
002844433086;1;100;141;137;97;145;620
060061184484;1;88;279;150;91;175;783
028723832135;1;208;192;176;101;63;740
065292677817;1;145;156;171;70;100;642
017501656454;1;248;153;264;50;103;818
078670779764;1;205;243;260;113;125;946
086761063351;1;110;130;142;91;137;610
071057825955;1;228;254;201;95;168;946
050217588498;1;258;127;111;96;56;648
081494036441;1;282;227;287;66;107;969
099060554341;1;121;263;237;74;152;847
086251098781;1;231;274;276;115;82;978
071220736943;1;246;118;137;118;168;787
079648608152;1;258;263;93;83;152;849
006830636330;1;116;88;105;55;62;426
018732147184;1;113;105;171;110;115;614
054255244868;1;268;191;121;112;124;816
085612389553;1;170;217;276;52;113;828
089155957794;1;102;268;194;108;116;788
066464521328;1;283;102;144;71;52;652
027354850673;1;121;183;180;116;120;720
038889615637;1;122;116;231;77;117;663
005457959459;1;252;179;162;63;83;739
013125232566;1;92;288;272;98;94;844
013130967132;1;287;141;243;98;90;859
099620790177;1;221;114;260;53;90;738
011942006466;1;139;131;107;109;170;656
031431170072;1;214;249;244;120;88;915
059694145084;1;272;157;205;70;143;847
003806199473;1;233;124;215;82;177;831
074466677331;1;155;196;224;86;114;775
017496887939;1;166;106;299;75;101;747
088259153388;1;236;242;195;58;114;845
059029636540;1;166;167;169;81;107;690
061780257093;1;292;230;122;104;176;924
008083369941;1;121;256;135;110;157;779
021500239868;1;255;187;293;116;57;908
019403039798;1;146;288;206;90;80;810
072202253604;1;253;262;136;89;171;911
062762895044;1;217;260;140;74;129;820
001400184553;1;201;272;224;83;158;938
038998212231;1;235;95;218;111;98;757
062585166622;1;199;244;117;93;144;797
081215740420;1;80;103;133;86;55;457
058267454527;1;255;236;123;101;121;836
039913289076;1;262;121;237;108;73;801
086322536175;1;160;187;269;99;55;770
060549949806;1;247;106;228;98;112;791
098172202753;1;284;274;117;103;85;863
074941880928;1;262;149;131;96;95;733
085044180815;1;159;252;254;84;58;807
069639049481;1;277;111;292;83;77;840
098490255768;1;85;256;169;75;130;715
050021529581;1;282;143;298;107;83;913
029487663679;1;175;195;280;110;87;847
082436118768;1;190;156;172;96;151;765
092288486299;1;111;252;274;108;159;904
020186857486;1;219;141;175;77;74;686
046772026989;1;271;285;142;91;96;885
057675044432;1;120;217;184;72;80;673
072046361203;1;133;93;271;104;102;703
043386401970;1;228;175;145;62;146;756
070058531210;1;188;119;240;65;107;719
004377164044;1;170;98;156;108;150;682
034713751299;1;229;220;117;55;65;686
071136753056;1;222;265;117;89;164;857
051815828165;1;172;286;123;104;143;828
004222097387;1;160;141;139;97;147;684
013425293402;1;128;184;204;52;177;745
041726072836;1;250;251;268;64;112;945
007575016287;1;150;150;158;117;100;675
088993999871;1;283;116;115;85;87;686
028179246161;1;250;174;288;80;130;922
067735721088;1;205;261;264;119;133;982
043829795277;1;199;103;293;113;148;856
062131473684;1;291;277;299;99;124;1090
086835604044;1;94;196;107;51;175;623
022056010893;1;292;172;204;107;144;919
057956793964;1;224;98;103;64;151;640
034770069936;1;248;108;251;76;96;779
066210392840;1;148;113;286;83;127;757
007177507536;1;102;170;207;51;162;692
095327438764;1;175;112;234;52;83;656
011837324323;1;107;262;175;77;88;709
004279611741;1;271;223;280;59;165;998
010431130573;1;162;222;126;109;135;754
064381836882;1;128;203;201;79;150;761
098802370806;1;189;174;206;54;117;740
090963913760;1;108;173;263;109;178;831
088415835389;1;188;274;181;83;162;888
021690695746;1;152;275;208;76;88;799
096469484262;1;122;183;91;117;70;583
044474678005;1;286;157;108;61;163;775
018460565109;1;186;195;188;64;128;761
078084569786;1;152;260;269;106;65;852
074761815997;1;123;146;110;73;172;624
098958853601;1;260;163;250;119;151;943
015768653603;1;194;102;113;57;92;558
058428285133;1;241;283;155;110;66;855
038821699990;1;183;228;259;76;127;873
055074763824;1;115;262;126;74;55;632
077721251548;1;185;177;100;82;102;646
093614339984;1;245;156;134;63;74;672
008033151848;1;82;162;110;86;60;500
005172400303;1;180;179;276;63;154;852
016810224047;1;188;124;294;51;124;781
040756299861;1;104;264;98;51;137;654
071374169608;1;183;179;152;119;140;773
028675064564;1;171;173;289;113;50;796
098978249099;1;231;226;247;101;74;879
077296937588;1;270;159;128;116;65;738
011835328863;1;239;147;254;72;128;840
051662853786;1;155;86;233;101;91;666
001997729080;1;292;197;212;108;71;880
047772456580;1;168;218;164;103;136;789
088727057374;1;291;173;202;57;157;880
049094931968;1;92;174;123;73;72;534
044846028403;1;221;242;102;93;158;816
005640232714;1;271;151;148;50;62;682
076138370856;1;171;175;254;51;55;706
073366921602;1;93;219;155;78;58;603
075945708355;1;234;128;94;52;178;686
042983505218;1;159;125;242;83;132;741
066936289293;1;164;180;287;94;128;853
084812884797;1;227;122;292;87;134;862
022513106800;1;163;158;191;65;82;659
080569405222;1;259;229;90;103;116;797
040574819281;1;286;264;230;117;109;1006
069573466778;1;83;148;127;81;133;572
027538552064;1;107;134;258;54;68;621
027228830168;1;118;122;130;80;53;503
051074335262;1;264;180;263;68;72;847
054491241403;1;100;264;136;50;151;701
094508138626;1;140;274;128;60;134;736
022592824401;1;281;226;158;115;153;933
000951342776;1;112;202;225;119;69;727
006890357303;1;118;135;172;52;170;647
050905811655;1;146;214;96;72;170;698
003622590511;1;235;281;230;105;53;904
085812445725;1;279;120;155;100;53;707
018832634722;1;149;283;220;106;126;884
061635356857;1;242;138;267;85;54;786
094741824049;1;292;111;175;81;166;825
041389532707;1;189;155;185;107;164;800
005638407701;1;255;122;127;83;75;662
034981233825;1;234;148;254;59;173;868
010773097920;1;119;268;131;93;58;669
092035722112;1;258;200;208;108;130;904
093355752299;1;231;95;164;76;50;616
041524024782;1;96;126;142;100;171;635
021223313815;1;237;195;182;79;77;770
001918149071;1;196;190;199;63;141;789
083815768257;1;210;153;192;99;66;720
061205821276;1;272;123;151;101;156;803
013722763831;1;271;179;180;84;63;777
097500326743;1;281;121;298;77;76;853
037454712819;1;142;237;265;112;175;931
069934127900;1;181;119;132;89;173;694
088036073399;1;262;205;272;69;98;906
025009733938;1;220;80;286;103;58;747
097062196548;1;146;224;229;96;50;745
076585074032;1;221;193;173;55;122;764
029504622354;1;90;110;197;102;163;662
075750789445;1;130;271;172;91;133;797
021332537995;1;201;109;269;60;106;745
041901578403;1;243;202;124;103;83;755
022824657596;1;222;227;214;95;90;848
004096844954;1;106;96;200;53;58;513
037177659192;1;166;146;203;76;130;721
057907744463;1;259;231;133;89;69;781
010674143296;1;230;185;248;50;83;796
065835960198;1;110;287;211;106;163;877
019546675831;1;148;101;195;92;125;661
022528506797;1;221;99;90;71;80;561
037687021416;1;285;134;122;64;159;764
084661899915;1;150;252;183;69;126;780
032238676123;1;247;163;159;108;102;779
076151335528;1;235;245;250;55;123;908
065753521717;1;280;202;120;113;158;873
088535713488;1;107;264;229;57;82;739
011011470944;1;247;174;199;115;80;815
027994566154;1;145;96;205;61;140;647
030771078957;1;207;231;130;97;73;738
079956894725;1;229;167;153;57;168;774
034969985677;1;148;214;236;76;98;772
091890945714;1;85;154;155;58;128;580
003491873724;1;172;108;289;61;119;749
072039128082;1;238;170;199;57;130;794
074097359100;1;211;86;199;68;123;687
018812048844;1;272;274;158;102;72;878
074552864413;1;144;237;174;101;65;721
078690725697;1;247;243;194;95;139;918
018497121883;1;102;275;120;85;148;730
088063221422;1;231;203;254;73;73;834
026961096333;1;278;212;165;104;171;930
055184174685;1;288;126;213;93;178;898
060354602981;1;201;107;254;82;148;792
012193547900;1;117;265;135;92;134;743
068078714394;1;120;184;268;73;72;717
082156893122;1;169;93;179;74;60;575
023518314737;1;95;173;197;75;171;711
010655427724;1;93;105;200;59;80;537
009885589914;1;200;144;172;63;149;728
029596600914;1;146;144;164;92;153;699
029819061303;1;276;251;289;97;98;1011
007585146175;1;182;141;116;92;96;627
028063028749;1;281;280;171;107;93;932
069198985340;1;194;127;297;101;110;829
074067834818;1;195;246;132;86;114;773
091665141502;1;92;127;218;65;151;653
071378183017;1;278;237;240;83;101;939
066438489787;1;270;283;110;120;165;948
011407776202;1;263;91;160;120;148;782
007725807199;1;115;207;298;111;155;886
083050988685;1;275;226;243;78;52;874
051819333078;1;185;98;152;70;59;564
002519883635;1;235;204;207;54;70;770
001317266695;1;174;167;102;117;96;656
096619063153;1;235;117;234;80;130;796
008043679969;1;228;115;268;110;61;782
050428806927;1;129;128;195;94;101;647
014009183878;1;114;147;281;79;150;771
030864086587;1;269;240;213;99;119;940
082157777191;1;153;230;219;107;172;881
025337401619;1;82;195;191;69;137;674
000465221734;1;94;142;204;67;149;656
037680891461;1;248;91;189;50;59;637
090983283205;1;215;199;206;84;161;865
061621224288;1;138;283;221;76;104;822
099305425939;1;276;127;245;62;166;876
077793247955;1;268;249;233;116;61;927
000032806460;1;242;129;172;55;135;733
037114515974;1;145;106;167;68;152;638
043980486027;1;151;103;176;103;158;691
049567569612;1;250;173;189;53;174;839
069118176268;1;120;266;232;94;129;841
046786616050;1;163;201;163;55;168;750
028750317788;1;81;179;299;83;110;752
027512860752;1;106;99;171;70;88;534
053162213400;1;261;191;155;112;74;793
076828465880;1;176;203;279;87;66;811
061937271013;1;196;91;116;63;128;594
072414245376;1;160;164;163;115;93;695
036840353983;1;87;210;270;85;106;758
061372540637;1;118;94;238;80;93;623
027601614531;1;251;241;112;64;58;726
074648848556;1;251;270;298;66;120;1005
002954610549;1;114;173;241;50;132;710
037204043843;1;102;118;240;67;131;658
091159060689;1;270;128;298;92;123;911
078633878681;1;96;247;102;109;61;615
026054574313;1;178;257;277;58;111;881
096405404583;1;216;154;243;71;160;844
016045534385;1;246;218;238;86;141;929
071283635971;1;155;142;148;79;135;659
079326145773;1;129;174;272;79;157;811
099254409931;1;288;128;97;96;88;697
022412915524;1;277;236;189;72;159;933
024466866806;1;258;221;113;93;176;861
093724921121;1;94;162;126;101;56;539
038151115139;1;265;157;165;117;70;774
006905146158;1;211;130;192;94;173;800
090886933244;1;253;286;140;58;112;849
096795052521;1;274;280;259;100;83;996
060562775830;1;129;119;296;87;65;696
042935302699;1;165;262;144;64;136;771
040524366544;1;237;201;121;109;73;741
004068437301;1;147;192;242;117;168;866
003390409966;1;156;158;269;98;65;746
056499372026;1;167;105;136;54;81;543
009686900304;1;286;162;108;115;112;783
026534739431;1;232;154;122;114;68;690
076780651027;1;278;208;266;65;132;949
003111061423;1;224;162;229;59;70;744
018634948120;1;150;118;233;93;113;707
085626567709;1;95;126;101;100;122;544
033562007209;1;163;279;234;81;61;818
089250818401;1;249;228;106;67;52;702
079463749569;1;270;267;149;115;64;865
054991561770;1;249;277;298;96;81;1001
059720167762;1;260;138;299;95;155;947
039614037080;1;207;125;143;118;69;662
048751822902;1;95;156;120;95;173;639
057197224082;1;288;283;94;73;102;840
023536448506;1;207;208;258;110;66;849
070059211498;1;97;238;285;119;81;820
056998919406;1;272;263;119;71;156;881
093943883921;1;136;242;139;77;142;736
087632671068;1;257;182;96;81;120;736
051807648063;1;153;184;122;108;111;678
091458513406;1;136;225;229;94;122;806
015614472194;1;208;201;107;98;73;687
076626562649;1;182;160;278;93;63;776
074864552731;1;110;151;151;66;166;644
046833359336;1;277;158;140;111;163;849
020407305233;1;274;175;185;104;64;802
081719327804;1;130;86;131;96;111;554
028522278522;1;82;120;115;105;104;526
002527487567;1;159;98;271;76;145;749
085030951589;1;161;269;241;53;140;864
007292131799;1;234;99;238;86;85;742
085764236694;1;187;253;200;80;171;891
079124965371;1;266;181;236;109;161;953
006120636676;1;203;263;212;88;115;881
065775111883;1;140;242;219;64;129;794
007526512157;1;290;102;150;71;70;683
050219916030;1;111;183;99;73;169;635
084419572695;1;161;155;288;70;173;847
015959816939;1;281;194;229;62;108;874
022814026927;1;194;142;227;55;77;695
005540190192;1;198;190;139;92;157;776
036697081306;1;211;271;118;58;76;734
057406384915;1;170;125;186;59;84;624
001734723763;1;123;276;176;60;126;761
095051246435;1;155;211;107;117;123;713
028799851153;1;155;262;174;80;130;801
006920977933;1;252;268;281;101;141;1043
007280754158;1;229;246;298;50;88;911
075139186367;1;241;82;293;87;104;807
099659434649;1;101;191;155;57;62;566
066401840101;1;200;245;117;63;63;688
001069440638;1;171;124;288;75;92;750
061156236452;1;147;277;277;62;164;927
033683063266;1;163;227;300;111;62;863
082678369325;1;135;234;168;50;143;730
091430621514;1;229;160;135;104;172;800
017042342628;1;277;203;270;112;62;924
080715250251;1;265;263;176;86;126;916
084410223755;1;183;89;248;94;145;759
094541124413;1;250;229;224;75;168;946
099134768148;1;183;131;221;118;123;776
015314946188;1;160;198;92;115;153;718
077482517802;1;115;158;122;77;63;535
067962063315;1;150;145;263;84;65;707
020999321780;1;264;162;192;60;169;847
051479395453;1;159;111;174;54;95;593
057807074366;1;100;185;108;75;127;595
033238952589;1;220;92;281;77;157;827
099927008319;1;170;246;146;56;79;697
064325607596;1;90;160;207;90;122;669
085229722770;1;146;223;186;90;157;802
062333397551;1;106;184;111;111;96;608
098537322602;1;95;208;122;89;84;598
031760967162;1;174;288;276;117;120;975
039385382809;1;186;227;257;77;118;865
052349457749;1;187;133;199;60;152;731
077727477065;1;144;116;131;91;110;592
054577749111;1;193;96;120;87;119;615
043315375606;1;221;167;273;108;174;943
082193000416;1;120;107;249;88;169;733
038350873924;1;150;281;178;101;88;798
046456210438;1;227;144;123;109;141;744
051425893957;1;83;221;200;66;156;726
059020619959;1;95;257;135;93;111;691
081474442852;1;123;196;232;68;54;673
086000157523;1;119;252;211;117;76;775
089109219259;1;229;259;102;74;129;793
061053691794;1;220;81;124;68;54;547
026164808431;1;180;171;252;68;170;841
017346780587;1;89;184;190;96;109;668
028622350172;1;106;246;157;79;164;752
034923110854;1;229;142;262;79;164;876
051237783235;1;207;180;191;96;158;832
083103971874;1;206;190;261;71;153;881
076966743555;1;118;230;287;115;61;811
084042122619;1;198;108;115;52;136;609
013822423416;1;212;179;235;109;119;854
024323652817;1;131;111;108;67;112;529
033103765707;1;206;203;167;65;134;775
081408153095;1;228;181;257;106;151;923
049986865468;1;157;109;107;67;87;527
006941094207;1;277;253;137;97;121;885
019963919321;1;264;179;125;51;96;715
069460404522;1;132;162;231;78;115;718
097869297168;1;266;164;164;95;175;864
028420394726;1;107;257;113;52;56;585
098719439394;1;184;281;166;88;96;815
019274570458;1;122;105;100;74;152;553
027320668034;1;114;169;138;56;125;602
011047822856;1;219;208;149;64;144;784
039884166176;1;163;168;225;71;88;715
085048896741;1;118;216;173;95;89;691
018394938009;1;166;190;207;88;76;727
035465645316;1;270;200;208;90;68;836
051203969452;1;190;112;162;68;167;699
032428925985;1;112;191;238;64;138;743
009796058689;1;134;143;166;82;51;576
027261909723;1;131;233;289;77;86;816
043558184772;1;137;244;196;51;130;758
021444597055;1;92;203;250;65;163;773
008981770492;1;207;203;155;55;55;675
087097657445;1;288;180;109;93;96;766
047438173662;1;147;120;187;110;56;620
021662306811;1;245;219;160;61;55;740
030231366912;1;278;98;217;86;105;784
009164206716;1;137;106;267;87;82;679
077989071310;1;152;92;281;59;110;694
064079071133;1;100;127;246;69;61;603
060120582747;1;180;157;207;95;176;815
008681622447;1;193;194;294;94;160;935
033383793758;1;290;215;245;87;52;889
006679453711;1;164;111;124;59;69;527
002138234316;1;172;238;203;58;88;759
002522630165;1;200;169;269;93;131;862
044142715920;1;238;124;288;97;112;859
068694875319;1;140;225;137;83;142;727
093434144362;1;234;143;235;62;66;740
089076330597;1;273;266;242;93;60;934
052637180675;1;89;168;213;89;63;622
045633212240;1;166;246;137;54;161;764
026064308761;1;214;131;247;62;111;765
042971990856;1;249;185;158;114;111;817
018287522904;1;231;134;115;76;51;607
009622208821;1;116;122;207;53;168;666
005900528070;1;194;187;155;80;149;765
062506363363;1;154;212;117;56;117;656
052504652559;1;151;210;285;64;125;835
001342556060;1;276;149;299;97;129;950
002193154707;1;179;139;241;118;67;744
059595098846;1;152;142;167;54;174;689
061401295620;1;291;123;163;107;86;770
077711490412;1;103;109;297;86;149;744
051071028129;1;197;166;153;112;154;782
095973912060;1;218;181;140;60;154;753
043915940821;1;192;284;273;100;124;973
040693765520;1;171;229;129;106;165;800
071770185683;1;275;87;184;111;140;797
086973211759;1;176;207;145;78;127;733
047861964579;1;289;224;237;113;134;997
059818162470;1;177;197;196;62;78;710
046053437600;1;151;237;172;52;62;674
036797873696;1;252;163;212;102;64;793
032740402837;1;226;147;193;71;140;777
038485032687;1;189;206;165;83;53;696
024838177879;1;221;197;121;83;101;723
070587872615;1;253;269;261;98;66;947
060701791230;1;98;186;122;58;59;523
037307816073;1;208;257;264;85;77;891
025513265405;1;290;265;202;89;106;952
040981510570;1;168;194;257;96;127;842
028367023281;1;231;258;123;92;118;822
039435782684;1;141;198;182;57;155;733
063650512375;1;87;98;181;107;146;619
034911657612;1;103;223;199;51;58;634
079602778544;1;273;247;252;112;131;1015
019110832991;1;237;138;204;72;150;801
015358079849;1;240;91;128;93;165;717
055192278825;1;88;151;194;84;63;580
031592022638;1;157;188;296;75;104;820
012126159830;1;226;278;223;100;110;937
034951066032;1;105;154;146;89;104;598
074841092289;1;227;272;114;106;143;862
025509967668;1;121;213;205;102;158;799
054784666736;1;283;138;186;93;57;757
079657092953;1;170;178;219;50;164;781
086536461108;1;222;140;124;59;129;674
062927663119;1;189;206;270;100;115;880
096793915232;1;226;257;127;50;84;744
093441692290;1;289;194;197;73;138;891
010355543274;1;269;207;258;61;100;895
014045403343;1;158;186;124;78;63;609
044306792586;1;188;179;218;79;137;801
073418845120;1;278;122;284;116;63;863
055163022772;1;139;156;208;89;69;661
017693581688;1;177;158;204;77;58;674
098683835844;1;177;118;166;92;166;719
067050379430;1;193;275;221;73;72;834
056725998111;1;184;135;198;110;168;795
080549233813;1;223;234;148;66;145;816
041457268900;1;135;225;247;108;55;770
040207752961;1;227;159;261;90;95;832
081242862060;1;214;273;288;118;52;945
005078245912;1;87;167;226;65;103;648
033260223832;1;162;219;287;91;150;909
006931812106;1;158;177;214;69;65;683
038797834118;1;193;96;276;61;131;757
083265999909;1;289;205;246;79;84;903
079766253676;1;259;208;196;84;147;894
043297114550;1;244;231;148;61;93;777
063268451171;1;105;128;281;75;162;751
061469766939;1;131;266;245;68;74;784
020371047830;1;175;134;132;51;60;552
037899601197;1;273;228;170;54;55;780
055762594777;1;153;271;153;84;62;723
052844560615;1;289;266;247;112;131;1045
062139004260;1;114;286;154;96;152;802
050173510407;1;219;168;282;113;80;862
005096518423;1;212;224;130;84;153;803
023546036177;1;122;267;255;94;63;801
010565025152;1;127;152;95;77;84;535
043374264447;1;92;260;194;56;121;723
033184653104;1;288;182;212;119;57;858
053405777052;1;270;168;114;91;95;738
002504606141;1;160;80;169;85;128;622
096285801576;1;215;180;136;86;158;775
088388482998;1;80;287;142;97;177;783
066196167242;1;134;148;125;107;161;675
073283062118;1;166;142;203;50;120;681
063272303450;1;130;230;227;99;171;857
043971373067;1;274;167;138;112;138;829
041243815389;1;157;241;161;82;83;724
052691150826;1;189;184;245;103;87;808
051011560826;1;144;254;205;120;125;848
022242053467;1;214;149;180;98;120;761
096145467068;1;193;136;256;75;68;728
092586141182;1;180;86;202;101;71;640
082022728426;1;285;152;156;50;95;738
073163727394;1;242;83;136;94;144;699
080095713375;1;124;167;106;59;144;600
039909871415;1;281;95;190;62;78;706
070582355311;1;280;277;121;112;135;925
014199974121;1;124;261;279;78;130;872
055183007760;1;281;134;206;90;134;845
034973962961;1;154;97;169;74;168;662
091813587454;1;204;287;129;110;95;825
081500631139;1;277;245;211;88;65;886
082226149366;1;182;88;252;95;62;679
088254218678;1;96;90;119;53;104;462
029835984770;1;182;165;116;61;136;660
061223004403;1;240;244;236;71;87;878
026962952296;1;195;253;249;81;174;952
006804595912;1;155;161;245;105;57;723
015319577565;1;95;184;131;67;113;590
016804058756;1;235;186;205;84;174;884
029745622865;1;124;96;267;95;58;640
074954837314;1;220;93;161;93;143;710
011241451407;1;88;266;100;107;139;700
026818877410;1;278;120;170;93;134;795
046058041153;1;219;101;158;98;90;666
061705265696;1;276;111;200;100;131;818
010487570976;1;80;267;219;115;176;857
014643150330;1;99;141;213;97;136;686
024237735931;1;164;211;228;96;160;859
055625032278;1;276;283;253;120;158;1090
024473980040;1;111;196;185;55;122;669
038320984541;1;196;179;179;51;143;748
052368648322;1;288;157;228;50;110;833
062681929685;1;176;271;136;92;58;733
057186819855;1;110;136;204;58;98;606
012362867040;1;116;267;275;73;99;830
052301862912;1;95;117;141;85;140;578
026174106615;1;232;134;105;88;58;617
055735493187;1;171;198;93;89;111;662
025579125426;1;181;133;231;100;174;819
083253499501;1;160;263;274;81;114;892
014941821709;1;257;100;117;84;138;696
036128720107;1;143;261;245;105;178;932
014175808583;1;159;204;175;102;159;799
047676455113;1;129;237;218;50;52;686
032737604133;1;105;227;130;79;108;649
023929498478;1;218;237;103;106;60;724
070731190403;1;165;285;100;116;81;747
050142682992;1;136;228;180;74;120;738
014812364598;1;125;148;238;108;136;755
071251219644;1;205;284;146;75;85;795
059425019291;1;169;120;171;92;89;641
001903725246;1;290;177;220;106;85;878
022518527411;1;197;214;283;62;159;915
003715183145;1;117;283;249;96;92;837
098253063172;1;126;238;111;75;168;718
019416956209;1;162;192;252;66;58;730
078343593891;1;120;98;172;110;166;666
050784795162;1;268;125;229;109;53;784
014505531681;1;156;202;249;52;174;833
057743431000;1;97;214;213;68;53;645
022109254492;1;122;276;150;67;176;791
037788667505;1;223;221;244;67;123;878
072143824837;1;222;275;115;110;160;882
066176645625;1;239;280;232;76;171;998
007742335388;1;211;187;210;66;114;788
063876750679;1;268;94;158;99;111;730
030319469946;1;233;247;268;75;134;957
006973621987;1;166;224;292;58;126;866
086017251988;1;270;257;211;94;103;935
053087782056;1;290;203;276;85;92;946
051316452155;1;231;278;197;105;51;862
039611484116;1;159;281;215;120;79;854
032527361335;1;174;170;290;80;111;825
036804032181;1;219;276;231;120;162;1008
033444963227;1;218;260;125;119;124;846
053525885806;1;120;140;145;74;155;634
087308861179;1;127;101;209;109;171;717
057748782306;1;147;133;135;71;117;603
034091099087;1;209;208;119;63;104;703
029183985375;1;206;168;157;87;80;698
080038490520;1;184;233;95;65;170;747
074827226356;1;255;134;183;63;151;786
053934029124;1;249;203;168;63;158;841
067970532950;1;259;166;222;56;76;779
035393290452;1;90;136;175;76;132;609
007936505765;1;112;199;186;72;145;714
043397014356;1;187;244;270;70;71;842
097727014220;1;125;288;291;65;59;828
077422006540;1;182;260;166;60;129;797
066480033950;1;168;150;217;95;90;720
038236147025;1;265;200;259;119;88;931
000944856779;1;169;152;148;84;159;712
020131454361;1;102;209;130;82;156;679
086562605189;1;202;95;116;58;113;584
020441439323;1;192;98;160;107;71;628
000097211509;1;126;237;135;58;96;652
035598800138;1;215;174;278;105;131;903
016088613729;1;212;141;194;62;169;778
099190863760;1;251;142;99;58;168;718
016952621792;1;117;146;261;62;71;657
079733912329;1;255;139;98;97;150;739
068119301596;1;246;216;150;57;114;783
033446822430;1;134;223;134;88;130;709
058681931404;1;217;186;255;105;58;821
099850204248;1;158;257;140;96;104;755
046359067392;1;214;259;142;99;139;853
021621230525;1;247;225;198;109;58;837
066328863255;1;277;106;156;73;126;738
041543679896;1;232;117;269;111;134;863
024809252162;1;109;229;196;50;55;639
024194259246;1;245;262;298;58;112;975
052866379647;1;269;243;134;95;128;869
029318831520;1;87;226;120;87;178;698
051971625329;1;172;236;177;76;80;741
085506430827;1;270;245;156;96;127;894
021088281009;1;87;138;211;96;138;670
012229542750;1;221;235;104;72;167;799
040585137126;1;197;175;218;96;153;839
013688563957;1;255;80;109;73;175;692
064243890760;1;107;84;298;105;85;679
006051749575;1;212;215;133;79;153;792
022499476097;1;93;239;98;81;113;624
073646124226;1;288;109;257;77;170;901
008648328103;1;156;285;219;100;102;862
009488071027;1;152;230;156;53;52;643
084894314296;1;153;98;216;51;173;691
076487582688;1;249;192;101;108;56;706
019888785028;1;211;142;119;53;136;661
077699859876;1;205;190;115;95;143;748
051944842445;1;278;227;117;64;85;771
004591795272;1;287;228;199;74;54;842
093443039098;1;242;148;143;54;145;732
068569487481;1;97;116;169;70;128;580
057906383234;1;280;159;147;115;149;850
062068105120;1;82;222;118;53;129;604
026521479198;1;149;255;291;56;177;928
063969890690;1;231;149;183;59;120;742
012704968323;1;260;208;240;77;57;842
051305514518;1;234;170;110;60;139;713
044649445348;1;222;197;91;107;108;725
007036520628;1;150;166;100;74;126;616
025119352689;1;141;124;264;75;102;706
047175231137;1;240;253;113;79;69;754
018171731154;1;203;180;290;114;140;927
096227611377;1;164;150;143;85;87;629
082182675315;1;97;115;95;90;115;512
073935320881;1;261;140;105;113;157;776
016952658071;1;178;181;276;110;51;796
075175072025;1;285;151;222;60;91;809
008606404101;1;93;181;205;111;104;694
059990876489;1;253;234;176;83;146;892
054740792261;1;91;211;190;96;68;656
044119345123;1;269;288;200;102;65;924
085954860769;1;224;242;170;116;165;917
073828207198;1;82;112;220;76;131;621
025514429988;1;217;180;101;60;62;620
070054219479;1;160;88;217;117;71;653
033460893005;1;248;91;104;85;87;615
037490078007;1;138;138;273;79;153;781
056861089160;1;247;243;243;119;55;907
082406780424;1;197;116;90;120;56;579
032694662347;1;255;149;281;68;58;811
033909280318;1;199;136;214;106;109;764
099986362115;1;98;243;286;91;119;837
037049725749;1;227;137;224;71;62;721
088398746727;1;133;120;186;107;101;647
073092880097;1;160;274;269;91;52;846
057754755325;1;219;164;264;99;98;844
091653560316;1;178;249;185;57;116;785
051093979608;1;216;97;247;91;101;752
039562359972;1;118;161;283;102;84;748
054196913328;1;289;143;270;91;76;869
007932635798;1;142;207;233;112;110;804
075730330834;1;80;130;120;113;94;537
050614678568;1;292;154;115;73;91;725
063195126735;1;124;131;221;118;146;740
052486249064;1;268;240;219;100;75;902
025258541676;1;101;282;263;89;173;908
050148194906;1;292;141;221;110;153;917
076857916011;1;207;177;115;51;135;685
066872048946;1;123;235;255;59;58;730
092551792483;1;165;258;209;114;63;809
033787896445;1;253;82;215;54;143;747
092377410730;1;168;227;123;66;166;750
071332814698;1;84;184;228;100;147;743
032830224866;1;190;255;234;111;66;856
051899975376;1;217;213;94;84;153;761
065634655384;1;180;263;127;51;155;776
084308590880;1;249;257;270;116;175;1067
013943949980;1;145;223;90;51;172;681
080654629192;1;130;121;291;52;58;652
089013565121;1;282;190;273;68;143;956
032137392620;1;152;163;90;93;127;625
017301542017;1;240;160;213;66;62;741
090766288996;1;288;184;130;82;130;814
073151688625;1;187;82;280;119;103;771
091123887066;1;142;97;97;94;94;524
001250594342;1;127;105;175;103;90;600
032182388551;1;133;272;117;53;174;749
080051848843;1;206;111;207;74;135;733
047612750435;1;158;191;171;55;118;693
022346093017;1;159;145;160;74;150;688
089300405440;1;106;264;268;99;78;815
086726676952;1;101;190;95;64;108;558
009075287723;1;134;130;263;113;174;814
042456332171;1;109;92;186;74;138;599
011656974843;1;121;255;188;119;144;827
076502956033;1;269;271;226;105;153;1024
081201881858;1;226;246;135;66;127;800
096496779559;1;212;156;102;97;95;662
081743017072;1;220;200;147;115;161;843
064400649914;1;240;173;151;95;63;722
023474893515;1;99;254;169;106;57;685
040437931329;1;230;160;259;120;162;931
003012931396;1;102;228;124;101;83;638
025701545200;1;134;82;148;87;133;584
062830610541;1;157;96;240;56;153;702
067100926854;1;275;121;117;95;147;755
007532296603;1;147;85;251;92;116;691
041700802652;1;288;212;159;87;94;840
079472535329;1;210;241;92;93;51;687
014397201021;1;287;186;270;61;164;968
018064379722;1;90;189;288;78;60;705
022501629496;1;213;163;234;107;139;856
034938651297;1;243;240;97;63;119;762
079227812109;1;188;227;157;109;163;844
047287308937;1;130;235;115;66;105;651
030671973837;1;244;192;246;75;144;901
038963948603;1;161;218;108;80;86;653
086730614958;1;261;189;143;69;77;739
045021465827;1;224;119;228;80;152;803
038572321363;1;279;201;96;105;105;786
075433237861;1;145;80;202;82;125;634
063811916153;1;192;97;287;68;102;746
034983692827;1;152;276;195;87;178;888
002972559441;1;120;178;119;66;70;553
035930623130;1;174;100;205;59;51;589
042819875042;1;147;136;99;89;98;569
013848650367;1;111;189;140;68;78;586
083066242812;1;103;98;207;109;137;654
039302407010;1;199;167;193;82;79;720
078564715911;1;162;218;250;52;58;740
058333596895;1;274;113;273;56;173;889
097652593273;1;179;229;132;96;68;704
068778886132;1;146;138;211;63;65;623
093168204614;1;213;149;120;108;128;718
094626276885;1;247;153;250;97;116;863
041339005566;1;161;196;287;58;96;798
080028874596;1;177;176;150;117;81;701
045783302496;1;251;179;239;96;164;929
053331540534;1;129;179;106;98;52;564
062435294887;1;176;218;164;69;97;724
076664458715;1;175;207;187;61;101;731
047108571264;1;252;80;293;93;134;852
081797134305;1;126;162;117;94;62;561
045488310107;1;123;266;164;115;164;832
009837660458;1;99;195;121;52;64;531
032843870036;1;231;164;285;102;120;902
028818748635;1;148;249;139;50;177;763
027902159913;1;146;249;146;72;67;680
052274604872;1;190;121;231;99;131;772
022152497873;1;285;224;262;115;159;1045
079795268627;1;287;267;187;82;85;908
088761531739;1;217;136;140;73;152;718
062835192024;1;141;123;121;96;89;570
081783362119;1;280;200;248;116;107;951
045093623120;1;192;283;154;120;151;900
055916781905;1;106;200;106;120;116;648
092066057229;1;276;201;299;120;167;1063
001426872094;1;154;116;133;85;74;562
050392488137;1;238;94;241;85;151;809
007263232763;1;273;167;154;68;84;746
047820176155;1;128;151;110;54;145;588
015597129464;1;130;117;233;113;144;737
015201844816;1;289;149;168;88;61;755
051367493754;1;122;154;261;108;161;806
081367284206;1;198;170;103;54;51;576
068823765041;1;137;237;273;79;115;841
090910814938;1;283;280;246;116;169;1094
094366898342;1;234;102;208;55;130;729
084658250679;1;248;121;183;94;101;747
095959163687;1;164;129;97;63;146;599
015856819320;1;194;248;280;102;139;963
070925332559;1;239;258;113;90;87;787
079890351279;1;94;166;158;54;121;593
091336745089;1;178;116;144;83;119;640
072429590279;1;259;244;183;50;59;795
079101506925;1;98;235;297;93;108;831
071477459557;1;86;131;233;97;129;676
081375528787;1;154;156;268;75;160;813
017975502792;1;143;285;206;50;135;819
052426286544;1;149;278;111;75;96;709
025168795444;1;284;158;123;55;172;792
091961570930;1;283;225;267;102;150;1027
094008020526;1;129;82;139;88;151;589
000713059650;1;244;228;220;101;175;968
065324027323;1;205;239;191;110;85;830
059511317889;1;223;188;111;66;161;749
092347330570;1;128;276;298;120;63;885
036853439375;1;274;97;199;119;122;811
060521718210;1;272;246;253;79;120;970
083526005285;1;284;113;271;112;66;846
060200824219;1;254;96;164;78;87;679
053003583884;1;120;257;277;57;139;850
072032952692;1;240;217;234;72;156;919
093299450038;1;183;130;160;120;124;717
044294383081;1;259;115;124;66;69;633
048316832812;1;84;271;250;95;178;878
087921476152;1;270;185;116;103;52;726
039710081409;1;207;137;124;53;129;650
033507748519;1;80;138;271;70;74;633
076132815607;1;241;122;165;72;133;733
068052402800;1;218;262;240;72;120;912
017531790805;1;276;152;292;120;163;1003
087106777840;1;114;264;258;107;175;918
033866256498;1;129;165;207;112;174;787
021879892573;1;260;215;164;87;136;862
007491913093;1;265;217;281;110;108;981
020094491575;1;210;81;251;63;173;778
092472550276;1;163;183;224;93;110;773
041340586073;1;274;138;156;57;170;795
002241212065;1;232;111;193;75;77;688
093307895285;1;96;129;227;53;75;580
013901589317;1;91;119;203;112;157;682
084279123000;1;230;231;204;61;128;854
087534082763;1;154;175;135;120;143;727
071865852392;1;124;229;118;104;172;747
013474650434;1;183;135;261;50;151;780
063926824193;1;119;188;215;58;75;655
033791251140;1;196;275;229;78;89;867
065117149141;1;286;92;178;102;154;812
026435115340;1;83;168;209;102;115;677
010956472107;1;239;277;181;58;103;858
063154170070;1;189;216;138;80;129;752
068269646486;1;153;176;170;68;55;622
087275122343;1;235;150;247;88;151;871
016122213078;1;143;93;250;106;83;675
039596276128;1;160;203;216;69;143;791
009470649451;1;152;186;123;85;71;617
076541568168;1;274;145;275;115;75;884
085560059765;1;233;102;109;69;167;680
081764278422;1;237;181;118;89;106;731
050036474975;1;211;87;270;117;164;849
054927276692;1;252;240;185;85;105;867
040888141378;1;277;262;281;87;62;969
040565359547;1;111;286;295;60;82;834
067278479294;1;266;93;201;60;59;679
093116278601;1;190;269;232;80;170;941
051109604949;1;150;195;204;66;81;696
047296010486;1;274;269;253;75;127;998
016683647252;1;133;252;300;51;135;871
027744521854;1;166;252;274;74;126;892
000105989001;1;288;191;94;74;93;740
029066631005;1;98;82;232;95;145;652
091322538821;1;232;262;178;63;85;820
012394132368;1;283;197;272;104;70;926
042273168250;1;145;186;132;108;83;654
075166517302;1;86;147;121;53;74;481
058720705801;1;228;125;153;95;56;657
093454094576;1;193;156;179;53;126;707
063336762076;1;191;211;254;52;160;868
073940422823;1;237;266;100;95;87;785
051999650340;1;150;117;242;88;152;749
066521973778;1;99;230;253;116;111;809
010342078548;1;239;220;165;117;165;906
079210595645;1;211;212;212;110;61;806
087996115167;1;118;88;199;70;82;557
025724240752;1;144;128;257;52;87;668
002601029162;1;183;196;270;74;173;896
074520971577;1;126;130;298;97;64;715
097487240947;1;226;287;104;63;92;772
050884202035;1;252;256;194;53;142;897
015668393033;1;220;148;138;74;64;644
010967147434;1;210;185;243;113;137;888
030319902184;1;259;226;245;65;109;904
094155344876;1;206;256;194;72;86;814
071150351854;1;82;172;268;92;104;718
061921002000;1;132;250;238;54;136;810
078187742786;1;182;229;153;103;68;735
084137557774;1;192;157;268;95;175;887
058047333605;1;203;284;274;76;107;944
036251779165;1;158;180;93;119;166;716
072295001025;1;193;121;137;63;63;577
078591760507;1;89;181;223;120;97;710
081650828877;1;195;255;106;62;85;703
018140153515;1;256;204;120;109;102;791
073015565817;1;108;175;247;84;169;783
087900844337;1;205;145;125;88;111;674
023988769474;1;250;283;251;108;163;1055
021743480101;1;188;83;215;108;141;735
027784347882;1;276;175;151;94;127;823
057283997323;1;202;135;238;91;119;785
080754037772;1;209;170;99;52;108;638
079102549327;1;257;229;174;84;129;873
007917291249;1;230;229;207;117;146;929
031099403302;1;216;176;180;80;120;772
052863895659;1;235;179;217;79;161;871
030162869791;1;257;95;157;115;154;778
083566580970;1;243;264;176;69;176;928
036703213523;1;105;257;223;56;132;773
077364481611;1;277;237;194;57;128;893
019453072277;1;89;280;142;105;116;732
083880636629;1;245;288;177;100;171;981
072466082332;1;181;160;243;92;83;759
040661073576;1;118;196;188;86;109;697
064827485623;1;136;194;168;83;131;712
093320773744;1;191;152;190;70;143;746
063963565354;1;234;276;168;116;102;896
000677422474;1;202;243;139;109;67;760
087527264899;1;238;136;215;72;175;836
043011544462;1;136;198;157;110;154;755
092168400150;1;217;212;97;108;110;744
072141615634;1;103;263;113;118;139;736
039028227119;1;186;115;90;75;154;620
084453016652;1;121;219;94;117;73;624
015231058870;1;178;182;223;54;71;708
018230374807;1;184;276;211;61;129;861
084235478227;1;87;244;158;85;165;739
066057326434;1;109;228;211;62;91;701
051900367114;1;185;189;170;57;136;737
021670938863;1;168;165;296;73;165;867
099266708228;1;81;158;207;76;121;643
028772456899;1;105;130;223;54;156;668
015626621574;1;290;82;285;51;177;885
028709472434;1;148;182;216;117;70;733
030510053825;1;216;212;150;74;91;743
022115158093;1;139;86;236;89;142;692
057190387160;1;129;170;137;77;169;682
010816709609;1;194;146;152;107;86;685
051048606521;1;219;280;221;103;122;945
030956412798;1;163;110;274;89;61;697
059432759959;1;211;144;209;90;95;749
005867661309;1;202;81;200;104;97;684
060360786586;1;103;179;260;116;126;784
047688182912;1;244;178;110;120;50;702
045173223669;1;131;160;138;85;71;585
002362791757;1;147;128;243;74;109;701
083932927552;1;94;145;111;92;169;611
079460995293;1;254;123;184;57;172;790
021142528809;1;148;252;284;107;143;934
019750690018;1;120;188;242;84;146;780
054690360322;1;249;199;260;106;154;968
039269164639;1;187;236;278;93;126;920
074765801789;1;122;191;102;65;119;599
020433798735;1;192;109;161;63;134;659
061373836454;1;213;93;139;50;141;636
071785595038;1;151;93;289;83;167;783
050451548148;1;86;221;225;117;141;790
026588485730;1;157;278;96;103;145;779
003099609144;1;287;228;147;111;153;926
051325800493;1;278;221;199;96;56;850
098656538207;1;290;195;298;68;138;989
016695856499;1;226;85;101;75;137;624
015038410334;1;186;174;140;57;61;618
017064737511;1;166;277;242;119;136;940
045891665631;1;134;263;286;65;122;870
026599721636;1;206;277;294;81;59;917
051188257159;1;163;228;123;92;151;757
099211068586;1;147;166;249;84;136;782
044429209134;1;150;231;270;116;74;841
034321347932;1;279;272;152;65;150;918
095304814905;1;117;99;291;90;50;647
094358630215;1;106;192;196;113;78;685
069839798924;1;231;209;257;73;170;940
005721830595;1;81;161;153;66;177;638
062322656820;1;101;173;262;67;173;776
010915812140;1;247;236;266;55;123;927
034086109136;1;164;134;232;53;105;688
037465055938;1;155;255;204;92;114;820
074883679382;1;104;205;151;64;110;634
034101328740;1;136;196;99;71;158;660
038076397454;1;121;284;276;101;64;846
038701483890;1;127;124;158;107;167;683
051714436945;1;82;203;199;95;92;671
083879101812;1;238;220;280;56;85;879
003151326279;1;184;138;208;84;68;682
049772366745;1;141;271;103;60;174;749
045639453809;1;148;98;120;74;161;601
067955066176;1;161;220;131;56;58;626
038172851128;1;237;276;152;69;95;829
029065427929;1;167;164;172;53;63;619
034952973261;1;135;128;225;50;80;618
057923687356;1;198;248;150;68;138;802
071553370240;1;132;215;171;87;100;705
042270754554;1;146;229;255;83;125;838
009137054735;1;150;238;126;101;172;787
018213290336;1;276;287;193;60;123;939
010998814793;1;147;283;264;97;147;938
002222397089;1;218;237;142;90;73;760
034120114828;1;250;253;223;77;57;860
059560692400;1;108;101;186;100;72;567
066348588805;1;191;125;125;51;141;633
024378158441;1;94;262;261;80;165;862
092539918465;1;239;117;132;62;155;705
043760728368;1;147;149;253;102;102;753
051616358129;1;208;111;229;90;125;763
000141778112;1;102;222;179;71;62;636
057592133713;1;173;232;179;57;87;728
010480767911;1;202;244;174;72;109;801
012887611961;1;201;230;288;91;168;978
088867908101;1;200;106;220;55;151;732
029679442805;1;255;198;202;117;86;858
087315832885;1;196;285;190;106;125;902
089840769772;1;141;267;285;93;144;930
091331127727;1;234;131;116;113;168;762
091032297062;1;279;111;186;54;71;701
070275199419;1;153;269;159;102;161;844
069638981312;1;125;227;227;65;137;781
084231812036;1;180;138;96;59;88;561
077404812560;1;107;226;124;55;178;690
074175202250;1;271;279;141;119;133;943
060971343619;1;243;85;299;73;53;753
072026926858;1;128;245;183;103;124;783
093384435446;1;229;163;226;82;62;762
051109377949;1;120;187;249;82;56;694
070478420891;1;276;90;100;52;119;637
093388183350;1;172;271;108;108;170;829
059013978111;1;123;260;264;73;62;782
031217635809;1;180;188;235;119;58;780
086364106711;1;218;173;282;91;99;863
036006253645;1;160;122;273;78;172;805
067646255977;1;259;167;196;90;118;830
039063003726;1;137;164;219;119;144;783
091973471912;1;129;125;184;108;147;693
073942460540;1;130;187;293;76;120;806
034201608363;1;102;166;241;106;172;787
023167479194;1;145;202;272;82;168;869
065456711750;1;231;187;288;55;52;813
074865319745;1;126;113;298;78;105;720
048460666518;1;272;221;295;71;117;976
048295255227;1;174;84;104;54;73;489
021613219938;1;108;171;142;96;109;626
013505525339;1;254;141;277;90;176;938
050564568821;1;195;206;216;57;105;779
075121571232;1;241;114;175;76;136;742
021462490122;1;152;184;265;116;69;786
041513045271;1;242;166;145;50;75;678
035990511971;1;220;158;182;80;50;690
091924199457;1;100;248;253;58;136;795
020343154386;1;270;214;215;86;90;875
087016925048;1;265;203;177;114;102;861
026266711945;1;226;208;160;115;151;860
052285947359;1;249;232;299;109;139;1028
013557236460;1;111;222;143;53;157;686
038806283791;1;137;132;300;54;53;676
090399552012;1;190;225;176;103;101;795
017975865268;1;170;190;90;79;94;623
054074935134;1;259;86;268;73;99;785
018051688470;1;266;138;287;76;64;831
039128295683;1;275;218;295;80;171;1039
044628970365;1;152;263;108;76;111;710
097611126793;1;150;202;137;84;98;671
066891462172;1;176;106;138;108;138;666
092614696109;1;216;159;237;98;69;779
038252555786;1;89;284;108;66;165;712
050325268890;1;196;99;180;111;92;678
000346894411;1;86;154;265;71;69;645
081665742609;1;188;87;100;102;113;590
038250268331;1;92;186;95;100;51;524
087535926075;1;220;188;209;91;139;847
045053871874;1;128;194;248;54;113;737
048791568752;1;243;195;247;65;107;857
079729637585;1;123;217;128;103;174;745
071406420300;1;271;199;298;54;117;939
046707107607;1;180;120;219;74;175;768
078963951535;1;276;112;127;98;139;752
071695038829;1;147;152;234;106;67;706
078904996662;1;197;234;232;113;76;852
078527460306;1;272;183;224;93;110;882
078658605917;1;237;81;158;111;85;672
092169831527;1;110;198;154;66;149;677
080013337872;1;122;139;220;75;66;622
086421859904;1;252;120;211;57;84;724
009775665993;1;88;256;125;81;174;724
020871420649;1;105;165;92;52;69;483
020022483001;1;256;237;91;81;147;812
053094541273;1;158;275;142;65;72;712
085117055910;1;153;121;166;119;158;717
024727782027;1;146;224;209;115;70;764
027775583293;1;243;112;263;65;136;819
067473802734;1;154;257;286;66;122;885
016401080808;1;289;252;192;69;118;920
081583990305;1;81;275;101;53;169;679
054875385428;1;113;188;120;92;112;625
038974310033;1;128;259;114;107;133;741
057294589529;1;274;285;125;110;62;856
041610094472;1;252;194;274;71;67;858
024380407976;1;242;285;190;115;157;989
022271216501;1;161;206;206;81;107;761
040342095230;1;158;248;264;118;152;940
032319482646;1;262;113;182;91;102;750
024953997618;1;178;89;285;113;109;774
066435846577;1;205;206;155;105;96;767
069221508929;1;143;262;246;61;103;815
039598929802;1;106;120;215;119;82;642
075075524887;1;193;140;145;84;115;677
097755753991;1;132;216;284;102;177;911
066648236401;1;237;278;227;80;66;888
050104673010;1;147;259;174;106;122;808
013853142252;1;225;250;200;84;128;887
075285134417;1;262;150;111;89;116;728
057417647791;1;111;183;279;119;124;816
056519373400;1;96;183;137;86;100;602
010897104510;1;126;98;204;84;147;659
064813495170;1;111;279;100;58;148;696
047551299020;1;233;95;151;80;169;728
028208788935;1;178;247;221;115;173;934
082142279704;1;283;285;277;118;170;1133
074164287700;1;278;244;280;102;157;1061
028971236605;1;120;155;298;75;65;713
049137972009;1;239;160;269;116;55;839
089971062647;1;274;275;198;50;108;905
066258136048;1;205;185;187;70;91;738
005091431423;1;200;167;270;51;63;751
019435944719;1;190;254;176;116;153;889
053934459729;1;265;139;129;104;95;732
080911855704;1;284;243;224;58;153;962
085631312626;1;244;155;120;94;169;782
054400289754;1;172;224;293;81;112;882
010122700077;1;187;157;286;118;154;902
024549533952;1;134;110;286;117;163;810
024864367678;1;140;257;189;86;159;831
044443185909;1;246;131;262;119;136;894
009089678819;1;152;268;294;78;109;901
037450724926;1;248;244;287;80;75;934
081062500696;1;239;113;187;109;51;699
011254744726;1;200;127;262;62;78;729
047661745330;1;242;153;102;79;135;711
052251081076;1;183;248;93;69;53;646
064810458381;1;259;202;170;98;108;837
016311685554;1;101;119;134;104;68;526
090343995416;1;222;129;261;81;56;749
078327604186;1;97;213;249;50;59;668
046921902949;1;243;222;156;83;103;807
025347230119;1;123;240;181;92;61;697
097765767504;1;227;203;96;82;60;668
080581060488;1;264;122;212;72;58;728
066025092898;1;119;90;184;59;98;550
025939156479;1;98;232;266;58;163;817
083352526752;1;143;135;123;105;69;575
005878797937;1;281;175;200;51;100;807
037456150885;1;255;120;102;57;104;638
055066507017;1;152;123;225;54;90;644
073105853490;1;141;152;110;62;102;567
068149786843;1;154;196;234;66;146;796
037865951821;1;185;107;211;106;118;727
027222191078;1;226;221;188;89;145;869
049192801425;1;156;273;239;111;56;835
091002458160;1;180;242;103;69;142;736
048070981832;1;91;88;264;98;143;684
013152729345;1;136;200;289;55;105;785
094318241877;1;171;119;214;93;161;758
062000290261;1;174;232;255;93;156;910
049581139883;1;168;240;144;51;110;713
054658996304;1;145;109;220;84;137;695
064199337714;1;208;232;94;117;71;722
056655928878;1;249;145;256;63;147;860
024955423318;1;91;281;108;96;127;703
000675141866;1;200;248;179;110;152;889
018083578643;1;212;282;184;120;122;920
081751408128;1;274;223;106;98;65;766
075797117893;1;199;86;168;93;72;618
090281810479;1;213;235;238;102;99;887
096251998341;1;173;134;262;100;112;781
065092774039;1;127;218;152;103;119;719
010728091310;1;173;288;113;52;131;757
039316105691;1;156;120;140;89;134;639
047423159638;1;269;268;206;88;140;971
036949130696;1;228;184;153;112;52;729
039672761992;1;84;252;174;63;155;728
049043738321;1;128;89;248;99;73;637
005856043524;1;101;112;129;110;145;597
003445120542;1;228;98;125;118;106;675
036989601242;1;286;112;179;99;68;744
003845924539;1;166;248;238;82;94;828
023879426434;1;215;225;263;54;144;901
054508659387;1;152;201;200;93;168;814
017067178077;1;135;120;134;72;151;612
057406225635;1;273;128;255;64;165;885
057410117524;1;245;157;143;83;175;803
008537758889;1;124;142;96;67;89;518
025575206418;1;182;103;203;55;50;593
009152937141;1;267;272;206;61;73;879
069209182814;1;244;103;157;79;125;708
077556630918;1;292;224;291;114;91;1012
050923251124;1;251;243;259;56;96;905
000312521415;1;190;263;266;57;84;860
068824014845;1;152;88;234;101;62;637
089611464367;1;121;235;155;60;95;666
028636947858;1;189;174;173;68;109;713
035856322757;1;269;227;199;110;59;864
095039572697;1;123;257;160;65;93;698
040482910217;1;87;255;198;114;110;764
070144408985;1;287;125;264;107;169;952
070795738397;1;233;122;226;113;131;825
072676753703;1;153;268;257;113;159;950
019056898018;1;177;92;242;77;138;726
072430052577;1;275;162;199;109;168;913
067516343935;1;126;236;124;104;130;720
047902441530;1;210;229;164;60;143;806
051660688241;1;140;85;99;108;143;575
064015531490;1;261;131;184;107;84;767
026436984622;1;97;124;148;83;146;598
041994372641;1;133;263;255;118;150;919
058747442609;1;146;80;242;67;111;646
092954226944;1;99;186;208;105;90;688
075351988578;1;217;110;261;101;93;782
077755233908;1;171;173;245;91;52;732
038413223712;1;171;101;289;113;76;750
078065275238;1;178;157;275;108;60;778
098929200509;1;153;147;129;68;85;582
052437112840;1;139;123;276;84;55;677
015607170459;1;188;279;300;108;65;940
078089976041;1;125;211;92;52;86;566
043909534156;1;195;249;245;99;112;900
025245485503;1;172;183;207;96;132;790
096673426757;1;135;136;105;92;146;614
007001528528;1;243;207;205;117;159;931
096633233088;1;98;186;286;71;94;735
042391615750;1;102;119;285;54;86;646
028971308226;1;287;272;181;90;125;955
077798904408;1;110;139;186;64;161;660
044749254690;1;111;123;241;70;125;670
068054054846;1;267;99;212;102;102;782
043415088561;1;102;269;195;51;62;679
021472387474;1;187;90;291;99;159;826
043526548969;1;151;218;276;67;135;847
079610649545;1;122;86;299;98;148;753
037385713004;1;258;117;126;102;171;774
047401734459;1;89;177;247;117;149;779
055522249140;1;123;259;122;88;153;745
047727472125;1;166;135;192;99;138;730
003266585743;1;168;199;197;115;56;735
036851009501;1;292;172;228;105;80;877
038964570171;1;123;101;271;110;162;767
062189797248;1;264;213;276;61;77;891
082144952620;1;281;242;280;87;85;975
088024938773;1;244;171;203;119;127;864
012857888887;1;262;229;154;120;175;940
092835432408;1;204;128;246;88;138;804
066987972874;1;80;124;221;87;120;632
065069936425;1;88;102;158;110;64;522
091349302744;1;222;116;259;77;135;809
015356732409;1;209;223;213;77;174;896
065406554352;1;242;186;95;118;138;779
084209432304;1;152;272;243;97;67;831
057883570913;1;110;172;133;98;54;567
062771728777;1;126;184;274;66;84;734
099359356552;1;180;143;115;100;50;588
060849732976;1;159;84;272;68;83;666
083515995192;1;139;162;294;104;151;850
005386705235;1;245;266;238;96;128;973
071216092825;1;229;263;174;103;113;882
012980204678;1;191;278;247;76;98;890
025871388033;1;228;244;121;57;59;709
027395345136;1;99;268;101;118;113;699
019435759585;1;107;83;251;110;138;689
060361261265;1;201;158;193;84;154;790
064927179882;1;101;152;90;52;164;559
073913885841;1;199;167;141;88;87;682
061798399984;1;208;235;113;102;158;816
043266817675;1;218;163;169;104;103;757
016705340133;1;223;112;220;87;172;814
020748046779;1;240;277;207;59;113;896
096306341394;1;231;226;136;83;78;754
014378064905;1;191;262;231;72;101;857
073374649487;1;98;127;132;76;143;576
023960797222;1;159;215;178;95;135;782
084958931611;1;235;152;90;100;134;711
088277672984;1;232;221;227;57;70;807
077313891979;1;179;264;146;110;161;860
076205124811;1;214;80;202;68;130;694
052579542762;1;206;135;160;74;87;662
067060368226;1;267;267;225;62;123;944
078750858124;1;221;132;114;75;111;653
028772713120;1;170;204;155;63;50;642
090622014241;1;276;160;198;56;118;808
045403965181;1;258;250;136;73;71;788
026268104063;1;82;158;181;71;167;659
010928130672;1;139;99;157;76;169;640
061030771942;1;243;270;143;76;140;872
085542019698;1;113;283;108;98;56;658
017469668894;1;263;259;236;117;135;1010
099889378748;1;282;98;169;70;69;688
002529732578;1;81;198;153;56;86;574
090029638315;1;166;115;173;66;78;598
036651922078;1;145;161;231;64;127;728
025324907892;1;278;157;121;100;131;787
071109335650;1;243;84;296;81;139;843
070813632827;1;212;109;96;88;71;576
045307114011;1;173;147;157;78;57;612
084456857938;1;227;193;196;118;82;816
059743357887;1;95;237;107;60;142;641
059450913901;1;141;270;257;55;80;803
021796061505;1;127;236;125;51;53;592
003597665507;1;116;165;249;118;127;775
065080610555;1;207;254;262;90;69;882
028263494430;1;267;107;187;98;62;721
066756586148;1;270;212;227;105;61;875
098845014278;1;212;276;114;97;84;783
034541588699;1;182;179;185;97;131;774
012671015749;1;88;221;286;59;70;724
059945410408;1;227;90;231;56;142;746
035209648107;1;119;222;235;100;58;734
027417147352;1;140;153;123;108;158;682
055962943633;1;262;271;293;87;60;973
042048674608;1;170;206;228;77;58;739
012357032871;1;254;224;285;98;121;982
084307888272;1;137;206;277;108;101;829
059080010208;1;166;203;157;84;112;722
079718385588;1;198;258;137;52;142;787
019988341279;1;138;106;117;109;107;577
056740074653;1;200;218;258;51;135;862
003164637352;1;187;134;185;106;79;691
037850389645;1;209;182;103;92;158;744
024334787909;1;243;207;207;63;141;861
088784598329;1;204;228;236;82;68;818
036838680977;1;206;123;192;119;150;790
034074380726;1;261;101;236;93;82;773
093596249813;1;120;228;208;71;177;804
027030623701;1;103;127;134;82;95;541
098086739294;1;227;116;216;87;63;709
049487554462;1;242;246;226;68;103;885
043637023205;1;242;170;217;101;118;848
096089563049;1;209;269;128;113;62;781
064385568746;1;194;282;274;51;155;956
008701103393;1;270;169;256;88;178;961
065014341942;1;266;97;188;80;70;701
004846430757;1;279;228;250;56;145;958
086813529337;1;150;167;134;67;58;576
027303664253;1;139;140;296;116;142;833
052101685945;1;232;162;115;51;136;696
055548043612;1;123;144;282;65;169;783
063120948541;1;247;145;274;100;100;866
027942349868;1;234;173;127;61;85;680
063727856348;1;116;187;160;90;170;723
064830244549;1;211;128;146;64;72;621
034796377061;1;129;147;112;102;124;614
044289113116;1;187;270;294;94;172;1017
028057917178;1;184;263;159;60;170;836
092722830661;1;145;136;194;87;127;689
068688993698;1;123;115;128;88;55;509
096900552967;1;221;182;173;106;174;856
081470767520;1;236;288;238;99;110;971
077816338345;1;258;167;234;54;109;822
063549418042;1;113;96;169;53;159;590
011140585790;1;196;187;138;68;111;700
029357428185;1;221;128;111;57;178;695
085605367546;1;237;267;260;102;158;1024
099298571000;1;105;111;160;68;144;588
063917061901;1;117;288;108;119;110;742
004000985208;1;183;226;179;64;171;823
017411897038;1;159;194;230;72;169;824
059602162290;1;138;248;137;97;145;765
092690761394;1;81;240;174;53;152;700
050871420615;1;230;217;296;58;144;945
028811780409;1;268;275;237;93;142;1015
088731472282;1;172;227;224;107;104;834
032346783647;1;186;132;277;73;71;739
036941349856;1;265;133;100;65;60;623
028855340982;1;126;214;125;89;173;727
074904587231;1;250;267;92;110;145;864
032571834433;1;92;192;264;54;112;714
014098245155;1;212;149;268;96;116;841
032304942388;1;174;87;170;88;176;695
081199912267;1;231;196;234;92;110;863
031952969574;1;255;145;134;74;65;673
026448686704;1;147;169;280;78;134;808
034577846444;1;232;141;174;93;166;806
024981922343;1;254;118;106;115;138;731
071679665644;1;160;229;269;109;62;829
051011609182;1;270;228;240;83;52;873
026770748232;1;122;213;222;76;51;684
058589572878;1;145;239;243;115;65;807
078151819680;1;289;237;112;81;80;799
066032975707;1;84;178;123;74;77;536
043739380283;1;100;101;176;75;159;611
064102360621;1;101;260;254;52;52;719
074063994871;1;98;157;278;100;108;741
081555826580;1;279;185;173;64;134;835
054185459926;1;115;206;208;114;174;817
028391338818;1;269;120;282;116;130;917
094678345013;1;196;88;218;88;103;693
065960993182;1;116;204;228;105;114;767
091247921389;1;185;253;269;88;94;889
007796981829;1;210;284;296;56;121;967
085057743555;1;174;103;275;81;156;789
066817416233;1;119;121;143;54;138;575
049315831590;1;157;158;232;117;81;745
072933183240;1;273;205;172;66;65;781
079842298455;1;128;269;95;71;107;670
003426115041;1;122;145;235;70;86;658
042133316508;1;229;187;117;73;65;671
047594530271;1;196;248;187;63;55;749
028937818370;1;207;267;285;67;151;977
067458975667;1;207;113;206;90;105;721
015847949774;1;83;130;143;92;129;577
009629406450;1;202;191;100;73;76;642
014199517688;1;200;183;202;73;77;735
065648326851;1;244;255;130;62;120;811
029516182114;1;202;236;252;69;165;924
019923096864;1;210;237;113;64;86;710
047737461841;1;226;266;196;84;166;938
002605640289;1;150;262;271;58;154;895
032060552861;1;239;154;152;76;80;701
074039876143;1;192;88;107;107;60;554
030712675779;1;283;208;189;91;72;843
043857870218;1;99;117;127;86;92;521
091346912859;1;249;227;91;78;142;787
008868657254;1;270;122;102;73;80;647
044382285670;1;197;124;288;89;94;792
093447197304;1;191;196;160;57;147;751
057019752440;1;140;184;93;55;59;531
053859840295;1;105;110;144;70;126;555
054678364103;1;150;269;167;63;164;813
098069321486;1;194;210;249;105;151;909
092800807881;1;118;229;215;111;85;758
073374593218;1;80;181;119;76;97;553
015843955441;1;175;109;284;75;103;746
034860673131;1;222;242;170;103;78;815
079957555344;1;254;125;233;120;120;852
098464008301;1;141;174;149;59;80;603
006252501481;1;133;269;93;58;55;608
080132107877;1;135;114;116;59;161;585
099308330353;1;101;142;227;96;53;619
075866307143;1;218;98;138;74;80;608
062058965912;1;119;236;98;69;94;616
015149757171;1;287;267;160;78;83;875
047775302362;1;186;218;101;111;73;689
096910240774;1;235;274;179;64;136;888
020392728474;1;263;138;106;95;134;736
061705800370;1;256;183;243;76;157;915
066825460805;1;151;241;289;120;77;878
012006395325;1;264;90;202;80;142;778
085761170110;1;246;226;175;95;178;920
029614148870;1;223;104;233;111;95;766
037282604575;1;121;202;223;54;127;727
007448107703;1;164;182;172;63;166;747
068088555451;1;267;111;117;82;134;711
001019406137;1;96;269;270;102;85;822
015230786470;1;268;208;247;73;103;899
012072404519;1;80;113;198;55;136;582
036497208815;1;131;270;290;78;172;941
092759948186;1;278;169;224;112;63;846
017310692515;1;255;187;294;79;109;924
070065413068;1;178;275;259;66;118;896
028889103166;1;270;97;167;91;177;802
006312626053;1;111;233;127;107;94;672
044239116813;1;283;143;161;59;61;707
048068866339;1;228;247;227;120;115;937
095961309392;1;145;89;130;72;100;536
010365621147;1;150;153;184;93;139;719
073079995078;1;171;225;104;59;89;648
085128484208;1;95;266;294;61;111;827
093191430372;1;225;226;284;67;62;864
026183413946;1;150;105;142;97;170;664
011290098967;1;127;170;269;106;157;829
042797096405;1;150;248;286;115;66;865
005083103530;1;282;171;123;91;78;745
093947476548;1;232;253;255;116;94;950
022260809850;1;168;228;98;89;53;636
020502707114;1;233;180;137;51;92;693
075289641559;1;118;226;289;86;98;817
010174410721;1;241;125;139;92;143;740
054581228209;1;173;232;225;89;124;843
018974358003;1;285;231;190;86;134;926
022850903964;1;218;140;122;70;152;702
087076015748;1;260;194;135;96;65;750
002889581665;1;251;193;246;113;83;886
038511575096;1;114;83;258;106;129;690
033603088140;1;155;140;176;69;73;613
048997478222;1;155;236;237;74;60;762
091534925909;1;150;210;161;115;175;811
046845269670;1;109;201;112;83;83;588
088017184927;1;86;135;199;106;94;620
079998818433;1;121;173;182;82;91;649
082232649034;1;154;87;104;98;63;506
097772478373;1;118;258;231;97;126;830
004166970752;1;273;195;264;110;169;1011
007866968327;1;269;145;298;58;174;944
078344205792;1;137;181;253;66;142;779
094531299597;1;185;198;176;117;105;781
026001170762;1;125;82;223;112;165;707
064675245413;1;238;138;119;84;156;735
018743828312;1;231;203;134;114;153;835
046031427260;1;82;101;237;71;86;577
043910694000;1;221;116;259;99;144;839
070093165936;1;254;218;184;52;151;859
086325930317;1;110;266;155;100;124;755
049744228659;1;238;154;130;69;109;700
039203810005;1;287;285;110;87;67;836
064213385528;1;290;283;125;115;87;900
081417763810;1;172;153;296;55;100;776
037234832897;1;149;288;154;69;96;756
072474739952;1;239;94;146;112;163;754
046514720249;1;95;136;224;83;82;620
029889368674;1;223;219;231;61;154;888
038226242741;1;281;222;244;82;78;907
048631718374;1;169;267;156;75;111;778
037709782586;1;176;189;234;90;133;822
029569905661;1;189;128;153;110;106;686
065193639990;1;247;160;167;99;116;789
036010711210;1;109;124;111;86;108;538
013738088579;1;158;87;255;81;125;706
072523020236;1;149;241;230;54;105;779
002476483032;1;188;153;120;117;141;719
069629028948;1;180;102;117;70;159;628
070252689841;1;184;87;206;57;142;676
066362816141;1;156;83;153;88;164;644
005686819388;1;113;86;97;81;80;457
049048045889;1;206;189;127;106;120;748
066840675328;1;192;285;99;106;70;752
091009913053;1;221;125;141;72;79;638
042567596309;1;100;230;159;79;166;734
028776701982;1;280;178;197;66;153;874
079364855621;1;106;225;153;112;166;762
066300574223;1;289;277;239;104;150;1059
047004942231;1;290;165;94;73;61;683
095750039040;1;246;217;217;57;127;864
063575595525;1;89;87;186;62;106;530
030720868807;1;136;108;190;78;77;589
047355841834;1;189;108;227;81;159;764
059047131819;1;252;112;185;61;124;734
008596431857;1;223;154;157;113;163;810
007166726178;1;239;166;300;71;69;845
041716896181;1;189;100;134;52;56;531
013014608619;1;102;244;225;100;154;825
028664386022;1;285;258;109;115;110;877
050265542434;1;271;157;93;93;70;684
045144906627;1;168;280;113;114;82;757
093728344644;1;247;224;274;71;124;940
080468687719;1;286;105;103;111;138;743
010896081003;1;256;153;208;72;137;826
097371815386;1;142;246;232;67;169;856
058298650043;1;144;155;201;57;121;678
031014840384;1;282;208;114;78;137;819
082431409565;1;88;163;106;69;163;589
042025059408;1;291;258;280;54;128;1011
078364593442;1;281;121;181;86;106;775
092642819605;1;210;177;197;96;113;793
076082559753;1;128;247;110;77;107;669
007737505018;1;220;137;236;119;149;861
084649132930;1;246;241;110;74;172;843
005585751459;1;249;82;226;90;159;806
063807906526;1;140;241;223;85;103;792
026567287534;1;137;219;294;91;100;841
060148665040;1;171;157;236;79;56;699
053432560368;1;152;107;136;89;99;583
077173446356;1;195;190;170;66;159;780
025296313178;1;245;247;244;85;96;917
077715469111;1;107;268;244;76;58;753
068993627646;1;289;157;147;96;85;774
028866669058;1;179;122;135;114;61;611
054465969865;1;149;165;292;56;68;730
097976606886;1;121;171;95;114;52;553
041451803029;1;113;266;201;68;124;772
057169629002;1;201;263;209;59;174;906
061677855031;1;237;239;124;58;87;745
032963663520;1;265;106;201;92;148;812
099228910406;1;248;260;299;97;175;1079
071722116174;1;100;152;155;50;115;572
019742158510;1;191;121;145;52;95;604
013422123497;1;235;119;113;75;149;691
021329870962;1;256;238;287;119;174;1074
061649040249;1;232;104;173;51;148;708
000198640662;1;259;99;284;111;113;866
079785997938;1;256;191;153;95;85;780
005254288998;1;235;146;157;85;124;747
020940530728;1;174;106;237;104;178;799
051929293787;1;162;173;300;103;76;814
029114797497;1;116;210;257;116;171;870
071954399466;1;109;154;113;88;156;620
098702543253;1;272;242;233;52;159;958
086549283636;1;180;114;102;103;176;675
022962067401;1;268;82;132;119;90;691
059071119804;1;283;241;171;101;175;971
034968837056;1;162;100;141;91;88;582
037976288722;1;273;249;117;95;169;903
045356414249;1;255;190;121;114;106;786
017582255808;1;182;167;276;107;162;894
046998187930;1;231;82;255;100;177;845
092153958641;1;118;93;297;117;54;679
082542262816;1;186;98;267;50;53;654
087509479460;1;162;193;169;104;174;802
067975831438;1;208;164;239;61;61;733
054158344056;1;248;193;221;84;62;808
032725873995;1;218;117;159;73;138;705
000545361467;1;174;136;110;95;95;610
048950928115;1;85;230;95;67;160;637
024892521988;1;150;166;139;93;167;715
069378083997;1;134;150;237;73;56;650
098384962171;1;265;274;139;85;131;894
067698478274;1;248;111;253;94;125;831
096507652903;1;162;238;265;97;147;909
091307240453;1;252;173;296;53;60;834
016953952585;1;196;272;109;79;128;784
062335754999;1;95;256;208;113;167;839
044563211425;1;184;101;101;86;142;614
095841633682;1;201;287;170;57;64;779
030929065893;1;158;80;267;88;66;659
018560640787;1;210;150;217;92;122;791
061549266516;1;187;161;278;101;127;854
092370680909;1;132;159;114;104;134;643
005578618581;1;93;157;110;94;130;584
067806136665;1;120;198;149;92;117;676
088712782085;1;119;98;280;104;94;695
040430381651;1;140;238;166;69;173;786
008610993364;1;143;230;230;63;177;843
064612063593;1;262;286;212;67;119;946
072016343472;1;90;286;159;57;166;758
040928909066;1;253;191;174;106;88;812
052424111780;1;277;148;226;73;66;790
004438048207;1;257;184;183;86;81;791
062899946201;1;101;236;239;96;153;825
077501629628;1;162;232;143;72;120;729
093890399813;1;150;254;169;83;78;734
060738251051;1;155;167;145;96;131;694
077363140987;1;173;141;240;52;65;671
001197997683;1;181;86;112;110;54;543
082376002030;1;170;263;252;106;73;864
041528402342;1;251;259;95;64;131;800
063073200571;1;177;193;164;66;51;651
059437271849;1;289;196;109;75;158;827
030406044007;1;200;86;266;80;87;719
031418596953;1;156;89;158;66;151;620
039882771080;1;172;103;170;94;62;601
008027166174;1;90;185;140;98;52;565
045567694475;1;193;262;218;64;124;861
084957950581;1;180;188;213;105;121;807
097729046704;1;131;217;188;98;96;730
085219967652;1;83;193;127;89;172;664
015248244157;1;195;288;91;55;148;777
076214292880;1;210;190;258;85;146;889
022754059871;1;90;143;221;99;68;621
090708030976;1;123;141;289;107;83;743
072084122581;1;259;272;201;84;96;912
000242357797;1;181;232;155;117;172;857
003998267107;1;262;181;229;120;52;844
019011226355;1;188;255;229;98;95;865
070264145556;1;292;171;182;74;125;844
025198027356;1;87;151;185;119;114;656
002633297170;1;218;273;218;95;82;886
025713495929;1;215;235;209;90;142;891
027329032829;1;131;285;138;58;144;756
089770114516;1;233;271;253;86;177;1020
042481752975;1;150;160;164;108;62;644
047251338695;1;101;164;121;77;96;559
067591057911;1;189;176;279;98;161;903
057846167116;1;292;222;91;112;146;863
007126937481;1;233;177;158;102;122;792
064729770138;1;284;254;164;68;167;937
031289127335;1;292;248;199;89;91;919
093638914108;1;222;131;103;102;161;719
022853744844;1;184;158;93;87;69;591
056814961908;1;108;99;202;74;139;622
066229111241;1;210;95;91;94;92;582
043881345068;1;164;108;138;84;92;586
039561637841;1;119;227;299;105;70;820
092028132849;1;242;112;133;53;135;675
057000341533;1;153;242;138;102;68;703
029144147326;1;191;196;164;101;82;734
072847320528;1;126;169;230;95;140;760
012642682800;1;281;167;245;115;147;955
019327001840;1;130;229;151;96;143;749
060604220264;1;201;150;239;105;153;848
039944583546;1;171;187;233;105;120;816
072932276238;1;174;151;172;113;151;761
063005664940;1;256;267;166;56;161;906
052324045270;1;263;84;269;118;67;801
029006909054;1;210;274;94;59;150;787
070983191151;1;127;166;204;79;161;737
051723384523;1;145;115;180;50;76;566
026098686155;1;91;208;250;95;149;793
056420904189;1;220;111;251;60;106;748
094360726704;1;280;106;254;99;67;806
095398710322;1;81;268;256;60;176;841
081722869028;1;82;172;96;117;151;618
048973451972;1;191;210;111;111;74;697
085154591421;1;254;129;156;95;150;784
009292879216;1;85;230;212;59;100;686
042790639792;1;216;249;149;104;111;829
017683382584;1;238;178;224;113;55;808
084511644452;1;184;230;138;89;106;747
081840365356;1;103;104;102;100;92;501
027775752817;1;139;247;216;78;99;779
032353945655;1;292;209;199;106;96;902
003709168627;1;111;106;117;105;114;553
092715531497;1;212;238;279;85;98;912
069635296831;1;255;160;167;105;112;799
007182985142;1;110;179;149;59;146;643
085221539795;1;184;114;236;65;59;658
013487621570;1;201;230;208;58;121;818
030922891944;1;101;263;177;74;130;745
086901555948;1;242;254;245;70;54;865
044356331008;1;202;102;297;94;55;750
015841247680;1;202;123;213;108;51;697
050284112064;1;280;194;125;70;98;767
058416729412;1;275;206;238;100;87;906
088312747421;1;138;171;162;67;126;664
035448685009;1;146;275;184;97;145;847
025905847191;1;215;125;256;50;116;762
030299108855;1;87;215;213;67;129;711
057363408925;1;121;107;191;90;93;602
013135555998;1;180;254;267;90;117;908
020846329091;1;167;108;214;51;149;689
034796999163;1;205;286;286;99;106;982
070569583779;1;230;170;279;63;162;904
087550286249;1;223;108;132;67;159;689
060481106478;1;89;186;175;50;91;591
090978125575;1;170;80;289;94;151;784
026248763565;1;184;96;132;110;130;652
092875288757;1;284;137;102;55;133;711
088587400949;1;118;137;155;118;157;685
010037477156;1;248;263;105;65;98;779
072137280058;1;84;178;230;84;168;744
059866202538;1;179;138;97;73;124;611
047160659987;1;234;131;262;50;85;762
006072908921;1;84;159;291;118;142;794
076493702294;1;230;82;216;109;174;811
071022140658;1;152;141;215;87;52;647
090629034639;1;280;171;131;80;129;791
098546052456;1;227;166;114;59;103;669
058377259318;1;218;271;194;50;91;824
078055111491;1;252;258;183;90;174;957
018931270750;1;193;148;109;50;139;639
074192544457;1;128;115;114;78;138;573
092162190987;1;248;253;163;82;73;819
015237796906;1;205;219;295;91;92;902
006087103086;1;218;263;151;105;154;891
091786742546;1;237;119;191;86;116;749
081611575653;1;262;205;109;105;123;804
089159363915;1;258;221;236;78;70;863
040480734660;1;292;171;227;51;53;794
013358962270;1;179;122;90;108;54;553
011270108816;1;253;100;272;88;158;871
083734369393;1;175;269;164;82;147;837
043700265716;1;266;147;139;104;121;777
064911596724;1;143;119;292;107;175;836
030979552123;1;286;230;163;58;115;852
012532979599;1;120;248;234;60;76;738
068479324631;1;117;229;138;82;176;742
076427957498;1;85;113;219;51;71;539
073378961371;1;189;281;172;90;168;900
069713310276;1;202;261;198;110;124;895
006179193182;1;169;233;280;70;177;929
034162687740;1;107;280;94;108;100;689
006261912535;1;82;247;124;87;77;617
070400568283;1;167;171;169;103;68;678
078891529329;1;88;233;105;57;90;573
064670328753;1;208;251;233;65;161;918
019254798615;1;129;229;277;102;78;815
004091543557;1;190;133;254;75;83;735
019552258995;1;212;194;177;105;138;826
088517371529;1;154;157;156;68;107;642
065830131930;1;287;251;167;84;69;858
031365051608;1;89;210;223;87;56;665
035340094098;1;200;159;220;68;149;796
017770279501;1;213;129;112;113;65;632
082290531423;1;246;232;258;75;103;914
024041960641;1;147;133;298;119;156;853
034613116764;1;203;106;262;113;131;815
068760895010;1;220;205;206;90;97;818
082572706313;1;223;146;207;94;147;817
099253844398;1;173;258;195;60;163;849
088249696313;1;266;200;225;73;89;853
090455944503;1;199;105;260;71;61;696
082239895405;1;221;112;101;92;106;632
050988996527;1;119;178;121;113;96;627
065799869351;1;177;161;105;73;139;655
013833935585;1;176;118;266;106;160;826
054719159670;1;158;140;133;109;138;678
020845349622;1;155;274;285;53;121;888
001358742537;1;161;199;95;99;137;691
031814943896;1;95;222;166;51;175;709
090683712023;1;215;226;211;56;105;813
070087421542;1;103;284;126;53;163;729
067830276388;1;248;94;104;56;56;558
009863275428;1;201;154;266;111;153;885
061223970817;1;80;167;235;56;134;672
007504893415;1;214;267;219;79;147;926
009485856871;1;169;147;238;80;76;710
053956045020;1;204;118;163;78;54;617
020395731847;1;287;192;100;52;167;798
024355406224;1;292;155;102;104;118;771
076178952662;1;252;175;91;94;62;674
014012750470;1;180;117;123;99;80;599
090150895476;1;242;182;90;115;152;781
077906572380;1;88;136;286;85;95;690
086253013464;1;228;279;269;103;134;1013
045084203890;1;127;214;101;85;61;588
086280338168;1;122;232;232;94;89;769
067137539776;1;116;148;101;70;112;547
046941047209;1;247;209;127;74;177;834
004476644602;1;156;228;296;68;58;806
043630542869;1;163;167;261;86;156;833
032017208058;1;118;190;133;60;104;605
011191113256;1;120;272;194;62;174;822
013269004623;1;268;165;171;84;105;793
098429847356;1;137;104;163;116;93;613
003377909272;1;88;212;199;106;142;747
083152655220;1;84;104;299;75;121;683
050817601549;1;87;143;155;95;106;586
005458679904;1;123;84;137;89;121;554
071049829960;1;272;96;192;93;158;811
094464403299;1;249;259;207;78;161;954
029712869971;1;184;112;168;86;142;692
000445524253;1;135;283;218;78;99;813
041087099262;1;271;144;208;55;83;761
025383118640;1;99;255;157;109;114;734
043891292679;1;186;166;200;85;88;725
047362896972;1;89;208;279;109;68;753
007673156403;1;234;126;274;98;169;901
081939994183;1;190;180;288;105;144;907
094593965710;1;207;223;207;86;154;877
002391942769;1;157;136;156;73;65;587
012274190761;1;201;114;134;113;169;731
007118481157;1;180;135;129;69;111;624
096119952585;1;287;225;217;107;151;987
085495867358;1;166;288;173;97;106;830
069563833887;1;287;88;286;87;178;926
090108847160;1;131;266;291;113;94;895
073811594825;1;82;248;150;119;121;720
090309082067;1;267;119;237;84;156;863
082755122268;1;278;218;233;95;98;922
073195900499;1;97;117;207;63;177;661
007943929677;1;153;261;128;83;161;786
061839490314;1;191;112;235;75;148;761
074115826476;1;154;216;290;53;163;876
079859485127;1;240;114;170;95;136;755
091189074175;1;273;126;220;81;72;772
005919428994;1;104;242;254;63;150;813
026527479941;1;208;193;229;107;162;899
062923007611;1;254;145;297;76;53;825
016615450108;1;228;201;269;53;141;892
066006241767;1;121;254;273;89;89;826
000503468953;1;190;115;238;60;101;704
064595588587;1;255;264;188;67;74;848
040339867782;1;143;203;188;99;118;751
019786603012;1;198;171;114;107;54;644
006583751648;1;122;174;162;87;135;680
087811783549;1;200;98;140;70;60;568
021387247137;1;223;169;108;64;86;650
088331606179;1;107;195;100;54;50;506
019439080146;1;225;89;236;63;115;728
069957481551;1;103;260;147;50;81;641
005850557716;1;252;240;220;98;117;927
024252652267;1;188;208;116;59;59;630
099285918422;1;115;260;290;85;148;898
016227597944;1;274;162;220;67;77;800
016549269859;1;217;250;182;117;56;822
044783035119;1;121;83;128;74;96;502
049164216684;1;210;225;229;99;68;831
077639322879;1;133;159;225;73;124;714
002445048520;1;288;104;111;61;70;634
065760036105;1;158;175;104;74;149;660
050399139239;1;96;240;290;87;165;878
010229211729;1;92;169;130;118;163;672
037053070925;1;246;224;255;56;68;849
093957769346;1;204;114;190;55;101;664
018348311714;1;108;146;287;120;71;732
068214860689;1;283;242;141;59;75;800
051933774348;1;277;207;96;77;73;730
074255995276;1;108;157;134;67;129;595
030702171164;1;177;288;139;85;69;758
012155344975;1;271;266;118;101;114;870
033417804536;1;191;161;250;118;164;884
070511979596;1;281;149;125;64;104;723
088696719972;1;130;124;281;93;88;716
051883910186;1;177;262;252;105;94;890
069572531241;1;241;262;292;55;135;985
006675871178;1;275;242;97;79;74;767
039154300024;1;263;210;161;87;89;810
007228448964;1;246;237;117;116;90;806
060196805087;1;109;166;198;75;129;677
058872287453;1;114;92;121;104;159;590
074137565999;1;210;122;166;76;162;736
062717785237;1;276;211;288;108;103;986
075474012780;1;255;248;93;107;158;861
044719409859;1;100;115;225;109;160;709
009134233867;1;178;96;99;50;100;523
082894852260;1;217;159;295;102;150;923
022484021969;1;120;154;201;58;137;670
075006085213;1;161;225;174;93;170;823
023426981831;1;214;235;187;101;77;814
089520609920;1;268;96;182;102;161;809
064914446079;1;267;203;297;54;140;961
021507166009;1;86;239;148;95;160;728
024334558639;1;280;284;216;115;168;1063
073733133032;1;109;225;223;79;59;695
021840591129;1;169;166;275;86;79;775
086089681427;1;143;212;105;120;152;732
043663316373;1;255;82;98;71;126;632
085612319136;1;207;276;98;118;64;763
058415860116;1;121;244;124;92;156;737
088420994127;1;247;212;116;97;84;756
016263327355;1;118;149;267;102;101;737
078079045210;1;84;265;233;105;167;854
029632894423;1;207;230;282;56;144;919
027072451519;1;257;226;122;84;58;747
049105216800;1;238;249;141;94;102;824
014099540300;1;224;151;139;52;130;696
079789824596;1;90;132;287;116;160;785
096226687344;1;212;216;175;118;108;829
069358707530;1;285;140;116;96;80;717
020805375510;1;284;274;107;51;147;863
070809397560;1;278;255;93;99;137;862
036101091454;1;260;223;123;80;84;770
068833875001;1;242;188;159;67;167;823
003667526502;1;283;178;265;54;84;864
042474097517;1;134;150;151;112;67;614
026838998286;1;144;80;237;110;96;667
020887496837;1;153;137;95;56;53;494
067521760768;1;263;114;167;65;50;659
018931905065;1;181;287;119;110;161;858
065326881646;1;251;95;292;72;95;805
068563081222;1;275;207;228;51;99;860
069618799434;1;248;261;281;70;177;1037
091926258447;1;196;104;195;95;115;705
086536767136;1;142;241;146;120;54;703
083791499949;1;146;142;288;118;169;863
040476067583;1;214;162;241;82;154;853
067568551724;1;175;101;260;109;142;787
029140742867;1;81;276;104;62;151;674
002952730383;1;121;219;280;70;82;772
081807321525;1;288;151;146;83;66;734
039850192629;1;188;171;146;50;103;658
091457971472;1;192;88;215;90;119;704
099284681614;1;166;110;296;51;51;674
008919622846;1;108;241;234;59;125;767
031250846355;1;132;276;102;102;136;748
016082707281;1;199;186;249;115;86;835
042352196102;1;150;82;288;89;107;716
089456711853;1;156;218;237;97;125;833
059646063909;1;230;195;192;95;137;849
001752250668;1;107;264;277;60;128;836
090156828572;1;82;119;155;99;107;562
014558776196;1;163;146;216;92;106;723
096563675619;1;162;142;260;66;53;683
071816010894;1;238;270;273;65;109;955
099165139151;1;164;143;220;73;130;730
073323683955;1;205;209;288;61;78;841
067110109670;1;215;177;200;64;95;751
032183319025;1;217;164;113;61;57;612
056182771138;1;136;253;197;92;146;824
081071012023;1;281;168;141;53;108;751
059152810916;1;284;281;145;66;89;865
095914257908;1;156;128;143;74;149;650
027353864088;1;110;120;183;110;138;661
013944233355;1;230;234;121;85;102;772
013896398980;1;284;169;149;99;144;845
034476144788;1;116;87;163;61;167;594
072312143763;1;118;261;265;114;106;864
062326025427;1;182;248;172;83;53;738
078788591748;1;211;91;210;80;114;706
081096978725;1;198;178;192;114;172;854
033554270380;1;278;182;294;51;123;928
076807071022;1;96;166;175;93;58;588
016184853152;1;124;94;143;93;123;577
052034280293;1;271;255;230;86;52;894
054388688446;1;234;119;170;66;83;672
001720291686;1;94;284;262;100;114;854
021001179834;1;176;180;179;80;81;696
097157654222;1;168;271;262;78;138;917
067884948300;1;95;110;189;56;112;562
060900537236;1;177;237;139;79;99;731
031059459527;1;132;96;107;119;89;543
075292031913;1;205;121;267;110;61;764
048856037780;1;82;186;202;65;103;638
058176103026;1;149;234;216;61;51;711
055631400340;1;204;215;137;111;72;739
069026033592;1;290;164;111;116;158;839
095803969428;1;191;138;276;70;122;797
066031646989;1;254;279;187;112;84;916
087847149459;1;118;190;152;93;173;726
005483380348;1;279;249;137;102;172;939
011223871548;1;167;84;180;63;79;573
098769519186;1;250;230;112;82;54;728
070235408851;1;123;227;93;82;111;636
071196484102;1;274;92;146;57;162;731
077025479585;1;89;142;280;58;53;622
021089488800;1;232;99;251;115;120;817
013029383670;1;102;153;148;103;86;592
014251349948;1;204;270;158;118;99;849
069980796425;1;232;271;92;114;156;865
051247902895;1;222;166;159;99;145;791
040623556537;1;251;150;96;67;100;664
070501752945;1;131;194;197;91;95;708
008521041226;1;269;184;140;60;92;745
074698979160;1;146;123;142;94;174;679
033769993914;1;143;262;270;75;142;892
015421497589;1;86;169;249;76;113;693
033877383910;1;236;188;263;81;122;890
038307547921;1;241;245;250;59;172;967
013326004841;1;117;166;212;107;79;681
044540279550;1;112;285;234;108;171;910
035217253769;1;272;209;121;93;59;754
083630683498;1;181;154;251;117;96;799
099118980522;1;217;238;258;62;138;913
057440429477;1;208;131;179;89;152;759
068063748119;1;106;209;208;82;61;666
024712231157;1;102;246;148;64;97;657
010301633813;1;200;208;291;107;98;904
097152118803;1;97;82;161;72;112;524
066412036168;1;123;99;99;63;112;496
001873647103;1;106;162;270;74;111;723
056353833910;1;89;271;148;50;69;627
041435260663;1;179;197;266;59;141;842
084977109646;1;171;266;255;64;93;849
071217007272;1;288;223;172;67;175;925
040445910015;1;165;266;133;66;144;774
041813963122;1;137;277;202;54;108;778
009655171606;1;141;182;130;60;94;607
055800491868;1;257;223;280;93;133;986
019932531246;1;93;243;182;63;140;721
067734209467;1;164;144;197;83;74;662
024031126407;1;271;243;105;63;151;833
030824790109;1;192;162;103;119;126;702
081186076640;1;201;211;191;97;129;829
001725854742;1;90;174;253;76;144;737
053003759257;1;123;165;157;64;102;611
065504588048;1;273;130;251;74;63;791
036129607369;1;92;88;175;104;104;563
037736848735;1;177;100;205;85;146;713
061662341607;1;185;282;158;58;76;759
056770108978;1;130;284;292;105;64;875
076146026852;1;208;204;283;89;160;944
012277747000;1;261;280;295;77;98;1011
014361267782;1;88;91;99;82;133;493
080135561231;1;182;197;164;64;106;713
094703884351;1;126;156;187;51;115;635
000485379366;1;119;278;216;92;86;791
048760492643;1;292;230;147;58;127;854
025367627330;1;187;198;111;53;159;708
090789520796;1;282;225;170;108;168;953
054846007497;1;80;268;282;114;92;836
081153214062;1;167;275;146;88;136;812
084789848383;1;234;144;142;113;61;694
049473064509;1;226;143;123;117;100;709
018495328019;1;247;121;109;83;56;616
096876248388;1;172;153;237;94;71;727
041707860253;1;272;229;219;65;125;910
055466446213;1;195;218;122;63;169;767
035529410324;1;256;277;201;69;170;973
088905673190;1;159;226;276;93;83;837
012391551558;1;121;116;197;51;140;625
049674753847;1;118;241;254;80;144;837
010075149324;1;247;195;213;90;171;916
037147350185;1;178;126;223;72;168;767
046828541588;1;142;194;259;86;59;740
040633724997;1;257;106;211;63;143;780
054378590175;1;129;234;298;80;52;793
006767612149;1;274;180;167;108;77;806
079088028284;1;146;246;101;112;167;772
021373760352;1;232;169;170;66;103;740
012355267459;1;92;244;238;114;67;755
078615923900;1;183;156;109;119;78;645
030011836960;1;211;185;211;85;132;824
000398635599;1;98;263;183;81;69;694
054697359058;1;205;245;142;106;141;839
007666828933;1;153;270;231;98;70;822
089822806162;1;154;187;96;60;127;624
026247925894;1;130;232;187;63;92;704
023111372741;1;206;148;297;58;124;833
021378862465;1;220;207;104;106;61;698
006576374148;1;211;280;125;111;151;878
001367938632;1;243;117;281;53;54;748
007010092441;1;237;276;283;65;161;1022
076029477760;1;281;161;215;104;113;874
011470235994;1;262;253;274;110;64;963
060368046137;1;233;258;264;106;96;957
010005569692;1;116;281;267;108;178;950
081836204523;1;230;244;274;111;72;931
092995048125;1;102;197;210;107;161;777
040718767388;1;211;229;294;87;130;951
047603704177;1;272;203;262;91;163;991
006212908657;1;114;223;118;53;50;558
022304026018;1;151;116;100;70;166;603
071706485266;1;193;102;152;74;93;614
071828550595;1;224;231;143;88;104;790
075101457790;1;275;197;92;105;144;813
037315050901;1;259;200;153;104;90;806
003463933603;1;118;268;283;69;129;867
007912640354;1;198;158;128;111;147;742
007414917453;1;275;141;102;82;130;730
057551697400;1;194;136;233;69;143;775
005176575366;1;144;128;96;102;125;595
045749269280;1;206;114;256;74;142;792
090994707938;1;191;107;212;65;128;703
042597985913;1;270;207;96;51;133;757
069986748756;1;278;213;180;116;58;845
047478803241;1;141;199;172;118;55;685
028052943316;1;97;241;241;80;89;748
036934607130;1;124;201;293;72;162;852
054163822695;1;130;204;133;89;171;727
081088967468;1;80;182;210;84;67;623
028146757269;1;130;141;280;66;173;790
070813578538;1;196;124;281;88;68;757
043347155537;1;232;182;192;71;144;821
035228695721;1;140;98;236;96;157;727
033843498170;1;256;196;153;111;89;805
089334373088;1;203;213;99;75;141;731
093321041149;1;284;90;205;110;103;792
032792574435;1;266;209;273;61;158;967
004250396737;1;284;84;290;55;168;881
079040200275;1;214;135;269;108;172;898
006260110604;1;148;138;147;67;104;604
024271711570;1;222;254;205;90;175;946
058604624957;1;168;185;201;87;105;746
006310222935;1;87;256;220;120;121;804
004866052478;1;94;83;238;87;95;597
050558056186;1;115;167;282;52;57;673
081145162465;1;264;140;130;55;94;683
056787697149;1;180;129;108;93;55;565
004853972383;1;116;287;183;82;70;738
028235046414;1;179;223;191;62;100;755
023987902449;1;233;99;226;86;50;694
094066898137;1;112;268;134;52;95;661
081376493191;1;256;246;190;80;161;933
044593667608;1;208;212;284;106;100;910
060512290086;1;222;268;202;99;166;957
083816129934;1;104;253;180;83;88;708
051003114635;1;117;129;195;87;65;593
032233107295;1;233;214;176;53;103;779
018271399001;1;150;277;243;108;96;874
093158810961;1;178;161;282;88;149;858
023245498388;1;265;278;166;91;130;930
052584749011;1;217;109;273;107;150;856
000535364652;1;177;252;115;112;143;799
044539156786;1;275;129;289;106;67;866
058695334662;1;104;216;212;58;119;709
018809386757;1;115;205;123;100;112;655
049318366147;1;143;106;281;70;62;662
068574928546;1;208;140;209;96;71;724
060225713171;1;190;214;133;71;115;723
033270171814;1;158;211;271;115;58;813
028052933657;1;146;119;111;112;62;550
092090550068;1;108;216;190;101;109;724
029552824886;1;208;214;141;96;77;736
026909376644;1;192;117;201;75;113;698
009768312275;1;127;101;203;100;125;656
048755563155;1;196;143;105;67;57;568
006245160696;1;192;259;179;59;129;818
032641614194;1;91;213;237;63;153;757
033798407127;1;185;237;175;64;70;731
052268082271;1;183;104;111;77;125;600
025167951445;1;175;130;191;57;157;710
058803107748;1;270;141;279;106;64;860
066270182950;1;211;287;296;114;171;1079
087188362169;1;287;148;206;94;66;801
069094045389;1;191;183;277;114;158;923
019553892036;1;254;284;269;89;120;1016
037759242766;1;199;116;274;105;121;815
065801868444;1;275;114;107;116;79;691
043327132161;1;243;243;233;71;132;922
011994233201;1;141;269;291;107;96;904
060428495427;1;88;255;143;50;67;603
023323986430;1;148;184;233;82;168;815
052681203971;1;130;94;225;116;143;708
019776644580;1;215;262;153;109;131;870
013624149739;1;283;148;299;95;117;942
018835367054;1;238;282;257;78;60;915
059790742574;1;290;198;226;67;172;953
085172897852;1;159;279;196;101;59;794
064281803735;1;196;193;142;117;165;813
028190094762;1;109;262;185;105;61;722
084989141560;1;256;91;110;59;168;684
052951521063;1;288;259;206;108;154;1015
028653332293;1;256;247;266;55;161;985
094118330065;1;272;152;137;112;172;845
066032197628;1;208;108;275;82;135;808
003531539532;1;262;209;146;77;160;854
027146310966;1;134;196;295;105;135;865
056035693779;1;158;216;249;64;89;776
062901335769;1;151;145;265;65;121;747
055739149462;1;205;241;256;89;118;909
012462808214;1;191;231;230;114;54;820
002252821891;1;130;272;259;95;85;841
091277904635;1;182;129;150;57;82;600
031918330125;1;96;96;191;85;147;615
009046248771;1;122;230;269;90;96;807
068054986643;1;289;178;261;116;69;913
078768866571;1;228;288;259;117;173;1065
057538032101;1;139;158;242;116;92;747
008146133691;1;233;147;107;65;137;689
087794019250;1;180;204;280;116;132;912
023222808538;1;225;129;170;57;66;647
033347630838;1;130;245;244;114;148;881
045653025221;1;236;89;211;79;61;676
001896529159;1;273;219;289;120;110;1011
098698024084;1;154;216;268;112;144;894
000130163521;1;244;113;263;72;58;750
085648433792;1;287;224;118;82;82;793
020428383675;1;245;228;294;91;65;923
069224866230;1;123;189;127;75;161;675
073011009397;1;102;98;242;80;145;667
077725018815;1;134;106;187;108;167;702
055690417791;1;257;140;226;86;146;855
072452489853;1;211;238;258;70;61;838
068940829869;1;276;233;149;84;94;836
028392272267;1;107;118;211;57;136;629
001618244140;1;288;161;267;87;135;938
042160518129;1;292;116;144;92;96;740
028214066838;1;192;250;106;84;83;715
076322827840;1;217;242;179;64;168;870
026177259673;1;253;199;217;58;176;903
007732205365;1;204;232;158;114;176;884
085814622470;1;228;137;128;62;62;617
003821770939;1;213;195;116;66;169;759
005391137732;1;239;98;152;114;75;678
031567957746;1;168;153;168;56;127;672
062612606936;1;281;108;92;96;84;661
061799327747;1;116;286;107;53;96;658
091820642739;1;85;123;226;79;51;564
093857175989;1;147;164;211;117;69;708
064017616746;1;239;168;99;111;100;717
070469444693;1;193;165;242;77;68;745
012564521672;1;280;233;296;53;150;1012
017866619714;1;144;241;99;87;84;655
070205721335;1;146;147;141;100;138;672
021612434173;1;136;284;104;100;163;787
097126252233;1;229;179;286;82;146;922
028643076954;1;186;133;239;120;123;801
039064867646;1;212;208;128;100;61;709
023385889469;1;113;105;193;51;85;547
046598478431;1;230;139;271;86;166;892
005513187322;1;212;223;186;64;134;819
068415392267;1;102;135;236;87;137;697
014034312437;1;237;283;207;72;142;941
029950151909;1;140;119;273;113;120;765
070633078356;1;291;273;235;109;166;1074
053708140480;1;175;283;268;76;159;961
008284634363;1;196;221;197;88;111;813
095834495810;1;231;90;268;97;81;767
075783126736;1;166;285;224;90;81;846
019197514979;1;116;221;113;102;126;678
027855035182;1;180;189;252;96;104;821
005997522385;1;235;140;246;55;114;790
097855289788;1;266;92;214;109;152;833
073032174315;1;251;137;253;58;133;832
075208344412;1;121;81;110;96;52;460
006606314622;1;250;251;231;67;66;865
011388009667;1;171;181;108;85;110;655
038612475689;1;197;98;95;92;152;634
092617274369;1;201;114;215;84;96;710
075906115392;1;89;195;144;117;71;616
019823751548;1;282;260;269;83;128;1022
003042208876;1;173;279;106;75;133;766
079989017231;1;115;251;137;104;121;728
035952024962;1;184;221;263;85;114;867
024268013007;1;88;173;205;84;68;618
053598970737;1;148;223;282;84;100;837
076536307747;1;94;196;259;53;96;698
074771974215;1;208;157;227;76;159;827
017648872851;1;85;189;178;119;154;725
035715453050;1;281;195;113;55;152;796
069733172534;1;120;85;116;90;121;532
063434174788;1;216;91;215;95;115;732
007297283312;1;279;285;268;80;62;974
059760554673;1;143;163;181;58;67;612
029915664852;1;148;180;129;65;54;576
038317091751;1;157;203;189;88;99;736
045037017625;1;109;97;207;89;158;660
037931476357;1;97;234;293;98;85;807
009069295393;1;286;203;199;60;168;916
087202069072;1;180;130;255;111;138;814
056151737008;1;203;198;157;87;178;823
010920168928;1;180;273;287;115;149;1004
024037038768;1;190;136;225;77;104;732
026057883295;1;261;238;134;91;73;797
041448881949;1;242;247;165;80;130;864
026099711924;1;169;266;126;79;170;810
009324149180;1;156;96;138;96;92;578
001317826597;1;283;217;284;75;169;1028
069228109183;1;169;118;193;111;53;644
026084706790;1;169;272;269;82;140;932
083842051715;1;193;210;124;103;62;692
078729145013;1;202;90;115;52;132;591
025225399615;1;121;164;245;83;163;776
057347816947;1;88;193;116;53;126;576
057219953395;1;271;287;219;61;135;973
053478878360;1;111;184;135;68;147;645
050522868660;1;259;97;277;60;143;836
057758783390;1;209;117;297;114;69;806
017861958373;1;260;130;178;73;99;740
086434772522;1;275;138;148;120;127;808
020396928407;1;101;194;164;107;93;659
058512675887;1;196;242;288;76;74;876
000840317671;1;141;156;218;116;121;752
069234829137;1;195;284;247;82;129;937
087767171895;1;164;239;150;53;77;683
024366669445;1;119;267;141;90;171;788
070717534321;1;104;205;215;73;79;676
082532569256;1;88;87;259;97;137;668
028045023665;1;173;129;107;54;87;550
008482385865;1;227;88;248;116;137;816
062245935463;1;172;180;109;100;170;731
092075857377;1;262;135;289;99;141;926
042472917823;1;154;178;280;81;128;821
091412342901;1;126;173;206;114;139;758
088224402159;1;213;128;262;96;147;846
010690851551;1;286;107;127;110;67;697
067616454947;1;170;94;266;80;162;772
018719828565;1;174;179;130;76;107;666
001994099144;1;163;223;186;58;146;776
085861992468;1;247;198;196;107;74;822
061732211927;1;285;262;225;51;56;879
063380662315;1;259;241;297;50;106;953
082790005762;1;183;214;249;61;102;809
083014533498;1;129;102;139;95;82;547
007969527771;1;117;95;202;104;78;596
058364690868;1;82;176;178;77;155;668
080103846400;1;255;99;212;94;99;759
035122352535;1;269;258;167;111;93;898
039585357903;1;292;242;288;62;68;952
018624076522;1;288;218;254;59;116;935
042950371129;1;185;123;261;74;98;741
080145849768;1;205;281;281;105;81;953
067216310508;1;126;158;226;112;126;748
056704314012;1;253;222;141;117;142;875
060795171351;1;285;141;91;103;174;794
088947475577;1;282;135;257;57;167;898
099852545270;1;119;199;298;90;76;782
012036703970;1;149;146;296;69;115;775
031676959825;1;168;161;143;110;121;703
044356576559;1;251;85;101;101;105;643
080297471278;1;159;201;231;114;165;870
058142151593;1;257;142;265;100;147;911
054514591973;1;269;177;192;97;135;870
086753280881;1;286;201;192;54;173;906
013565816717;1;180;188;153;64;167;752
000736359054;1;155;177;228;60;119;739
022148738589;1;156;110;114;91;140;611
011133604050;1;232;138;203;64;65;702
083498696258;1;235;242;107;109;93;786
043842198028;1;186;256;207;60;83;792
057944236614;1;139;210;214;55;77;695
000444151405;1;213;164;215;83;139;814
058438950142;1;173;99;218;120;97;707
020234178239;1;183;172;256;58;175;844
090801835139;1;219;182;165;52;57;675
036145268693;1;247;162;266;83;137;895
037038705785;1;184;117;128;100;92;621
087851566285;1;147;158;270;72;167;814
059046103315;1;257;82;278;86;87;790
062412732031;1;224;144;188;88;106;750
058238089723;1;145;270;250;108;153;926
069561474424;1;202;258;117;71;147;795
028154902541;1;120;270;128;69;83;670
052944803640;1;239;116;236;101;150;842
042306110223;1;240;171;152;66;94;723
022162540677;1;89;173;268;68;151;749
079744270943;1;93;267;250;82;170;862
099406498647;1;85;188;227;84;137;721
048213364360;1;134;98;207;67;85;591
094425003348;1;153;259;192;60;67;731
084269194939;1;153;275;235;88;57;808
088649907091;1;184;159;286;58;173;860
058325155664;1;117;115;239;66;109;646
029629971150;1;128;210;253;112;148;851
038208176983;1;107;134;129;80;154;604
050313350313;1;198;88;139;71;100;596
046500457552;1;171;119;101;80;108;579
002466027319;1;126;122;289;92;74;703
086202318184;1;96;174;99;107;145;621
063143199349;1;269;257;156;66;111;859
085065086775;1;249;130;127;105;96;707
039607868121;1;219;237;195;98;137;886
040944188934;1;148;198;210;76;58;690
085292426014;1;214;194;105;119;159;791
094173034374;1;204;212;105;97;56;674
058949143702;1;161;177;262;112;151;863
007505392583;1;160;121;241;91;174;787
071989081161;1;181;158;285;81;65;770
027840587929;1;156;127;275;87;73;718
028618236685;1;181;236;141;59;104;721
096119691833;1;162;171;199;77;62;671
049860169335;1;192;183;153;108;121;757
062142582134;1;153;170;123;59;70;575
093922492916;1;244;90;274;116;164;888
032317603516;1;204;272;217;92;118;903
012441169384;1;165;128;126;113;131;663
088971114792;1;212;266;144;82;163;867
093385385085;1;137;207;288;118;122;872
038403618269;1;228;267;226;65;122;908
097025348919;1;274;187;261;95;133;950
084248895237;1;198;108;264;94;52;716
070390055692;1;254;288;100;111;107;860
060388467886;1;250;84;197;77;110;718
068471881133;1;182;226;186;113;96;803
041458961371;1;108;154;157;73;132;624
079335594753;1;87;259;117;60;162;685
089235457717;1;94;210;199;106;51;660
016006556971;1;233;239;135;107;72;786
047320665472;1;258;160;283;118;104;923
051260893794;1;94;219;164;72;176;725
026217170653;1;224;219;227;92;70;832
046389616230;1;80;139;254;63;54;590
045709581356;1;88;237;264;107;70;766
026134421602;1;143;95;271;73;137;719
046774694410;1;172;196;133;84;103;688
002263908799;1;269;261;265;115;53;963
064208777462;1;173;100;231;103;77;684
057535917689;1;92;167;230;73;170;732
022377700044;1;156;198;282;118;110;864
035186441350;1;178;146;168;110;74;676
056544428282;1;238;228;168;116;100;850
031211206636;1;171;211;149;92;102;725
008418121687;1;118;280;176;56;130;760
082321282846;1;266;101;131;51;136;685
025414981108;1;162;169;287;109;168;895
024414227491;1;219;114;176;51;134;694
027701859677;1;152;167;122;67;73;581
005856828791;1;243;213;191;105;63;815
029132011551;1;235;229;157;70;148;839
060483550884;1;91;154;206;50;148;649
086824566339;1;126;202;240;73;91;732
004184236684;1;240;233;156;93;83;805
099570474333;1;177;274;270;99;118;938
001117850650;1;209;243;180;108;60;800
007883771864;1;269;136;199;82;121;807
082030700132;1;137;244;193;93;115;782
028268977624;1;161;232;97;63;54;607
068070775740;1;115;129;290;66;65;665
039104567379;1;224;84;162;96;124;690
077561053015;1;154;168;298;77;77;774
079199400633;1;181;211;201;76;124;793
000845254353;1;91;144;115;113;100;563
050578607123;1;176;101;198;74;79;628
010222140828;1;215;159;169;62;166;771
039575624973;1;278;282;295;80;50;985
002264538419;1;131;112;150;87;50;530
019198707575;1;210;136;294;57;174;871
063726081857;1;133;252;277;81;140;883
072737856432;1;204;185;220;73;103;785
075680963795;1;244;259;239;106;73;921
041544454897;1;219;200;277;102;145;943
006038886075;1;159;163;111;52;130;615
000983145460;1;127;170;220;94;87;698
090281660595;1;173;162;273;64;92;764
035515534232;1;247;97;136;100;136;716
077363640373;1;136;283;274;109;89;891
005324951550;1;187;113;179;82;123;684
019522190371;1;170;217;267;88;67;809
017595252168;1;109;200;289;78;101;777
020231551833;1;147;209;95;57;97;605
089920895696;1;246;244;283;62;94;929
074950929495;1;268;194;121;96;57;736
043888866219;1;144;140;279;97;100;760
044570096550;1;106;122;213;87;98;626
068741146339;1;80;115;182;103;76;556
065004856845;1;255;108;108;98;150;719
030729197303;1;126;205;113;64;177;685
082511453061;1;158;185;95;96;94;628
019951932991;1;227;109;286;74;151;847
039628494840;1;132;97;244;52;121;646
077363120502;1;91;268;177;76;103;715
085646466118;1;247;181;143;65;50;686
074921432942;1;278;108;282;88;105;861
039719975129;1;175;281;210;57;72;795
073011705252;1;254;153;275;93;164;939
089377429742;1;143;268;94;60;104;669
013001806199;1;277;288;164;103;104;936
016100938825;1;123;197;134;96;156;706
090484991551;1;145;125;194;51;75;590
020547898212;1;279;93;107;72;98;649
040610753526;1;269;103;233;73;121;799
013336845958;1;287;226;225;89;66;893
088238552765;1;138;274;255;55;168;890
077604732032;1;138;232;293;88;53;804
033041155832;1;255;190;179;55;159;838
023055976665;1;253;175;230;99;87;844
076024563090;1;131;136;103;94;111;575
054775224631;1;119;220;163;57;116;675
007725057186;1;201;276;205;76;93;851
071176261813;1;161;284;248;83;53;829
048084864723;1;236;238;170;52;113;809
057149989311;1;219;99;281;68;79;746
087193066515;1;183;111;107;56;130;587
018617999931;1;124;268;189;72;130;783
058742060106;1;110;157;178;101;81;627
098015308466;1;256;137;167;74;130;764
022671205889;1;267;247;276;63;166;1019
033866609451;1;226;282;251;98;116;973
090358345881;1;144;231;100;119;134;728
007880757077;1;265;189;247;51;59;811
014175864316;1;147;283;94;74;116;714
057825783327;1;186;245;221;89;101;842
002653302341;1;136;190;288;112;107;833
087304065224;1;130;169;211;112;126;748
085930902899;1;101;183;146;54;54;538
091285812492;1;226;111;111;78;145;671
067171781862;1;170;283;265;89;127;934
045990094040;1;95;189;287;102;109;782
090222427788;1;292;211;105;87;87;782
007435014898;1;195;228;117;81;107;728
057516981761;1;201;191;195;90;67;744
010124923635;1;213;214;104;90;128;749
079320382696;1;288;143;256;120;145;952
011650555652;1;181;264;289;114;71;919
077684694533;1;229;157;101;82;79;648
032119187453;1;147;111;198;108;151;715
022835189931;1;217;247;95;108;55;722
048659900426;1;110;155;249;95;148;757
025723096193;1;195;279;143;106;123;846
080787708471;1;149;128;262;108;116;763
009980297529;1;135;166;287;72;98;758
065435289981;1;144;270;219;115;127;875
033179257405;1;101;156;165;72;73;567
000717513257;1;148;91;102;69;144;554
063850647153;1;94;112;110;105;154;575
015579136704;1;202;82;179;73;78;614
013361850630;1;243;226;91;78;80;718
018178039543;1;82;91;93;79;143;488
030965309523;1;226;148;203;84;141;802
032400400261;1;122;98;93;113;139;565
044788884906;1;248;120;146;65;132;711
096828925376;1;107;201;251;96;128;783
051917953662;1;241;81;259;60;113;754
008762728042;1;196;272;91;79;54;692
041595007921;1;211;224;213;107;122;877
000370420449;1;255;165;235;55;66;776
009764075760;1;95;177;149;100;175;696
006069439952;1;237;261;149;69;54;770
098301808236;1;236;91;131;63;151;672
047217564830;1;111;189;108;91;111;610
083912289999;1;124;161;159;66;166;676
060836942505;1;106;162;282;67;169;786
032229807563;1;104;207;258;104;130;803
065533969666;1;114;157;166;119;168;724
037194952556;1;209;246;233;65;90;843
081489573445;1;142;113;183;62;50;550
004154008060;1;194;246;125;119;146;830
068218375311;1;277;146;121;55;128;727
066863792503;1;117;191;98;108;111;625
041204651770;1;228;124;94;56;168;670
094523802133;1;130;225;124;80;173;732
028611458598;1;147;94;131;90;173;635
083668490680;1;156;119;178;119;128;700
044149791487;1;164;172;228;97;128;789
078114229877;1;202;242;194;62;53;753
072313166701;1;248;172;104;80;94;698
057518700347;1;127;215;164;120;76;702
058642989054;1;170;91;278;88;95;722
008737878302;1;83;230;210;106;140;769
032481419819;1;226;274;266;108;103;977
089287939289;1;241;108;300;78;141;868
039004299647;1;145;217;297;82;178;919
035898276469;1;233;288;268;63;112;964
065437932928;1;100;260;158;84;146;748
025578277571;1;292;186;138;99;118;833
033773706358;1;212;88;141;69;139;649
010700323191;1;239;174;297;86;64;860
064358757297;1;107;213;278;65;151;814
025610905418;1;288;231;264;69;151;1003
099750270655;1;93;106;179;93;81;552
048788328133;1;208;214;291;113;86;912
039782799679;1;100;112;105;65;96;478
037491824597;1;121;189;123;57;161;651
026852614518;1;155;137;155;51;148;646
048812300052;1;124;255;194;79;79;731
029401961173;1;165;112;298;92;92;759
013129186934;1;198;189;115;112;153;767
086972650032;1;112;84;282;114;78;670
045011057292;1;186;111;167;55;116;635
068729885990;1;222;204;92;108;58;684
093766534911;1;277;83;218;85;139;802
029924512821;1;153;113;160;113;56;595
016536360745;1;155;198;160;82;106;701
025620520253;1;90;271;98;89;167;715
099642789520;1;251;197;225;72;59;804
045778597000;1;186;209;92;54;141;682
050636347600;1;159;130;159;118;73;639
053692411642;1;215;157;220;81;135;808
054396031618;1;152;130;251;115;118;766
088715197398;1;133;108;99;65;55;460
016828833303;1;140;261;227;50;100;778
002030708055;1;246;109;188;102;140;785
088529001485;1;133;270;161;81;156;801
064761105960;1;136;140;131;101;155;663
085239124771;1;248;102;126;109;153;738
014347438977;1;132;167;168;108;150;725
011550875119;1;94;152;92;90;100;528
011587380993;1;196;221;223;100;59;799
094022460852;1;232;184;217;99;52;784
072991887731;1;102;276;197;68;167;810
015559301217;1;157;173;232;75;158;795
049031825248;1;281;137;132;73;171;794
010869297813;1;143;204;133;58;94;632
045085117053;1;244;165;178;105;122;814
073793666470;1;113;194;143;61;66;577
061683537236;1;101;138;260;94;152;745
062546904056;1;289;111;136;74;61;671
091904442404;1;153;110;97;86;71;517
003173397560;1;134;142;215;106;148;745
029699045200;1;228;253;203;110;90;884
046053733668;1;136;183;210;82;80;691
056869779683;1;191;164;292;96;84;827
000365787952;1;121;280;113;81;71;666
044721019988;1;288;235;220;93;69;905
070093629868;1;111;112;182;104;174;683
080783050659;1;127;246;109;76;154;712
050467889578;1;249;156;122;89;93;709
087797900114;1;269;131;158;118;82;758
004033377893;1;133;284;139;55;51;662
046301008489;1;202;267;285;107;110;971
049567228577;1;154;175;97;112;146;684
036369766600;1;170;155;296;86;53;760
095122587948;1;156;274;138;116;59;743
048482985656;1;277;210;275;103;128;993
056101676649;1;257;207;299;55;140;958
038174213278;1;133;122;171;72;105;603
007892599261;1;85;119;206;66;71;547
042129124832;1;203;220;197;52;61;733
012527666591;1;168;145;115;103;145;676
065833771571;1;226;192;105;56;126;705
008980894215;1;213;150;272;88;144;867
022098429754;1;141;161;249;120;57;728
000123951897;1;267;173;275;101;93;909
038381380006;1;259;216;99;73;79;726
027158166537;1;200;216;205;76;132;829
044413840299;1;228;209;110;86;70;703
083984376434;1;115;286;197;72;104;774
075978495934;1;267;113;231;114;125;850
085331668721;1;232;82;213;55;79;661
030676953184;1;203;99;211;95;107;715
006842103589;1;204;155;152;81;57;649
053473127346;1;177;125;221;55;146;724
031357742576;1;140;270;175;57;158;800
073825024626;1;194;137;207;68;144;750
081654030902;1;286;281;245;58;169;1039
039322353112;1;231;84;258;106;161;840
006560420677;1;292;86;297;96;109;880
096825003123;1;277;145;94;119;51;686
079920190495;1;183;227;170;84;133;797
015475910552;1;152;137;161;72;85;607
029898249561;1;167;281;139;76;174;837
006291833871;1;257;122;177;87;62;705
059438437593;1;274;133;210;85;112;814
039640329869;1;126;83;195;82;57;543
030878877832;1;211;198;274;120;58;861
005164088927;1;130;164;137;91;85;607
037826477842;1;187;283;113;66;115;764
080969892757;1;198;142;265;98;108;811
041625645701;1;264;235;255;58;89;901
054244437638;1;208;106;269;55;61;699
090550162564;1;188;281;195;95;66;825
089527970213;1;100;167;111;96;109;583
051738783636;1;289;256;147;69;120;881
020356181678;1;110;143;136;113;170;672
089826387484;1;104;116;106;105;103;534
078682124599;1;125;150;280;95;137;787
069731252524;1;81;253;152;89;87;662
068290521510;1;166;152;101;61;76;556
085908001675;1;142;191;220;97;158;808
055461276747;1;105;265;268;68;50;756
071645299427;1;104;85;141;82;113;525
037826096890;1;107;125;248;106;126;712
096286767523;1;142;225;157;56;76;656
015750731760;1;158;283;164;60;73;738
013200441194;1;135;273;268;104;109;889
033663767720;1;219;92;286;54;91;742
010642884678;1;227;229;182;80;112;830
007466288443;1;143;273;183;103;113;815
047280713818;1;244;104;234;73;135;790
002094583266;1;184;224;218;89;121;836
004787650371;1;203;270;169;110;84;836
046904098100;1;229;110;238;105;178;860
042787238956;1;274;285;205;118;130;1012
018286353036;1;165;165;188;101;57;676
008744471632;1;103;128;146;90;124;591
034741258458;1;209;264;149;58;143;823
054203384763;1;158;278;190;94;154;874
036015566069;1;81;189;178;52;50;550
050420594442;1;224;263;103;105;141;836
037392817075;1;232;205;98;74;137;746
099452853107;1;186;254;278;118;157;993
068905052014;1;118;116;204;80;69;587
082617886515;1;228;166;233;93;100;820
085529220559;1;242;100;118;94;132;686
043339266562;1;228;286;98;100;62;774
064922729041;1;174;249;134;97;95;749
011758334550;1;211;220;182;105;118;836
042111628880;1;245;203;174;114;103;839
097718038367;1;237;279;149;71;160;896
080028821214;1;133;284;298;102;59;876
079600590060;1;266;250;226;109;101;952
067010898081;1;280;241;269;95;76;961
015457560547;1;263;152;141;115;122;793
013592464109;1;203;200;281;64;108;856
041108571577;1;260;125;140;77;50;652
071117379543;1;284;205;243;69;102;903
082813387837;1;223;222;148;94;126;813
009218027189;1;226;251;266;112;91;946
097076666988;1;199;183;294;72;157;905
009824660853;1;152;83;300;71;78;684
043397506978;1;287;144;142;102;158;833
074535890502;1;269;132;240;86;81;808
062177987360;1;122;188;285;90;177;862
099018381018;1;117;104;155;115;131;622
031186989975;1;119;193;213;66;149;740
032880894399;1;279;105;244;99;165;892
032206898037;1;168;245;184;98;141;836
056742171809;1;197;201;127;89;124;738
036418506536;1;97;229;224;60;158;768
042271412722;1;91;163;109;82;168;613
052659206003;1;134;91;226;54;171;676
038077819972;1;172;82;105;74;175;608
057791294420;1;142;276;258;54;79;809
045445862626;1;281;118;292;63;105;859
083184958426;1;190;229;235;101;137;892
009479622302;1;150;100;131;105;112;598
041570444461;1;180;112;90;60;140;582
003121470297;1;100;146;184;104;116;650
000910264111;1;161;139;230;66;143;739
002388228240;1;192;168;235;86;141;822
053533120053;1;121;87;226;105;155;694
078473618080;1;106;111;245;102;96;660
053247337652;1;243;269;218;83;135;948
057975520676;1;137;92;240;118;133;720
009123223734;1;150;115;112;80;121;578
089968839677;1;252;104;205;99;175;835
037821808505;1;83;220;100;116;90;609
012743684296;1;102;216;284;65;119;786
045392984084;1;192;248;268;60;175;943
065517785460;1;160;240;117;93;121;731
083765268471;1;248;184;93;76;50;651
080174177071;1;156;201;193;72;92;714
033949080473;1;166;220;288;77;136;887
010221371427;1;271;215;213;60;149;908
097261958385;1;290;193;105;93;168;849
043674951425;1;200;250;163;79;173;865
005429084763;1;178;81;279;83;171;792
007773631238;1;181;284;182;109;87;843
027657534949;1;143;144;112;73;153;625
073710736430;1;212;114;200;82;90;698
003682035928;1;269;80;94;118;92;653
090179483895;1;283;268;166;95;92;904
075179639713;1;250;95;105;119;130;699
049513115528;1;127;270;269;65;130;861
020310068577;1;183;109;129;93;117;631
061734514259;1;186;138;142;118;133;717
040679422323;1;142;259;105;118;165;789
086744865318;1;118;154;133;99;113;617
024778311272;1;158;203;152;76;155;744
056864524113;1;85;164;237;56;150;692
051357806630;1;146;271;100;78;131;726
091671121864;1;132;277;209;112;103;833
042011080870;1;159;257;128;110;175;829
010187556853;1;257;269;174;70;64;834
012204011751;1;139;147;201;56;144;687
054554054285;1;171;117;232;89;62;671
078421527656;1;267;188;167;111;56;789
012338694725;1;104;200;109;74;54;541
089087240845;1;118;251;233;92;88;782
060382001278;1;139;186;199;84;88;696
045671234603;1;204;131;298;119;127;879
012415864972;1;257;138;177;62;58;692
024037688186;1;118;231;263;71;67;750
093811926206;1;195;166;241;117;91;810
039156551541;1;174;152;150;69;117;662
070288381284;1;136;273;176;78;162;825
026073378924;1;122;187;184;88;142;723
032525711607;1;233;121;206;86;52;698
026559674830;1;168;213;181;88;97;747
088122159468;1;124;251;268;86;137;866
020749507908;1;236;103;300;64;60;763
072801350861;1;266;220;90;87;155;818
057008360400;1;179;255;287;88;117;926
061689909692;1;121;266;109;114;101;711
035987100322;1;261;176;273;56;131;897
012952186643;1;267;103;210;67;113;760
039046680043;1;232;134;297;58;124;845
044492806472;1;128;218;212;74;90;722
043673556091;1;145;275;226;81;145;872
075920773165;1;87;269;256;61;72;745
080080575124;1;84;269;300;73;80;806
020795737987;1;200;120;186;79;59;644
042613855665;1;173;186;162;51;112;684
069398820975;1;133;83;109;89;71;485
055372803993;1;184;281;289;79;51;884
094235788462;1;192;237;252;101;154;936
073866245231;1;201;283;249;53;119;905
019409790012;1;290;131;95;105;110;731
074753703513;1;253;225;227;53;144;902
039041558077;1;251;120;143;111;173;798
043237864529;1;177;226;239;102;56;800
011245678569;1;119;176;233;68;173;769
008068365935;1;146;279;273;68;145;911
023226409349;1;235;242;90;74;84;725
052051933834;1;251;287;192;99;151;980
097021813647;1;257;90;156;54;92;649
060337788565;1;156;198;161;70;139;724
088518118146;1;90;150;199;106;130;675
057627115948;1;123;281;102;72;85;663
039806597669;1;184;181;269;90;111;835
091302835455;1;169;88;294;61;114;726
090498800815;1;288;118;172;120;152;850
060881824251;1;242;86;125;88;173;714
039068856092;1;89;234;267;87;90;767
099395238502;1;285;80;127;80;81;653
079933600099;1;183;151;216;99;118;767
022287674289;1;263;102;267;119;102;853
099358038405;1;172;96;201;84;133;686
062696364722;1;171;266;110;96;160;803
096190101957;1;241;109;274;90;87;801
025082165147;1;117;152;179;67;71;586
005478614934;1;124;176;228;50;115;693
006442044126;1;201;200;285;64;97;847
028241100022;1;171;123;254;101;81;730
020033899385;1;189;200;178;63;140;770
077114942116;1;269;233;192;80;158;932
003833319260;1;149;156;198;58;162;723
042093376459;1;270;116;258;110;133;887
082114433522;1;289;133;97;110;70;699
037506370227;1;89;85;114;97;134;519
050160684150;1;197;193;213;79;147;829
003443023853;1;209;120;194;56;53;632
055950286470;1;219;260;102;52;141;774
001410293657;1;253;154;132;53;136;728
003565614399;1;240;101;122;98;134;695
095032218781;1;244;180;93;111;115;743
027534366732;1;244;129;263;86;92;814
002255846938;1;213;287;178;74;135;887
085442654706;1;227;159;242;99;72;799
037188727017;1;165;259;100;88;146;758
000183102355;1;281;115;289;94;55;834
086316714655;1;280;167;211;88;78;824
000965420175;1;90;268;184;65;147;754
040063264838;1;119;85;287;77;102;670
060164263727;1;192;86;158;113;101;650
003125697862;1;108;286;244;90;176;904
031870404518;1;223;281;213;67;68;852
039930292299;1;137;149;216;107;126;735
036885719854;1;252;167;148;60;172;799
094522442233;1;150;87;287;104;55;683
091093511590;1;156;149;236;118;163;822
038197509573;1;179;90;170;60;165;664
032661498519;1;119;167;192;62;139;679
010392894681;1;165;244;294;113;112;928
083303752448;1;178;115;185;107;86;671
079304760197;1;202;153;257;68;74;754
047544942642;1;291;220;115;111;81;818
076732865225;1;80;116;276;96;114;682
069056172452;1;279;223;96;76;120;794
048157086954;1;281;161;131;106;165;844
009714915143;1;250;186;163;109;137;845
084638302077;1;140;140;124;82;162;648
028929462885;1;277;125;212;87;174;875
031056331856;1;275;172;199;81;138;865
077715983656;1;184;137;134;95;112;662
084744730991;1;161;282;141;106;81;771
098873581973;1;276;227;92;100;166;861
035948378377;1;290;81;227;96;138;832
066672444497;1;276;139;167;120;72;774
073527948741;1;194;125;254;60;115;748
032433677814;1;222;137;296;109;112;876
024800621989;1;158;247;166;75;65;711
019464749568;1;127;87;188;119;69;590
081222818531;1;95;173;135;88;151;642
012180605452;1;288;196;237;84;66;871
029429215181;1;233;154;263;97;109;856
007376704213;1;138;268;153;78;153;790
050131237792;1;234;249;187;98;126;894
088344218018;1;135;278;290;116;143;962
033874066253;1;97;172;100;80;51;500
004067126248;1;103;280;179;80;107;749
023144969302;1;109;133;141;100;153;636
097854567999;1;94;264;209;79;73;719
061636417092;1;140;88;188;80;88;584
038233128664;1;131;262;226;57;114;790
049899350068;1;208;173;153;56;135;725
014022060071;1;244;272;273;103;155;1047
025268601948;1;86;191;186;67;166;696
031557549949;1;258;222;111;65;103;759
048215997956;1;273;91;109;51;150;674
044404898809;1;285;231;263;67;150;996
008297636263;1;155;114;130;89;58;546
004382759902;1;130;275;296;94;65;860
057118392382;1;259;152;102;59;93;665
098599063820;1;229;178;135;52;85;679
001483031905;1;116;267;169;85;52;689
070686371373;1;258;102;197;95;80;732
055465136916;1;283;174;139;103;173;872
050147139641;1;260;204;120;93;129;806
025330997488;1;269;167;188;115;131;870
003637353287;1;135;193;278;108;121;835
029779069149;1;271;82;274;95;101;823
030657895416;1;253;167;226;112;177;935
099190242181;1;97;184;102;65;163;611
022462236113;1;117;245;260;109;160;891
079237904848;1;154;240;217;76;153;840
010400403704;1;266;279;206;71;94;916
031779723559;1;275;138;131;90;57;691
086851387119;1;243;157;186;91;83;760
064188461837;1;289;84;153;69;80;675
071091134415;1;223;265;164;71;128;851
014068469021;1;250;157;280;106;57;850
069499854477;1;151;87;253;112;100;703
051551545193;1;225;255;160;68;126;834
040352326144;1;278;272;90;110;164;914
046399155880;1;217;237;118;85;120;777
007125840942;1;212;194;208;110;155;879
026306355308;1;223;214;93;63;138;731
061898147234;1;94;161;120;62;81;518
094052461053;1;190;129;90;53;142;604
087861653186;1;97;218;183;67;76;641
097425989976;1;230;196;128;114;163;831
012111343616;1;291;204;192;74;134;895
003884835539;1;126;231;186;55;61;659
060492080069;1;206;230;160;80;99;775
057188222204;1;99;89;104;112;164;568
033135344720;1;167;180;283;73;177;880
005932523412;1;187;192;147;64;56;646
085287844678;1;239;246;213;104;146;948
083846013213;1;255;88;292;70;112;817
088502105571;1;259;242;109;97;107;814
048995454762;1;126;146;216;53;85;626
035569032855;1;147;267;260;55;58;787
096976655993;1;247;86;104;80;121;638
066834262360;1;206;260;262;59;128;915
052397638790;1;144;184;259;84;169;840
062129478157;1;223;171;233;96;151;874
057477109412;1;152;282;122;66;176;798
049622365560;1;161;274;159;106;63;763
014888047647;1;155;143;149;87;103;637
072093954640;1;179;265;156;114;162;876
033582779571;1;255;130;146;74;174;779
090121608285;1;81;252;277;64;79;753
059081937136;1;135;101;103;60;88;487
088324194601;1;220;109;262;50;152;793
003466183006;1;127;195;132;69;90;613
059454495238;1;252;224;187;77;158;898
059675216282;1;258;261;200;67;81;867
028347351743;1;105;89;272;62;170;698
044031793117;1;171;117;135;86;115;624
074889061293;1;218;103;228;118;162;829
072644144554;1;93;175;150;90;99;607
001917165583;1;110;130;220;78;107;645
003502769799;1;82;190;151;96;102;621
026257755010;1;234;232;171;58;144;839
008350359945;1;95;193;285;111;92;776
039851933450;1;279;132;283;110;98;902
026192298060;1;257;96;134;60;85;632
047043282699;1;204;273;143;92;145;857
021995583141;1;148;99;111;80;124;562
073346743540;1;218;282;137;85;59;781
011765845144;1;132;258;181;116;81;768
088218860777;1;188;139;206;120;58;711
080440641102;1;228;173;211;79;78;769
064138506280;1;266;232;174;105;54;831
010981476649;1;242;277;179;97;109;904
050452403424;1;200;237;292;110;104;943
077404533494;1;120;220;171;66;112;689
014359907780;1;284;174;261;75;136;930
052284921251;1;201;216;277;63;51;808
059295800723;1;122;266;188;86;175;837
078876430645;1;168;238;286;69;83;844
014659900578;1;119;102;173;89;125;608
021522366732;1;260;139;143;74;136;752
043044359621;1;147;283;200;76;64;770
045713646175;1;236;132;186;75;88;717
074913552996;1;116;227;193;105;73;714
013862601493;1;257;93;224;89;121;784
084362633606;1;284;88;270;87;87;816
096128868007;1;284;92;146;64;76;662
007162146956;1;173;112;299;103;117;804
033788719259;1;291;190;259;68;51;859
065579349704;1;268;185;138;68;122;781
052076593415;1;257;138;279;104;63;841
076570146169;1;176;175;110;77;110;648
065216132975;1;198;87;190;92;173;740
024239204283;1;286;259;142;105;83;875
010337631278;1;104;215;292;66;177;854
015409455276;1;153;110;133;120;133;649
066078840285;1;290;187;167;82;111;837
091726031001;1;99;88;172;57;159;575
003568175556;1;267;113;145;111;169;805
053863634608;1;274;186;274;82;170;986
099724321502;1;212;156;290;55;133;846
082933024295;1;210;95;226;60;67;658
006781188814;1;183;159;126;61;123;652
068559432710;1;257;161;104;84;85;691
017153606114;1;262;140;165;93;60;720
018340462276;1;172;201;274;81;64;792
027542748644;1;245;91;216;92;69;713
010967783785;1;196;224;241;106;175;942
024272779495;1;153;92;264;53;99;661
013141508311;1;286;218;168;88;146;906
057186166358;1;250;261;93;115;118;837
070153686344;1;123;133;180;51;146;633
029859206857;1;182;85;272;97;159;795
002680513671;1;170;269;187;108;55;789
040703181772;1;207;115;109;68;145;644
065465092231;1;203;267;174;98;54;796
028864301612;1;226;133;159;53;132;703
080883689338;1;123;137;219;101;57;637
045100139544;1;275;120;243;110;163;911
038242146734;1;241;188;96;62;112;699
083267348151;1;159;259;142;109;117;786
012065905989;1;115;182;126;90;52;565
052261911154;1;235;146;224;76;120;801
070240293009;1;200;146;255;105;78;784
071535926260;1;156;211;187;108;171;833
075622594869;1;274;232;117;67;79;769
078791551615;1;206;225;291;79;72;873
082456065150;1;176;150;225;107;113;771
050779671446;1;215;196;209;62;112;794
039753011160;1;241;234;116;78;131;800
026228097369;1;260;213;229;54;73;829
089330449499;1;252;166;135;70;52;675
089881339466;1;219;103;103;83;92;600
060258230857;1;218;198;291;69;83;859
043202483779;1;141;152;153;57;177;680
034509342433;1;268;100;162;84;68;682
005529332135;1;113;260;266;95;142;876
062344773142;1;200;94;244;69;66;673
083660388844;1;257;256;102;115;60;790
041596724822;1;292;189;229;82;51;843
038064566777;1;249;106;120;86;107;668
026283581384;1;109;235;152;96;122;714
084779732126;1;102;223;118;113;88;644
021919071749;1;210;232;127;112;74;755
065186833710;1;201;238;113;78;56;686
093284684429;1;160;182;159;50;98;649
043840038066;1;103;220;194;61;81;659
083474629030;1;210;146;192;62;57;667
036546006397;1;124;124;168;89;93;598
066071039264;1;134;97;217;111;113;672
010526143294;1;223;174;130;114;52;693
070109707327;1;107;110;270;113;150;750
090524466406;1;247;240;153;116;60;816
029404056642;1;174;120;252;70;53;669
027348360076;1;164;188;291;84;102;829
079394637503;1;207;142;239;70;142;800
095138023032;1;159;248;118;51;152;728
035684197039;1;107;89;208;88;118;610
013130324461;1;286;190;165;52;173;866
084705044732;1;174;95;284;71;155;779
008008626284;1;87;276;242;63;132;800
044506135411;1;237;118;208;66;65;694
055130612647;1;244;237;289;110;130;1010
006006250049;1;114;288;212;111;131;856
093876264778;1;212;113;120;101;133;679
096432339379;1;291;287;124;114;75;891
093316876238;1;145;88;217;103;153;706
089804474874;1;212;263;102;95;62;734
049887756586;1;190;219;234;100;177;920
002436154609;1;182;150;194;92;89;707
070873789206;1;103;213;204;101;106;727
011904855707;1;143;121;102;66;76;508
028333261304;1;208;80;138;53;124;603
068515748759;1;204;190;285;120;135;934
066823810734;1;230;256;170;63;100;819
039708407271;1;259;80;249;61;143;792
037497164986;1;101;189;207;63;56;616
001085473710;1;168;119;127;97;105;616
052782480700;1;232;212;178;115;132;869
012181668208;1;283;158;286;102;65;894
059955372707;1;278;236;231;66;111;922
053035781327;1;132;155;117;94;163;661
053797575909;1;108;91;164;77;138;578
060776472720;1;87;143;189;118;118;655
036129934012;1;137;125;95;87;165;609
027041457006;1;169;106;245;82;85;687
048673448360;1;154;229;101;95;101;680
093828410859;1;259;116;243;57;151;826
031020612943;1;140;282;139;101;140;802
011818724032;1;150;131;293;76;53;703
023946978964;1;261;95;282;102;118;858
046196545250;1;238;285;140;82;147;892
093230295655;1;81;132;244;71;116;644
089402034921;1;205;107;113;72;97;594
039447340789;1;108;150;262;93;132;745
031925493930;1;84;209;153;85;163;694
066884142375;1;189;95;203;53;82;622
067430335319;1;199;133;300;70;176;878
001001343350;1;132;104;113;91;137;577
004326209972;1;203;209;211;91;108;822
050330576781;1;183;89;251;84;51;658
007040213871;1;184;201;260;102;50;797
086413753975;1;235;185;265;71;167;923
056256508698;1;201;120;171;68;116;676
054847841637;1;146;286;149;50;103;734
018969695514;1;270;87;144;71;68;640
059275685081;1;192;259;298;108;67;924
071631312818;1;173;246;231;105;168;923
022048417488;1;109;270;124;69;107;679
098492475334;1;192;142;201;72;83;690
036135251114;1;181;251;107;53;61;653
004664046448;1;148;100;122;74;68;512
086243967587;1;264;109;105;51;101;630
022943121662;1;236;154;193;90;138;811
099565355308;1;102;156;94;112;118;582
072804297797;1;270;197;135;103;148;853
028953483288;1;282;97;184;113;80;756
056112575117;1;91;128;228;62;163;672
037557979673;1;184;215;207;96;125;827
030536131392;1;109;264;286;86;103;848
046952254603;1;219;276;112;54;127;788
038520765648;1;171;200;271;116;155;913
080973224647;1;148;239;255;91;155;888
004989824463;1;248;125;296;54;78;801
071329716781;1;266;146;237;113;141;903
030268579650;1;88;81;197;103;169;638
035489483109;1;174;223;227;79;72;775
078899137790;1;110;188;207;116;121;742
020771949479;1;166;172;185;97;65;685
078533611369;1;120;87;112;90;54;463
012470172496;1;280;197;259;94;125;955
040542861794;1;248;218;228;86;66;846
031540135864;1;226;189;258;120;123;916
084452678254;1;123;159;161;110;102;655
046259540631;1;145;225;174;115;121;780
039531301526;1;103;166;104;103;89;565
057197364243;1;115;245;282;119;155;916
066166381600;1;289;122;277;71;160;919
071126478620;1;204;175;189;89;119;776
047640067947;1;176;175;269;61;119;800
095196657999;1;105;260;263;102;121;851
010910138752;1;250;139;293;65;172;919
089540512341;1;234;140;227;90;92;783
014774953566;1;182;114;281;91;105;773
081846224832;1;286;120;96;77;160;739
071318153162;1;116;269;170;81;165;801
061964443323;1;105;131;144;61;127;568
054441842134;1;81;139;215;84;69;588
013261208042;1;176;287;102;52;111;728
008546892885;1;174;279;190;110;150;903
083559453648;1;242;195;150;52;109;748
082963706051;1;285;236;273;73;136;1003
031287407767;1;90;271;192;120;170;843
087332578737;1;239;216;234;81;82;852
083740953295;1;176;93;163;113;129;674
056281929059;1;264;272;210;72;111;929
037701141895;1;221;150;252;60;53;736
074018995473;1;89;85;187;74;147;582
025393963716;1;100;162;97;54;68;481
036458170051;1;287;266;199;94;138;984
023965888099;1;183;113;158;88;131;673
051163287846;1;252;211;252;107;142;964
064529056076;1;111;209;129;51;106;606
068345467147;1;143;171;162;76;70;622
049578564100;1;124;187;218;110;159;798
038911288537;1;241;101;121;68;138;669
095751780807;1;161;264;109;105;160;799
095545045268;1;176;171;163;81;130;721
073879381821;1;204;127;210;105;51;697
060661176563;1;238;83;127;89;138;675
024098533020;1;219;228;125;106;98;776
089283774556;1;234;104;134;56;109;637
067184975001;1;139;107;244;108;75;673
092070048006;1;112;174;103;101;76;566
030005509084;1;105;228;273;118;102;826
004847184072;1;150;80;280;81;117;708
023681472114;1;288;211;155;56;61;771
019821865363;1;172;99;220;65;151;707
097537676995;1;201;230;161;52;171;815
081502950676;1;184;210;165;56;89;704
018933642670;1;109;236;125;77;159;706
041065127928;1;221;167;133;80;62;663
015170596725;1;219;218;208;53;165;863
007433770392;1;236;205;181;98;178;898
050843750640;1;98;189;228;94;107;716
086693585411;1;239;205;156;99;164;863
023829313906;1;197;106;209;75;95;682
026136652550;1;278;199;277;115;116;985
015176255576;1;99;264;241;83;69;756
062885562590;1;253;250;154;120;170;947
061218066054;1;85;203;268;92;90;738
054768542470;1;146;285;230;118;110;889
011788219128;1;248;89;122;78;89;626
055354364556;1;117;265;250;99;139;870
028431392692;1;224;281;151;54;120;830
029932253094;1;210;288;120;75;88;781
021205099157;1;103;243;248;107;73;774
069952762206;1;98;94;287;85;148;712
087179443966;1;93;167;118;91;163;632
000906066078;1;173;126;263;89;54;705
023842496104;1;238;243;295;60;133;969
047220684345;1;273;244;280;64;132;993
030786625204;1;136;179;114;104;170;703
047254552746;1;118;140;280;117;151;806
048626710572;1;83;264;232;119;163;861
084794125397;1;160;261;133;69;155;778
076375948501;1;81;141;105;51;129;507
060608322380;1;270;194;120;52;74;710
037747444457;1;232;157;200;53;133;775
036469961167;1;134;105;240;76;50;605
026937298036;1;221;275;232;87;164;979
020453485861;1;211;124;153;112;144;744
042797376380;1;235;224;280;106;175;1020
048070216987;1;239;194;97;97;104;731
026351808475;1;181;181;168;52;167;749
013642968005;1;191;271;267;116;145;990
080512947400;1;146;196;103;89;165;699
004331649862;1;198;142;183;104;163;790
013180114729;1;127;285;298;76;119;905
074471856840;1;230;259;233;86;138;946
078164556489;1;264;162;188;65;167;846
069173703748;1;248;240;172;100;144;904
069546584947;1;254;206;188;96;87;831
009300158738;1;191;115;137;96;81;620
003382549644;1;130;242;287;79;149;887
039640534836;1;270;166;170;55;88;749
080505399777;1;82;192;226;90;62;652
084973687681;1;234;159;226;80;140;839
052364177551;1;121;263;137;89;56;666
003078493772;1;251;220;292;120;97;980
029162246724;1;178;168;249;60;157;812
060194635184;1;253;251;143;69;132;848
011143750843;1;83;232;170;79;159;723
057524542427;1;245;117;143;50;150;705
052372645315;1;277;233;91;90;93;784
076883828120;1;176;194;289;55;62;776
043794214258;1;267;83;96;80;83;609
089613781607;1;287;108;150;108;148;801
068856763023;1;94;271;280;109;168;922
066684438457;1;81;226;292;118;107;824
061026723539;1;162;256;117;77;174;786
053830163399;1;223;178;247;61;83;792
088993850026;1;245;285;92;92;156;870
019145544219;1;126;103;100;113;101;543
037074262666;1;260;190;216;98;129;893
077171882767;1;148;226;167;68;152;761
001031717382;1;86;255;110;70;127;648
093597072419;1;269;206;167;114;107;863
027558840960;1;115;95;129;110;120;569
017220799741;1;186;218;221;65;145;835
053838408973;1;190;83;254;115;124;766
020511718368;1;122;137;283;82;148;772
060554297009;1;96;172;165;83;121;637
043377008797;1;107;129;274;87;54;651
043541678915;1;118;248;190;115;174;845
019090892679;1;239;238;274;74;68;893
009271859424;1;279;138;132;99;119;767
013284486111;1;151;92;274;88;94;699
056693456869;1;114;247;206;114;148;829
021670347037;1;87;169;112;53;148;569
083069281018;1;240;254;162;98;98;852
006940744591;1;122;270;136;84;110;722
096413468696;1;94;195;180;69;74;612
095094492653;1;273;93;261;71;91;789
011717648620;1;196;80;168;50;63;557
074267624022;1;267;274;244;61;121;967
048390640961;1;257;103;219;95;117;791
076576541925;1;147;145;104;103;172;671
038834216650;1;288;159;110;115;159;831
081472424938;1;97;104;130;106;136;573
067232089438;1;85;125;216;104;110;640
019655720149;1;288;150;249;117;113;917
091564126091;1;230;180;173;67;98;748
058171832717;1;87;147;156;82;173;645
095357382404;1;242;115;264;61;51;733
082545994423;1;271;179;147;119;154;870
007177257944;1;141;286;131;70;161;789
079999780833;1;207;284;271;84;120;966
003070818640;1;120;133;143;101;65;562
053995114533;1;263;209;94;87;168;821
083939549517;1;122;80;155;76;148;581
046511742519;1;273;109;290;57;100;829
039779641798;1;136;106;244;91;117;694
000675450889;1;104;187;200;53;159;703
086629235262;1;256;220;243;54;97;870
028080945464;1;147;171;274;57;152;801
098590936342;1;198;221;164;101;133;817
035591155835;1;88;115;224;72;114;613
052952206302;1;167;204;170;101;171;813
038753030088;1;90;211;191;54;138;684
032375721775;1;83;243;104;120;145;695
041665361686;1;93;184;96;78;115;566
043400539686;1;112;108;233;67;165;685
054010127874;1;120;83;104;50;72;429
084481796647;1;86;100;156;64;116;522
037498703118;1;185;231;159;100;95;770
094015851088;1;81;192;199;85;151;708
065644700092;1;94;232;131;64;82;603
065979681448;1;130;156;279;86;143;794
089745449719;1;138;147;206;67;50;608
038806011152;1;164;228;210;75;93;770
043193548309;1;182;120;278;94;130;804
005411407440;1;195;250;151;77;151;824
025252079597;1;195;256;254;95;74;874
011275387861;1;165;178;103;98;138;682
003960284737;1;194;198;237;99;164;892
082323646574;1;208;223;153;104;101;789
048930813456;1;233;266;296;93;171;1059
068212490132;1;170;232;103;111;171;787
070287821260;1;229;84;177;110;149;749
054481579941;1;180;89;300;62;161;792
096525864883;1;254;256;118;53;51;732
025268762513;1;252;100;128;78;57;615
023941558256;1;271;270;198;50;73;862
098888050239;1;267;150;196;95;108;816
070351536196;1;107;286;249;55;106;803
037130729046;1;131;126;134;56;113;560
082891784287;1;267;173;133;74;161;808
076509717666;1;200;262;300;50;56;868
094672223169;1;248;93;91;118;77;627
079896724041;1;99;86;248;103;61;597
047102723914;1;158;212;255;103;138;866
052802114331;1;168;204;118;51;164;705
060482430588;1;171;154;205;102;103;735
052809762724;1;129;239;300;82;167;917
037018747991;1;232;226;162;65;128;813
004981078372;1;286;264;279;107;126;1062
026173315258;1;287;231;144;111;149;922
091296688195;1;140;175;184;68;96;663
062742078640;1;197;206;228;85;143;859
041550140567;1;107;143;285;86;101;722
074064365672;1;267;242;149;116;62;836
067988355931;1;93;138;234;59;95;619
055959429885;1;198;186;279;101;68;832
023747328863;1;213;214;190;95;70;782
076673030954;1;94;119;114;119;110;556
027115021362;1;147;100;109;108;126;590
018866175705;1;270;287;199;111;100;967
006010759678;1;231;85;258;91;114;779
048089394772;1;258;126;283;71;160;898
096500552819;1;242;157;219;99;86;803
002978913115;1;150;144;300;102;115;811
039968277054;1;207;157;101;114;119;698
074829819755;1;160;202;167;82;152;763
090294326486;1;247;144;187;119;87;784
035911702462;1;120;241;290;71;170;892
073566133144;1;141;280;180;79;152;832
046243190635;1;159;268;138;99;168;832
064575466276;1;199;127;300;118;88;832
031985743693;1;186;223;223;79;173;884
054114731667;1;102;136;123;51;146;558
034278394930;1;252;279;290;50;120;991
078813439511;1;259;224;133;114;173;903
013046179861;1;228;220;290;119;84;941
003374965517;1;195;233;195;87;93;803
093810795450;1;225;115;240;64;115;759
069781643081;1;151;228;209;72;74;734
031862880757;1;220;107;269;50;105;751
026648077921;1;80;110;166;70;142;568
083090546562;1;106;108;156;73;170;613
066366375454;1;203;186;175;85;168;817
053865509456;1;251;94;175;81;152;753
019465550157;1;114;182;116;51;52;515
029234597448;1;222;173;279;78;139;891
072471498126;1;145;228;292;67;129;861
097874777755;1;270;143;288;78;115;894
031789654955;1;180;131;286;69;104;770
016520843090;1;245;193;249;75;92;854
047012914681;1;134;157;99;110;94;594
030075003275;1;158;193;142;90;135;718
044620607534;1;83;228;93;64;97;565
020268687677;1;222;124;214;90;174;824
047144012129;1;222;169;273;57;119;840
050974577710;1;209;177;185;84;105;760
014818065078;1;192;224;270;75;152;913
069333374633;1;131;279;155;90;120;775
078567788932;1;237;106;215;74;147;779
079382346215;1;122;95;147;115;158;637
029468558906;1;196;81;95;78;115;565
093627950336;1;220;281;243;50;156;950
096332080840;1;207;284;107;108;65;771
027918606503;1;188;162;248;62;167;827
032339311604;1;182;226;269;114;138;929
052069932950;1;156;224;219;86;150;835
043213661662;1;131;252;209;70;140;802
030419163978;1;147;253;202;58;101;761
025756387497;1;201;265;298;92;73;929
058709216933;1;147;242;297;64;144;894
009770982049;1;179;184;195;54;147;759
068192147446;1;202;121;119;87;113;642
058825693203;1;84;146;234;71;128;663
078847986895;1;136;239;262;75;162;874
095399575739;1;84;95;220;99;96;594
053610602076;1;227;135;107;74;119;662
050065568187;1;184;98;263;81;152;778
094642534078;1;165;169;195;91;175;795
093885840997;1;175;90;178;87;144;674
067948444912;1;291;257;147;98;61;854
005277237870;1;235;272;267;60;69;903
091550496107;1;251;203;93;76;118;741
072830128903;1;234;124;160;67;144;729
040568851171;1;247;107;187;89;146;776
067127235855;1;206;138;266;100;90;800
067983243417;1;101;169;126;67;119;582
026211403141;1;238;238;299;52;70;897
079484995611;1;156;263;119;76;154;768
082898787355;1;220;248;182;58;172;880
058093231984;1;249;198;143;84;58;732
041104073717;1;199;100;157;93;73;622
031772862510;1;181;124;241;88;157;791
094550766207;1;173;165;183;80;171;772
098866532811;1;227;143;128;91;87;676
020394503481;1;218;169;152;93;53;685
089993560174;1;253;247;290;118;149;1057
087405427660;1;283;222;244;89;132;970
070587134849;1;151;255;170;51;82;709
031951203836;1;106;230;102;99;61;598
074889216184;1;157;234;207;78;174;850
061022403054;1;185;286;246;104;75;896
023856500257;1;223;138;284;103;112;860
088192387251;1;183;220;208;118;101;830
042089252402;1;112;125;224;51;97;609
056774462737;1;187;231;241;93;112;864
096626320692;1;90;208;274;95;106;773
091282858360;1;274;278;221;51;110;934
002663429131;1;163;176;207;108;84;738
007548460286;1;251;228;193;112;73;857
048938510206;1;266;283;200;108;83;940
013479527688;1;222;247;111;102;72;754
074250249167;1;171;162;126;90;54;603
022642052173;1;254;88;191;84;57;674
068844261220;1;128;151;174;69;76;598
091106236837;1;192;284;160;69;57;762
005444302638;1;278;151;268;82;129;908
097545136891;1;175;264;214;90;125;868
015997850885;1;110;107;237;113;103;670
075175007362;1;142;275;148;86;50;701
036938961721;1;278;226;234;101;105;944
031973509895;1;247;237;243;63;151;941
077966684201;1;291;244;91;50;95;771
091389492056;1;153;196;160;71;117;697
040056753092;1;150;175;207;99;111;742
044983184628;1;209;233;272;74;162;950
076480223613;1;224;202;212;56;153;847
020575792771;1;150;202;281;75;105;813
060031576620;1;267;264;247;71;142;991
032911843860;1;165;180;163;71;95;674
011781378647;1;109;85;182;71;166;613
016181572667;1;110;87;144;111;137;589
054719390388;1;88;131;274;90;141;724
013170548154;1;196;258;208;87;75;824
005742010741;1;97;251;176;119;159;802
014490636878;1;250;200;249;78;99;876
003098009873;1;231;150;167;94;154;796
087673990594;1;86;256;141;90;153;726
010233110196;1;250;188;113;93;76;720
039102464378;1;209;212;298;74;129;922
040809282939;1;170;206;247;101;101;825
010293243928;1;165;158;140;79;55;597
015442655945;1;290;105;242;66;132;835
067397702056;1;272;170;294;98;169;1003
028616198883;1;87;91;121;97;121;517
070542023111;1;141;178;298;54;147;818
082226255756;1;274;83;282;60;64;763
039552415737;1;187;279;272;71;138;947
034718691305;1;288;107;93;90;90;668
060442342952;1;231;160;92;50;104;637
030093465803;1;277;190;170;114;139;890
072616357376;1;231;83;278;57;159;808
068543914366;1;125;170;118;91;149;653
093328296320;1;179;163;225;59;129;755
090456482972;1;229;251;290;100;74;944
044593502731;1;191;198;294;114;135;932
055374774197;1;198;167;252;52;122;791
081350362590;1;263;281;218;120;119;1001
015168396902;1;229;271;131;78;116;825
022027612594;1;202;162;161;56;175;756
031469803466;1;160;226;200;76;178;840
033590878959;1;82;86;175;79;128;550
048910951391;1;211;270;268;114;127;990
083565964385;1;185;155;138;59;111;648
072400035960;1;222;122;136;54;167;701
042385683414;1;204;160;123;66;67;620
051726883398;1;82;286;129;63;69;629
032864709709;1;108;154;288;82;123;755
022065226837;1;162;123;218;112;144;759
034756502037;1;158;213;237;66;152;826
080883418220;1;188;206;97;63;63;617
012284694961;1;99;156;90;113;111;569
010576771779;1;272;238;247;77;149;983
070575494488;1;239;144;147;88;86;704
023899717456;1;288;283;292;79;159;1101
054954152345;1;272;118;154;98;144;786
081559904595;1;202;88;245;55;86;676
043072041987;1;275;234;221;70;151;951
088100225668;1;181;121;182;53;75;612
058312388512;1;166;216;255;117;177;931
015535366845;1;189;158;121;68;170;706
087336764695;1;120;80;169;107;83;559
097934446335;1;267;144;109;53;108;681
062889332227;1;109;279;256;71;111;826
031766436689;1;261;114;280;104;147;906
017452493084;1;88;169;109;118;151;635
013663914732;1;86;106;114;82;55;443
021624442567;1;88;132;128;76;170;594
028648220004;1;258;277;279;64;167;1045
009570569758;1;159;87;278;89;161;774
038440411512;1;221;279;132;102;144;878
057651288847;1;277;262;204;85;152;980
086407881942;1;275;170;176;57;131;809
045384668894;1;183;95;105;111;70;564
034213627849;1;219;117;227;90;170;823
010510205706;1;256;247;99;76;71;749
071673521388;1;96;227;283;105;146;857
017403676573;1;89;199;160;60;98;606
060218031360;1;124;195;165;111;132;727
051240445059;1;276;220;296;51;148;991
002698216622;1;82;167;164;80;136;629
067354108603;1;122;237;194;79;119;751
010857932401;1;101;193;241;115;124;774
087491418579;1;217;126;211;106;117;777
076854282057;1;256;161;128;68;112;725
095096219193;1;260;85;209;75;165;794
073188154404;1;80;283;264;74;121;822
079159075500;1;291;185;189;55;136;856
055915109642;1;282;186;112;66;99;745
010855051869;1;166;263;155;83;76;743
077778901303;1;240;118;137;83;124;702
055578212043;1;171;149;142;78;56;596
079602194018;1;281;286;191;116;92;966
006560140905;1;121;176;235;83;79;694
054763899587;1;178;83;180;105;132;678
061409750093;1;163;90;122;115;138;628
068627899588;1;84;279;209;51;146;769
082678127526;1;290;196;113;114;170;883
066873996927;1;125;192;178;113;93;701
083015909294;1;114;91;177;67;64;513
064902455984;1;258;110;228;58;78;732
070752952816;1;267;186;140;55;67;715
040286824557;1;152;199;139;67;135;692
077641383473;1;131;240;250;97;71;789
046508304567;1;83;163;109;50;167;572
040851651174;1;268;215;111;100;156;850
045076217785;1;255;99;101;54;161;670
090193943665;1;182;157;258;59;105;761
023258150599;1;190;230;137;98;110;765
087438599564;1;198;122;132;91;142;685
058236516985;1;100;240;146;78;89;653
024467567622;1;168;215;130;100;114;727
036334331808;1;281;93;153;70;144;741
001099874173;1;239;227;272;110;111;959
006644604834;1;208;87;224;67;52;638
050233481926;1;151;101;197;58;141;648
085407783996;1;223;210;105;109;98;745
034153297584;1;89;229;91;98;84;591
065182311385;1;89;263;224;75;98;749
011234568406;1;116;268;205;105;111;805
024706270853;1;119;274;215;112;97;817
050706696178;1;288;234;113;50;158;843
043967900126;1;126;154;101;69;102;552
035626952505;1;195;208;103;113;68;687
099568226915;1;83;207;265;60;159;774
030697140746;1;289;281;188;111;147;1016
094085196953;1;104;98;130;116;111;559
058264445434;1;236;215;118;59;94;722
066198761170;1;217;246;175;91;133;862
083867433987;1;95;152;239;70;81;637
010472242400;1;159;172;158;88;52;629
028810444918;1;278;249;172;114;53;866
074575366580;1;239;134;155;52;75;655
013851287295;1;165;254;110;102;136;767
041934071165;1;110;122;279;52;154;717
097062675923;1;109;195;278;111;118;811
066462384903;1;272;161;257;57;178;925
098541609126;1;176;146;272;75;65;734
019367234100;1;238;229;296;95;121;979
091781082548;1;270;278;243;98;144;1033
068884061277;1;128;178;176;113;87;682
034950699130;1;232;239;291;116;112;990
023732210553;1;184;204;147;114;64;713
054837548887;1;99;120;134;74;62;489
088711939007;1;82;81;107;105;81;456
067247906964;1;278;121;130;79;116;724
022317799246;1;216;133;196;50;107;702
096715214338;1;257;133;276;66;59;791
070414559672;1;161;236;299;112;164;972
066059126340;1;148;168;152;73;101;642
041556983145;1;231;154;108;58;63;614
009086545504;1;245;94;238;115;129;821
096768115428;1;96;81;103;89;144;513
074550455521;1;142;203;214;107;165;831
037553067276;1;284;170;126;77;90;747
049777345199;1;277;259;300;52;116;1004
098616924683;1;182;269;263;83;146;943
019627625667;1;82;220;206;73;122;703
008212342380;1;279;267;279;66;80;971
089415194833;1;119;229;226;59;79;712
040280028856;1;81;105;136;120;170;612
097987893197;1;174;288;140;93;163;858
063864458605;1;148;283;263;54;133;881
055320093334;1;229;225;103;99;91;747
086632280431;1;216;150;236;93;156;851
059928102392;1;225;171;289;52;112;849
046140704489;1;282;162;283;76;71;874
096601382819;1;140;274;101;87;63;665
015046702473;1;96;82;112;108;161;559
090325474007;1;123;153;222;107;142;747
095982342963;1;198;114;281;71;174;838
051320033531;1;140;231;111;88;54;624
009756070801;1;177;160;207;80;162;786
097320727364;1;212;251;167;67;161;858
016960094145;1;262;90;225;92;142;811
090049982958;1;112;222;149;60;66;609
042172617245;1;171;266;272;70;55;834
096505302697;1;144;268;192;66;50;720
017947763052;1;154;191;288;109;156;898
066907911711;1;213;205;110;120;144;792
081378694659;1;94;230;91;104;111;630
010212820594;1;278;135;157;93;101;764
027758770693;1;180;95;244;67;112;698
052025640459;1;244;244;217;104;129;938
011606023499;1;270;120;111;96;117;714
065741733327;1;160;224;171;94;67;716
051930594020;1;194;123;271;102;56;746
055559720962;1;227;198;97;79;122;723
086278568896;1;269;285;146;89;121;910
081870551289;1;95;168;155;115;140;673
047024257005;1;267;157;248;82;128;882
050281594217;1;212;283;192;50;147;884
037906001012;1;292;95;254;53;167;861
076590607580;1;120;209;219;65;73;686
085052957911;1;175;230;281;102;71;859
008898305757;1;94;236;126;105;54;615
061210721817;1;96;233;109;110;171;719
012722877897;1;173;280;199;75;111;838
003001189829;1;242;254;97;53;72;718
088133117181;1;199;241;287;104;117;948
051114830254;1;269;174;132;77;131;783
003556950784;1;200;200;126;77;88;691
058826660811;1;112;241;109;99;104;665
059637940117;1;291;243;253;57;109;953
015622683891;1;288;240;229;112;125;994
011193393808;1;269;80;276;60;55;740
061714485841;1;169;148;111;69;166;663
086350922043;1;133;148;203;72;172;728
031522560448;1;178;202;126;53;175;734
017086928444;1;133;87;265;87;61;633
054888751208;1;291;169;236;99;53;848
077078141484;1;100;200;121;89;110;620
077630704909;1;253;81;135;100;168;737
063019158797;1;282;105;262;83;78;810
066513164858;1;229;138;190;54;111;722
052242751365;1;234;139;249;71;110;803
041191081627;1;147;96;151;116;145;655
025970462029;1;292;248;175;88;155;958
053676486507;1;277;147;155;80;54;713
001344336378;1;109;136;168;83;128;624
007051950050;1;236;240;175;92;155;898
011496301106;1;276;165;270;86;88;885
082134190308;1;136;176;180;60;56;608
098885018265;1;233;92;266;92;59;742
016778025369;1;235;272;223;60;117;907
070005178260;1;218;229;269;112;129;957
067699515237;1;125;90;156;90;70;531
041178333815;1;90;207;282;115;50;744
038565155988;1;249;138;194;84;119;784
083022329823;1;172;255;218;89;100;834
001633222106;1;262;236;214;97;54;863
042179972762;1;256;198;217;54;119;844
074998732233;1;113;280;206;62;69;730
058250976211;1;119;167;167;116;176;745
090942811256;1;124;135;280;77;70;686
044905826131;1;146;209;276;95;88;814
021158829826;1;212;177;240;64;71;764
042139241730;1;243;100;238;111;137;829
059419123915;1;251;196;154;82;122;805
083459604972;1;93;246;147;75;78;639
052988767598;1;191;92;252;72;90;697
001932700064;1;255;193;235;50;50;783
044763622019;1;170;168;194;99;61;692
031170030103;1;291;139;146;113;177;866
052501978661;1;165;159;285;107;82;798
001461594265;1;241;102;216;111;170;840
028473477690;1;99;125;163;85;109;581
043746712377;1;175;183;118;117;51;644
013417240101;1;127;231;166;67;96;687
094846471445;1;211;84;268;86;146;795
013188958245;1;100;109;126;92;160;587
038811305490;1;83;207;136;85;108;619
091251542003;1;222;242;182;50;75;771
064358044128;1;260;254;94;86;144;838
031355899294;1;104;214;93;105;149;665
034901927002;1;221;264;189;64;74;812
095503902309;1;209;206;131;74;174;794
040072194174;1;114;242;176;73;76;681
062905761639;1;249;231;264;115;97;956
060325554838;1;281;260;145;105;93;884
045196681047;1;291;188;201;79;128;887
088435324441;1;124;95;173;98;142;632
068988688952;1;162;243;230;86;77;798
092829472654;1;257;261;146;117;141;922
073587612719;1;287;232;143;95;128;885
059382917268;1;245;149;232;68;169;863
037116083139;1;247;135;160;79;178;799
067918740405;1;242;100;189;71;89;691
040177110815;1;83;89;177;111;143;603
053028219131;1;121;256;115;117;164;773
086410538816;1;284;232;278;102;125;1021
059959509146;1;142;132;155;110;140;679
002476662591;1;158;248;241;63;137;847
002777891466;1;86;153;246;68;143;696
080836396967;1;206;112;220;94;128;760
084850739078;1;100;85;188;87;122;582
004610257990;1;280;107;291;98;169;945
018299094524;1;279;99;207;88;168;841
005774409443;1;104;128;284;79;108;703
002219679835;1;133;113;284;78;60;668
018215341283;1;187;115;169;51;130;652
006801268129;1;214;276;150;67;168;875
032938190756;1;92;109;211;105;108;625
022789805331;1;199;244;285;62;87;877
015001034976;1;275;180;249;92;145;941
019281716074;1;195;215;184;51;101;746
017451424907;1;124;111;282;52;122;691
002785835949;1;232;143;250;89;178;892
076037401717;1;138;127;124;109;169;667
041474369005;1;272;133;135;105;113;758
070178309326;1;139;237;230;95;124;825
077503411492;1;111;168;216;84;74;653
075789645762;1;110;131;254;62;62;619
077775856493;1;99;222;147;96;164;728
088623385166;1;94;117;297;116;80;704
027322973500;1;289;218;278;64;68;917
032948050637;1;236;164;265;109;61;835
006382856610;1;269;258;296;66;125;1014
033425907602;1;193;101;144;60;62;560
082455170986;1;235;141;284;62;131;853
036288927485;1;212;107;244;68;72;703
069129675215;1;121;128;149;105;151;654
075786585353;1;197;194;91;69;149;700
023610703954;1;93;184;114;103;54;548
004828410616;1;278;158;96;106;116;754
045970237546;1;199;268;219;100;88;874
000659781223;1;275;212;255;55;51;848
009422664200;1;125;274;262;53;153;867
033474888429;1;176;276;143;94;174;863
027094815391;1;209;88;238;70;51;656
065904519231;1;188;121;187;95;130;721
064949963612;1;203;93;140;101;154;691
039034859324;1;167;172;298;113;173;923
096631057413;1;101;273;287;95;161;917
014556076588;1;131;116;270;108;51;676
072663661843;1;250;162;293;109;131;945
035435421637;1;140;159;157;69;114;639
086015976585;1;239;269;164;103;177;952
046979923313;1;122;237;140;63;95;657
021437467124;1;112;243;207;66;108;736
056728028667;1;96;194;128;70;126;614
093191073719;1;292;200;90;81;78;741
028248283643;1;189;258;123;64;158;792
030106712620;1;260;275;174;112;170;991
024803412721;1;201;278;295;58;164;996
010061529708;1;195;254;262;114;107;932
053715420740;1;149;218;139;90;52;648
019102826265;1;203;123;252;91;131;800
001505737411;1;100;152;186;107;149;694
062909062429;1;280;125;204;97;153;859
094841458226;1;124;284;256;61;83;808
060654524390;1;85;156;163;88;149;641
083468339247;1;93;234;101;101;135;664
033854190184;1;255;92;284;90;122;843
051974884251;1;198;155;245;73;153;824
049546724202;1;290;225;262;119;121;1017
037429531635;1;112;223;105;56;143;639
016285241287;1;210;166;289;72;127;864
046543941737;1;219;89;271;85;138;802
095924198826;1;280;171;298;92;172;1013
068020232913;1;139;209;117;108;53;626
040093781567;1;230;196;215;50;89;780
069954568229;1;159;122;294;85;101;761
016028249684;1;153;262;98;107;167;787
025171644955;1;279;202;182;103;118;884
010400986161;1;184;257;167;53;99;760
071814387113;1;208;244;202;81;115;850
010933991966;1;170;87;209;64;57;587
007319201874;1;156;182;118;86;137;679
089212730645;1;144;194;258;86;117;799
000093307990;1;256;152;287;99;84;878
032668652532;1;253;281;142;55;159;890
047094742012;1;169;206;273;53;135;836
020573473644;1;190;222;271;108;164;955
040973898446;1;278;124;250;56;115;823
039955894164;1;232;164;142;110;86;734
069742069909;1;289;262;160;117;127;955
020134333657;1;218;212;153;112;139;834
041186524753;1;261;140;158;97;175;831
032540865213;1;124;95;258;70;81;628
072947855658;1;199;105;134;83;141;662
086357949591;1;83;133;145;59;52;472
064638412400;1;190;271;204;102;66;833
084155876351;1;245;212;273;55;175;960
013638758047;1;250;223;219;102;173;967
054565453490;1;249;136;141;114;110;750
098094558589;1;263;229;133;57;142;824
055491622004;1;149;231;286;64;72;802
028881657526;1;215;206;262;81;116;880
036664485725;1;94;197;157;99;63;610
078811925682;1;147;191;188;102;161;789
060492826953;1;194;116;211;65;85;671
078659325253;1;108;130;276;78;147;739
015158143276;1;103;108;184;93;114;602
092294987231;1;217;159;128;83;113;700
079805027673;1;193;238;117;53;151;752
027984983698;1;289;179;117;100;93;778
076571660702;1;101;275;284;61;162;883
075041753943;1;202;230;275;76;119;902
095688566385;1;150;188;246;71;72;727
091469955288;1;233;178;280;53;77;821
042607956874;1;172;140;169;50;88;619
023541451331;1;274;249;99;81;169;872
052517185534;1;291;90;113;81;160;735
099812416592;1;205;284;106;52;149;796
017697238083;1;141;200;122;106;91;660
071581393615;1;207;204;227;60;68;766
083658950986;1;286;221;180;73;124;884
044251121154;1;126;106;144;87;104;567
037013207361;1;155;86;265;68;86;660
031358864605;1;153;196;167;110;172;798
021794687192;1;112;175;99;73;71;530
068940141762;1;111;259;188;54;124;736
031729228853;1;259;83;208;107;109;766
004323870991;1;164;168;230;96;98;756
074639709818;1;187;102;200;78;167;734
028118449602;1;282;255;91;57;173;858
054076257982;1;144;103;256;90;148;741
040461216890;1;247;116;288;58;143;852
043490143284;1;234;199;92;95;103;723
008565253560;1;152;146;128;51;147;624
096988444179;1;227;188;118;94;176;803
009016233640;1;192;155;238;78;175;838
035929476604;1;177;208;142;107;140;774
053813619061;1;111;237;199;109;85;741
076179054650;1;179;140;222;88;96;725
007055016383;1;193;261;220;80;155;909
095773625656;1;215;221;144;59;67;706
032611578116;1;263;101;295;62;176;897
088195216181;1;214;124;186;67;84;675
012464382333;1;116;219;184;52;107;678
044039518827;1;109;261;126;85;88;669
054911302500;1;114;152;97;120;120;603
000308538373;1;261;134;224;71;164;854
065828473053;1;94;127;147;63;173;604
077009323609;1;93;214;274;79;96;756
091062745894;1;197;141;272;112;157;879
018411217538;1;267;207;282;83;107;946
047926761062;1;182;165;282;113;120;862
009948073945;1;288;244;243;76;175;1026
003516729857;1;143;157;260;82;161;803
011397843132;1;139;220;212;50;159;780
037039973637;1;120;149;235;81;84;669
046133047448;1;154;132;260;95;79;720
023574655249;1;224;88;260;75;125;772
071321218157;1;290;274;98;53;156;871
070285447723;1;185;129;192;115;86;707
014714153369;1;175;201;190;109;121;796
026391878880;1;283;241;96;111;122;853
008348324515;1;180;183;187;71;138;759
082294351329;1;216;223;154;84;109;786
029096583739;1;239;129;115;62;107;652
083490475305;1;169;231;157;50;130;737
004978609647;1;221;165;116;88;76;666
063142583199;1;87;205;246;77;91;706
018653910091;1;85;194;135;53;128;595
052509617792;1;285;226;263;62;139;975
055700841348;1;170;163;211;57;60;661
013089414467;1;125;166;150;111;89;641
000852036594;1;177;175;183;92;138;765
058656722799;1;102;190;189;91;104;676
046098495477;1;197;154;178;106;60;695
093020885742;1;232;236;179;120;143;910
038121011507;1;145;161;233;116;159;814
073684662209;1;197;208;103;118;78;704
029795684926;1;144;210;238;118;108;818
070949062862;1;102;160;287;78;175;802
004405427996;1;182;211;299;99;75;866
000152102019;1;223;172;203;119;156;873
073429205994;1;86;229;247;93;129;784
077493887313;1;183;95;291;67;108;744
020593449409;1;153;244;140;71;66;674
096338495276;1;109;82;176;106;70;543
086734460369;1;216;282;141;85;156;880
033786716079;1;135;221;221;69;86;732
099561869814;1;257;224;187;90;84;842
029375616210;1;130;108;127;82;129;576
035742079533;1;89;272;111;79;136;687
078348915496;1;204;227;202;56;73;762
075294731497;1;154;108;230;65;70;627
048199698015;1;181;172;205;98;92;748
039873920589;1;279;248;241;93;74;935
036621915817;1;154;101;142;91;123;611
003294478204;1;212;287;157;81;67;804
093251892658;1;285;159;232;111;92;879
074960119759;1;217;160;290;110;143;920
085280376592;1;87;80;208;50;109;534
046595285916;1;189;135;144;76;94;638
039666930274;1;161;149;280;110;57;757
086319331837;1;126;253;195;96;87;757
009721373553;1;234;207;268;55;105;869
004460811739;1;150;269;238;116;161;934
058072209273;1;88;230;191;91;103;703
053361744893;1;264;142;98;94;91;689
051717904371;1;203;218;272;89;120;902
053457360687;1;155;239;138;53;82;667
039555331920;1;171;209;171;98;78;727
063628878318;1;172;194;230;88;123;807
091362089470;1;91;80;263;80;131;645
073289778800;1;185;173;131;108;148;745
048720747466;1;150;123;94;95;149;611
075819601577;1;100;148;215;119;135;717
071945181709;1;141;167;125;59;80;572
091873791019;1;272;241;224;99;85;921
074062491248;1;290;175;293;78;114;950
027756691673;1;116;124;253;57;61;611
054514270340;1;134;287;253;68;172;914
064363397845;1;153;122;155;71;138;639
019364742536;1;285;256;146;92;172;951
007024491059;1;232;246;296;58;94;926
078352065760;1;273;199;297;68;98;935
043886580621;1;163;138;138;120;118;677
079355775633;1;174;279;266;82;58;859
012380763350;1;248;250;211;115;154;978
045399111345;1;273;258;265;87;76;959
019072282681;1;190;242;243;85;135;895
073316740949;1;269;171;221;52;178;891
068603211987;1;137;90;289;88;60;664
074908999515;1;243;213;118;62;147;783
062424148801;1;144;89;190;92;62;577
077852515730;1;191;134;149;76;133;683
086656746408;1;195;217;216;55;126;809
075945261518;1;92;146;130;67;59;494
011933987615;1;286;232;116;57;102;793
057401739671;1;259;160;195;77;115;806
092871493668;1;279;207;169;51;92;798
086585804887;1;165;238;136;114;83;736
098990174232;1;240;208;126;51;133;758
078352487318;1;83;272;153;98;150;756
032247908750;1;134;156;220;86;125;721
078288277514;1;268;269;298;102;118;1055
013149333088;1;171;265;240;56;114;846
043422956867;1;185;231;262;118;112;908
095991689803;1;259;173;167;58;104;761
045013441700;1;233;214;184;84;91;806
037164288210;1;214;196;206;63;98;777
045665509441;1;248;277;279;116;138;1058
084881811574;1;224;192;248;67;74;805
010410296048;1;261;253;287;103;141;1045
029810449398;1;159;124;157;86;63;589
089200432096;1;146;210;224;64;53;697
080068660158;1;255;104;109;79;143;690
090273791764;1;144;250;253;117;97;861
085790471589;1;248;178;207;53;99;785
021772243317;1;274;207;97;53;104;735
060509585535;1;192;197;171;70;161;791
050390605729;1;277;214;175;110;97;873
028550573898;1;245;99;284;117;115;860
058301046501;1;126;198;140;63;71;598
079422664474;1;90;277;113;111;57;648
086880373807;1;90;89;205;85;172;641
039483817507;1;159;190;281;114;69;813
072108151723;1;206;244;124;114;132;820
007869959764;1;116;253;206;115;151;841
099863160866;1;270;130;121;95;154;770
083007934181;1;91;281;153;60;70;655
016096438002;1;232;101;241;115;54;743
059800164924;1;99;130;120;58;171;578
096125111704;1;230;285;257;75;106;953
022209246118;1;225;213;289;90;107;924
001896000347;1;219;118;250;75;66;728
052342477564;1;272;121;120;69;110;692
098589155802;1;264;168;280;96;55;863
019912261415;1;97;273;296;115;120;901
019545350734;1;267;100;90;93;161;711
054188538389;1;252;236;160;115;173;936
076417580728;1;213;257;102;52;162;786
035120446203;1;238;220;158;119;97;832
000005183092;1;264;154;219;120;129;886
048906759208;1;222;123;281;90;114;830
033471154802;1;222;261;231;61;169;944
042483827852;1;175;220;267;114;106;882
006209095331;1;104;227;247;120;151;849
074121915298;1;223;227;126;60;77;713
024440583562;1;88;271;99;64;131;653
091705807446;1;117;220;243;75;119;774
037022228781;1;80;121;179;118;160;658
095706910987;1;146;256;127;84;110;723
022370431203;1;292;203;131;117;149;892
066952344039;1;288;118;286;67;174;933
017062314341;1;129;270;252;94;111;856
050780339233;1;240;107;211;80;152;790
055952408338;1;280;124;218;118;139;879
007099730469;1;147;164;182;114;53;660
016124739177;1;118;231;99;59;58;565
093048959144;1;186;191;210;62;73;722
014122907934;1;290;262;192;85;126;955
031732375255;1;238;98;126;110;138;710
062785915351;1;264;272;276;65;102;979
056337771889;1;134;100;298;75;173;780
048420653367;1;139;193;164;54;151;701
033640337838;1;145;171;283;107;81;787
012352267746;1;142;237;199;58;89;725
002744685454;1;128;142;96;102;107;575
074472579801;1;233;110;108;75;56;582
031111109389;1;280;223;169;90;59;821
066776718034;1;169;143;274;115;162;863
036961968331;1;152;132;159;53;149;645
007840397887;1;170;182;197;68;51;668
025095886585;1;266;173;185;63;159;846
045954955650;1;150;85;155;120;127;637
051006653027;1;159;102;286;108;135;790
047400532113;1;91;152;259;76;80;658
078618557763;1;180;284;217;73;124;878
084590052041;1;202;249;282;101;64;898
034682218604;1;231;231;161;73;144;840
038379959411;1;84;100;206;107;130;627
054801116971;1;105;81;290;97;89;662
084266914660;1;249;196;207;119;82;853
083253632982;1;132;282;172;60;176;822
058111757543;1;126;140;265;51;93;675
037505410286;1;260;248;292;65;158;1023
068953546040;1;231;227;163;108;60;789
081150275842;1;132;124;181;61;59;557
000884009683;1;276;106;178;75;70;705
057299138028;1;90;200;164;95;156;705
066301851592;1;221;86;214;106;133;760
044819281914;1;210;284;262;104;108;968
097929241080;1;275;125;145;53;147;745
035288107488;1;267;245;213;114;76;915
054632054495;1;277;90;162;83;60;672
002181753874;1;211;218;97;110;104;740
067627903024;1;217;160;169;95;105;746
049577649466;1;288;146;276;64;140;914
057054928958;1;177;241;177;56;71;722
015213653369;1;209;149;194;79;108;739
043341322291;1;103;201;300;70;147;821
063711932374;1;104;278;273;74;77;806
013481434111;1;289;273;105;60;83;810
043454066188;1;94;133;100;100;56;483
005084177669;1;114;153;219;119;97;702
012599829258;1;260;283;205;85;82;915
002537360421;1;211;86;248;55;113;713
065152972417;1;96;227;110;58;157;648
007848693827;1;269;278;214;106;127;994
091822515720;1;146;146;132;61;152;637
006898592422;1;89;215;141;102;62;609
072891724277;1;217;195;214;61;148;835
032087083101;1;238;126;254;61;161;840
006375941797;1;83;148;149;90;69;539
099096590356;1;125;228;170;98;155;776
001897662537;1;157;194;209;117;159;836
093684954492;1;205;246;190;119;102;862
076670575185;1;263;87;275;62;99;786
019904147852;1;96;249;230;54;80;709
001430958127;1;175;133;115;74;119;616
083670911335;1;185;202;250;71;133;841
090473898289;1;174;228;262;81;87;832
041160381254;1;276;208;299;61;115;959
020210477593;1;223;265;133;120;89;830
099758059811;1;146;127;94;111;151;629
055806806629;1;115;230;132;104;71;652
087381368562;1;206;217;106;104;135;768
082792963747;1;177;101;125;109;116;628
049602244806;1;137;138;98;93;96;562
096244907691;1;240;284;156;54;59;793
013409320549;1;213;115;105;58;164;655
074076214471;1;159;122;166;88;145;680
099870921621;1;227;226;102;66;59;680
034811523005;1;123;249;189;85;153;799
006874287610;1;172;152;102;110;82;618
010505900134;1;194;163;181;67;161;766
044095507066;1;236;116;220;102;158;832
083501815249;1;84;231;92;86;73;566
094685080157;1;220;233;144;107;160;864
026518434396;1;156;134;176;62;136;664
011666257521;1;177;165;278;63;91;774
012725004951;1;183;223;123;54;90;673
015585745550;1;163;188;255;118;88;812
044647541506;1;191;166;150;63;88;658
070679532223;1;253;283;177;100;137;950
097209234822;1;151;140;163;58;55;567
045942883618;1;203;283;272;112;108;978
034395496989;1;148;257;225;58;153;841
043234301442;1;90;89;155;66;110;510
034180412635;1;100;162;270;90;176;798
031212090153;1;213;107;129;114;53;616
072997683871;1;266;220;280;89;56;911
016507218168;1;182;134;121;70;149;656
000441040489;1;131;225;163;118;107;744
053066277482;1;251;215;205;93;70;834
013838064262;1;259;103;290;73;75;800
043020518349;1;157;146;205;90;148;746
078050869828;1;254;247;170;95;82;848
060201646822;1;235;237;163;77;61;773
073506740963;1;254;86;177;75;175;767
024759706642;1;93;193;216;89;111;702
089400259435;1;141;279;188;60;130;798
075604714526;1;232;111;276;91;173;883
095646312141;1;186;183;210;62;64;705
025242682219;1;210;179;173;62;53;677
059034781185;1;270;114;112;86;119;701
061729006435;1;228;123;214;97;113;775
087076784410;1;160;158;271;120;64;773
039340781567;1;276;172;177;85;134;844
061521846300;1;246;247;227;60;147;927
096401088397;1;282;196;158;100;76;812
070217537005;1;209;131;294;96;77;807
049313688367;1;153;182;202;75;75;687
041028438872;1;152;244;299;99;175;969
030093122706;1;86;134;103;58;78;459
056138372847;1;140;142;258;96;109;745
085718859521;1;92;157;101;93;127;570
031577162609;1;119;146;171;70;138;644
060399299256;1;172;235;287;112;135;941
016421716541;1;157;199;237;93;94;780
047651820013;1;109;240;197;79;144;769
072875269243;1;214;214;246;63;71;808
074860560043;1;183;189;150;63;102;687
029821653139;1;96;156;287;61;61;661
064454547839;1;197;145;267;62;56;727
090540683794;1;126;284;136;97;63;706
017283173368;1;257;233;202;99;98;889
093558306113;1;182;104;226;71;59;642
052417530182;1;105;267;286;62;123;843
082889011739;1;259;259;116;118;67;819
012495564766;1;83;152;231;95;75;636
054163362512;1;194;104;126;90;96;610
031348873856;1;275;265;258;88;69;955
026487040149;1;211;185;275;55;95;821
042471294869;1;181;164;216;66;68;695
051288161989;1;81;110;248;74;108;621
072276430736;1;208;103;201;100;95;707
063121890173;1;95;123;152;53;163;586
046709371731;1;153;111;300;69;98;731
005237610381;1;253;137;266;52;100;808
078402050773;1;234;114;287;60;152;847
018509382445;1;194;132;127;90;139;682
057507688874;1;175;243;169;85;78;750
041545020694;1;291;193;291;82;124;981
059404778109;1;217;118;263;98;124;820
021491741513;1;124;283;252;68;172;899
043564300178;1;256;157;153;97;112;775
049890359507;1;232;98;267;84;134;815
060915949617;1;117;277;295;59;85;833
060051453401;1;291;273;98;103;143;908
044971153666;1;119;195;242;112;150;818
098676268428;1;112;133;273;69;119;706
007136733605;1;114;179;268;105;69;735
098657490084;1;159;209;156;117;92;733
055711652995;1;213;273;161;69;136;852
058652796002;1;222;92;143;80;102;639
073697150891;1;121;230;270;88;74;783
061896017640;1;173;205;285;100;140;903
067078127930;1;89;134;130;64;92;509
022700692055;1;137;269;171;88;151;816
094991495221;1;281;125;225;73;84;788
026005829537;1;106;284;203;76;86;755
084556793976;1;136;239;291;63;57;786
032051558026;1;83;170;120;58;81;512
099129647935;1;108;105;192;101;174;680
020382141080;1;154;98;218;119;141;730
014899596073;1;130;224;163;105;154;776
059433341007;1;187;176;218;78;82;741
055300779041;1;169;277;260;113;177;996
014608075843;1;173;193;167;72;76;681
006060350245;1;197;96;211;68;112;684
029613105817;1;220;283;285;96;137;1021
004126591520;1;194;157;193;71;154;769
035871563909;1;108;190;300;52;83;733
078020764552;1;166;285;146;80;118;795
001619998789;1;290;264;227;119;68;968
084903999063;1;232;190;275;66;169;932
080278493038;1;174;278;202;51;149;854
099804745425;1;213;127;247;108;96;791
040809004080;1;202;287;142;68;103;802
017327850976;1;257;204;187;89;82;819
009921575949;1;245;167;181;106;95;794
064436804344;1;169;233;127;69;69;667
026301311007;1;204;182;198;74;89;747
039815637747;1;288;274;287;105;117;1071
067793346914;1;276;260;251;95;123;1005
003174799765;1;180;193;238;54;160;825
043559006005;1;83;231;249;104;57;724
065552042760;1;255;80;194;120;93;742
036259241470;1;228;209;152;118;50;757
091011110379;1;273;135;279;94;117;898
043485285780;1;90;168;298;108;92;756
015394268744;1;108;253;235;90;153;839
081881670015;1;285;277;239;120;120;1041
091410080819;1;198;280;189;53;136;856
042823317385;1;92;203;243;76;104;718
089691984679;1;186;98;182;90;139;695
069471215950;1;186;127;204;120;56;693
000979874648;1;200;275;280;119;87;961
064199137670;1;237;171;122;120;119;769
049978018212;1;179;151;277;96;121;824
087393930253;1;255;163;208;98;144;868
076798184584;1;218;206;241;102;144;911
045632553283;1;249;246;298;62;151;1006
064919958479;1;211;231;105;87;167;801
093129365556;1;88;210;192;96;168;754
060846999580;1;219;127;95;94;124;659
020853039060;1;212;240;205;56;142;855
029766951008;1;104;284;143;107;167;805
014019966014;1;235;234;195;62;144;870
005516256805;1;269;162;110;67;84;692
061037948389;1;165;217;133;64;107;686
087023364377;1;242;130;114;100;106;692
016930302181;1;183;239;164;113;96;795
081659164467;1;196;202;298;106;151;953
014026484764;1;140;193;146;103;92;674
098772883171;1;87;266;226;110;73;762
042582617008;1;103;105;237;87;123;655
002768032024;1;126;121;268;94;154;763
054588301547;1;193;183;181;116;70;743
030108852477;1;87;275;108;120;78;668
063389324239;1;128;134;111;53;80;506
094973366201;1;91;150;211;77;176;705
011901826288;1;162;250;103;90;65;670
013649210825;1;226;115;288;64;148;841
075181761603;1;128;161;242;88;148;767
036698571775;1;110;170;101;117;66;564
060454843361;1;149;280;276;77;126;908
063394788558;1;184;128;99;101;153;665
095449642818;1;284;228;263;114;63;952
053845162282;1;151;148;251;104;174;828
038668603968;1;156;239;252;102;167;916
099623449616;1;157;240;152;116;166;831
073057539760;1;287;128;142;101;119;777
016209533624;1;282;207;173;52;88;802
044469036504;1;176;111;277;61;55;680
076198770136;1;181;136;185;109;160;771
001047742724;1;154;105;174;99;139;671
062464872972;1;90;201;223;89;161;764
041593665274;1;138;130;213;104;85;670
067096676223;1;215;235;203;118;57;828
063964831268;1;99;96;182;114;118;609
010453290417;1;276;286;203;58;54;877
027476011543;1;208;261;291;55;98;913
024500856040;1;257;178;165;79;60;739
009421964180;1;271;253;260;83;104;971
090483308211;1;276;82;130;62;155;705
085328181884;1;201;236;110;116;151;814
064989590642;1;262;284;190;70;113;919
021305483222;1;135;231;223;78;104;771
030061096611;1;207;176;270;97;83;833
063550264631;1;113;269;293;89;56;820
002812672407;1;261;240;145;66;159;871
019563005296;1;180;174;101;91;166;712
087085727290;1;99;246;296;119;128;888
035429173844;1;93;174;239;118;134;758
021351191122;1;175;215;179;106;178;853
092432261774;1;201;127;296;92;79;795
013182807732;1;255;108;279;109;162;913
045605926230;1;152;122;216;86;136;712
012266879909;1;288;260;218;71;124;961
045277214633;1;170;183;274;84;144;855
035084128990;1;216;196;149;104;156;821
044423520352;1;270;236;286;65;172;1029
020563358192;1;225;237;227;67;86;842
083610973483;1;242;90;291;87;145;855
019224664046;1;203;234;190;61;176;864
061096186809;1;131;117;249;116;88;701
038031260660;1;110;131;184;116;101;642
079170993510;1;291;241;171;102;176;981
042282890822;1;129;89;189;75;85;567
099546357070;1;223;251;220;93;151;938
099544625802;1;233;268;113;90;136;840
046432861702;1;131;195;192;71;126;715
002456114168;1;108;120;252;89;104;673
050057218141;1;86;275;268;71;86;786
025075888277;1;138;109;181;54;160;642
054480101945;1;85;207;281;119;165;857
026347398068;1;263;120;258;71;146;858
024536630663;1;258;113;214;107;102;794
053386150275;1;282;260;133;107;100;882
022287809469;1;233;87;171;50;80;621
001809815810;1;199;145;120;78;164;706
085964428644;1;154;157;107;65;162;645
073397415709;1;144;189;157;51;51;592
066437383785;1;136;198;242;73;164;813
052690888898;1;257;212;200;56;135;860
010612358661;1;144;129;219;94;121;707
092593413107;1;110;83;111;91;67;462
054011537382;1;92;137;298;56;63;646
087781764612;1;188;167;186;72;125;738
061534167681;1;225;242;192;66;100;825
073592337462;1;243;106;170;94;142;755
034123573405;1;220;210;261;91;139;921
088151051658;1;291;81;101;76;151;700
023066512685;1;198;240;159;79;78;754
002370052889;1;238;245;104;55;147;789
028824405537;1;126;199;280;99;88;792
034999814870;1;280;197;113;74;90;754
029998453940;1;151;125;129;118;130;653
073426199327;1;197;149;144;86;165;741
082713120948;1;197;173;229;81;128;808
014558590372;1;130;146;158;70;173;677
072517911561;1;162;280;119;94;178;833
026546724418;1;274;240;218;99;95;926
023701546275;1;280;130;169;53;105;737
043078728927;1;170;81;243;83;88;665
093611335258;1;165;237;269;110;96;877
041356796482;1;151;232;95;56;69;603
016456063441;1;179;228;187;110;140;844
006849752624;1;227;104;180;101;144;756
023858110609;1;187;106;163;68;168;692
031711611282;1;241;245;298;55;62;901
053094078993;1;135;86;280;73;73;647
018866883769;1;141;168;198;83;134;724
082992034076;1;210;264;225;105;140;944
085915660064;1;93;149;111;74;178;605
080629579982;1;290;213;270;52;85;910
094545090380;1;91;146;124;69;134;564
030949389578;1;180;115;138;71;72;576
049710660817;1;125;136;93;59;99;512
019601996859;1;151;90;148;59;158;606
097631878226;1;112;121;261;90;98;682
053471101710;1;280;145;139;71;141;776
076469615478;1;129;223;300;115;100;867
093482805654;1;114;103;173;74;117;581
007106780814;1;134;97;160;82;59;532
017822408465;1;128;158;261;65;99;711
001248305057;1;144;140;272;116;116;788
042376970817;1;246;253;115;110;125;849
028494505919;1;84;148;142;53;169;596
046481115504;1;218;183;238;76;140;855
024424762164;1;244;220;195;109;121;889
051087059477;1;284;203;286;89;101;963
065154974023;1;175;265;274;111;173;998
029937406614;1;121;92;152;59;171;595
072715914415;1;145;176;164;102;149;736
032374290616;1;275;182;298;100;178;1033
002792040385;1;115;246;127;112;148;748
041320708144;1;272;200;243;116;67;898
095685097542;1;264;275;260;93;62;954
079827581111;1;90;125;234;82;113;644
057706535304;1;128;134;298;101;121;782
084254125362;1;270;255;141;119;142;927
025807932977;1;219;116;150;69;88;642
019529772039;1;138;138;199;70;93;638
015231484115;1;133;174;199;85;157;748
055429661119;1;255;100;193;117;89;754
083078183623;1;235;132;184;92;55;698
087472304463;1;186;282;158;74;50;750
061675280623;1;116;206;272;55;96;745
015828209862;1;284;187;252;87;58;868
081397872486;1;155;275;124;51;119;724
078970514306;1;160;118;123;74;150;625
000457072382;1;247;158;284;62;67;818
032718921471;1;179;225;169;91;62;726
070277192471;1;213;274;157;64;98;806
090698945136;1;180;136;116;60;168;660
028399711242;1;145;169;111;95;178;698
054414656679;1;225;199;290;83;171;968
034464275847;1;277;129;177;118;143;844
010350763771;1;192;206;246;111;156;911
036193825053;1;153;105;153;96;89;596
025232354030;1;128;92;207;89;102;618
036142485616;1;247;262;218;92;178;997
091853718295;1;94;240;291;76;122;823
068157310349;1;147;196;261;59;127;790
046395982492;1;95;176;168;86;121;646
008093021345;1;266;199;230;50;123;868
098711921736;1;230;216;182;107;126;861
018157205676;1;216;272;189;98;150;925
072173756609;1;91;94;171;50;78;484
039969642726;1;158;273;150;78;107;766
033832869108;1;175;280;180;85;163;883
005558177588;1;237;81;151;79;93;641
054535072269;1;122;110;158;58;157;605
063381252260;1;90;181;115;65;81;532
073118659436;1;246;262;151;97;50;806
071350960616;1;202;120;219;51;136;728
051628977669;1;200;284;203;78;117;882
035592669757;1;106;145;214;92;120;677
014677986279;1;269;217;93;82;116;777
092824411581;1;186;156;284;109;76;811
000662938764;1;255;190;114;89;103;751
064113101713;1;144;232;236;50;131;793
027311703613;1;110;191;183;60;167;711
023553121529;1;131;229;100;87;165;712
048473656693;1;167;261;204;90;168;890
053278873167;1;206;132;153;50;165;706
066392539228;1;263;271;281;88;103;1006
070223458498;1;88;247;217;84;160;796
009079815565;1;256;228;106;60;104;754
055069617901;1;117;272;202;110;50;751
083600172024;1;98;243;163;77;57;638
085408315960;1;218;101;252;65;145;781
057330808801;1;218;165;93;101;178;755
019683911898;1;89;163;289;64;57;662
085947808099;1;135;120;192;78;54;579
039363438217;1;146;102;280;99;164;791
081346648156;1;174;159;174;79;113;699
068269069575;1;165;240;205;83;99;792
057263312332;1;117;250;187;91;87;732
080584974399;1;290;179;292;51;132;944
059599513156;1;111;127;128;96;95;557
096787365190;1;252;189;211;83;126;861
049333402714;1;168;175;158;51;107;659
047468946356;1;155;234;263;60;63;775
017782334482;1;134;163;161;55;178;691
028178545953;1;276;165;144;85;130;800
089905189549;1;107;203;299;80;92;781
005262840428;1;181;262;159;60;115;777
026556411161;1;254;226;144;75;70;769
075291044136;1;195;272;253;57;56;833
002239142048;1;124;178;91;58;54;505
078239394009;1;210;158;132;117;70;687
073114667207;1;204;171;112;101;58;646
045456494559;1;220;228;184;107;77;816
046694798231;1;171;250;253;78;98;850
076556028595;1;93;121;186;113;147;660
058389699162;1;91;91;152;104;152;590
071705410218;1;217;184;110;79;132;722
097918497777;1;210;125;297;87;55;774
047019858690;1;137;176;152;55;135;655
041700259922;1;116;222;104;90;94;626
071993490608;1;246;166;118;63;177;770
039681636918;1;280;200;92;100;156;828
092537334657;1;198;241;283;105;78;905
046151586044;1;181;114;146;87;80;608
015048248688;1;150;179;205;64;64;662
030301015508;1;209;235;257;115;98;914
076236453024;1;224;261;143;108;109;845
087518957489;1;130;149;93;58;65;495
031390818499;1;97;115;152;105;129;598
049807175312;1;169;230;206;92;153;850
093942320156;1;280;132;184;84;57;737
003924126444;1;276;104;176;94;104;754
037582444540;1;237;200;168;90;150;845
070256137284;1;120;140;145;112;132;649
013912556092;1;158;147;168;69;175;717
029985966778;1;183;193;185;86;69;716
011865664826;1;178;159;270;81;58;746
075170213402;1;107;226;159;52;161;705
069108713216;1;185;262;146;81;147;821
012186944380;1;133;211;234;104;61;743
046431634962;1;116;278;234;86;65;779
064682344200;1;117;112;273;90;173;765
007465025171;1;237;155;190;103;141;826
069378795847;1;282;195;233;89;134;933
017788683060;1;122;233;203;92;133;783
006041342318;1;253;201;204;65;105;828
004530835079;1;161;273;119;114;104;771
055525743325;1;235;282;268;62;58;905
063018460629;1;269;276;141;79;105;870
038465098531;1;141;148;274;90;62;715
006402038787;1;154;128;106;62;88;538
017757748710;1;152;283;116;119;70;740
086533814595;1;111;248;276;74;160;869
033795278857;1;240;227;281;69;91;908
045196577910;1;248;162;244;69;90;813
080375443038;1;138;210;262;97;101;808
039535419745;1;176;222;196;66;159;819
051748615206;1;253;217;153;108;144;875
090426844905;1;264;255;188;76;51;834
003254689366;1;252;95;284;106;71;808
044155825370;1;159;158;254;84;143;798
038416552777;1;166;268;211;57;101;803
001087745173;1;223;238;180;77;70;788
041852794571;1;213;249;142;86;140;830
086152572708;1;238;256;95;96;69;754
025886298711;1;154;209;129;97;176;765
036356284779;1;140;268;141;53;50;652
027018610943;1;199;218;158;66;78;719
035884821697;1;158;270;105;109;175;817
012428024206;1;153;155;114;78;54;554
041928617989;1;204;86;228;112;128;758
017391250742;1;239;135;249;82;97;802
099956323637;1;287;139;99;72;102;699
017408664231;1;164;160;281;88;73;766
037283852477;1;215;180;189;119;118;821
091796944351;1;234;97;212;56;84;683
034471454501;1;87;188;265;81;137;758
086613541976;1;288;96;101;85;111;681
086551298030;1;225;83;201;111;119;739
039552806890;1;120;236;277;90;131;854
001708729304;1;184;264;141;94;83;766
032277973920;1;271;234;149;119;169;942
072998598897;1;241;144;289;101;64;839
017775547328;1;141;238;286;50;56;771
056539237139;1;173;113;96;65;140;587
036498645447;1;218;116;168;86;51;639
001323979414;1;242;254;191;53;81;821
069827288459;1;135;288;252;71;84;830
001728775033;1;209;194;270;118;114;905
021184612316;1;229;123;272;109;161;894
099992792234;1;95;223;185;72;94;669
041645947177;1;272;285;165;51;154;927
010499433306;1;280;269;187;93;149;978
094133722260;1;261;259;208;95;94;917
092338277656;1;219;235;164;75;84;777
035747803206;1;113;83;253;96;106;651
092870535990;1;233;205;183;61;117;799
028501328928;1;194;103;99;70;175;641
093110658895;1;128;225;244;72;101;770
038636871920;1;241;276;256;75;88;936
010484852944;1;200;164;258;107;99;828
012959567744;1;140;99;101;93;68;501
020581069507;1;177;110;216;99;138;740
033238772060;1;241;115;278;56;166;856
051681706332;1;158;273;156;72;161;820
046703302244;1;219;260;182;117;51;829
076451019549;1;140;178;261;117;173;869
082832400515;1;192;158;155;116;134;755
021614470347;1;80;128;113;111;163;595
005642864821;1;216;130;128;93;64;631
064442604207;1;94;95;206;107;164;666
089573831738;1;83;132;116;65;117;513
007741859023;1;156;80;182;87;62;567
012502075778;1;110;182;256;106;111;765
010425054536;1;250;121;250;83;51;755
041050213810;1;254;163;100;120;134;771
040969437977;1;178;278;175;109;178;918
071733227946;1;140;204;217;75;173;809
027551485903;1;206;149;232;101;168;856
010934931450;1;121;150;195;67;150;683
069905079636;1;217;231;190;63;65;766
054791821743;1;181;187;90;88;74;620
087575121416;1;214;140;102;89;89;634
069555301599;1;132;286;293;73;112;896
029156709033;1;86;92;268;102;57;605
004844648609;1;106;280;208;89;106;789
043632667042;1;140;156;234;116;125;771
066519427576;1;238;137;142;93;131;741
060483638023;1;111;189;226;75;144;745
088847293739;1;192;191;185;88;159;815
077779367650;1;146;175;149;56;160;686
052808084015;1;96;261;281;66;140;844
005282620201;1;275;223;110;97;134;839
053612653309;1;233;217;299;96;177;1022
030614692191;1;88;248;173;76;171;756
090962741285;1;251;82;226;90;171;820
067261010552;1;133;275;261;119;102;890
069747803679;1;176;208;194;81;84;743
066362803680;1;274;278;263;75;108;998
054519128415;1;149;126;148;97;83;603
059087129105;1;105;91;194;120;100;610
005382181246;1;234;125;118;51;80;608
020455806829;1;210;117;278;90;109;804
046570039197;1;198;182;132;84;156;752
044550001929;1;211;146;207;85;79;728
004937447170;1;264;86;165;91;70;676
095181517030;1;165;114;287;83;143;792
070474016316;1;177;244;120;66;110;717
036564217706;1;141;230;271;94;50;786
009808897815;1;219;138;174;84;109;724
075924411066;1;195;282;145;97;59;778
094984368738;1;223;200;271;63;135;892
091983209496;1;172;257;198;113;50;790
098502479293;1;248;156;254;63;129;850
001280929623;1;86;249;254;98;100;787
053513248729;1;187;138;176;116;80;697
044650149513;1;269;270;121;67;64;791
038087437495;1;88;249;277;111;80;805
037420633227;1;109;106;183;74;69;541
076468113213;1;167;130;198;102;107;704
030216169646;1;273;152;173;68;76;742
072197701366;1;223;107;274;59;166;829
059676677784;1;215;173;298;93;60;839
012367482541;1;234;173;201;118;161;887
060981125706;1;130;163;255;88;99;735
044474935755;1;291;228;155;79;168;921
094604094421;1;222;199;162;93;110;786
025539967036;1;282;246;196;72;85;881
053588219070;1;279;274;155;92;52;852
083465356582;1;172;243;216;96;160;887
073818223902;1;236;85;245;120;162;848
031997853347;1;108;94;294;63;70;629
065136556661;1;108;199;255;113;93;768
015730162836;1;239;255;156;81;151;882
034478090405;1;215;169;240;98;102;824
066639041868;1;192;157;186;91;93;719
095947073734;1;267;156;276;112;154;965
003814761230;1;281;235;105;73;169;863
054357918368;1;229;266;223;90;69;877
029701661109;1;117;178;91;111;111;608
037922257926;1;235;126;112;58;147;678
013896207732;1;90;254;130;68;91;633
085967859740;1;143;197;252;64;90;746
062292556985;1;140;159;300;52;56;707
007893080539;1;120;231;134;101;99;685
059741881134;1;142;149;168;69;61;589
079131129732;1;86;283;204;100;172;845
053592053849;1;275;165;235;107;162;944
087219338300;1;231;108;248;73;98;758
059548675327;1;243;273;120;103;175;914
034693357189;1;212;268;167;63;84;794
040699737560;1;94;259;234;58;60;705
062034667515;1;200;239;134;120;101;794
068708727048;1;266;253;300;60;80;959
014462704812;1;185;178;299;95;165;922
047873978808;1;167;260;289;85;106;907
021429821959;1;272;281;115;86;57;811
020710630151;1;266;249;231;76;86;908
005660949380;1;186;140;237;115;137;815
032039835716;1;116;173;232;84;84;689
044998263767;1;93;99;277;70;66;605
047471998730;1;189;251;298;95;91;924
098712674116;1;234;165;228;87;126;840
096038217174;1;251;84;238;64;110;747
091887878895;1;91;150;282;102;130;755
095877846944;1;171;127;106;61;54;519
032809916263;1;100;285;266;79;102;832
005390211644;1;93;230;154;73;69;619
049183195928;1;267;269;254;57;69;916
082063255269;1;143;160;273;76;113;765
084667038640;1;265;218;149;50;59;741
061960706230;1;107;283;279;77;67;813
071159413991;1;214;281;230;100;70;895
021265779120;1;174;288;267;86;82;897
066863333144;1;219;257;235;102;68;881
017627060263;1;241;183;193;54;87;758
084587586866;1;118;196;291;62;149;816
039337512338;1;165;222;132;118;131;768
088646507620;1;89;211;207;50;112;669
080372491929;1;278;147;147;91;113;776
048345780118;1;147;228;90;60;101;626
031963186736;1;286;102;149;69;93;699
096988106427;1;252;189;298;55;65;859
089150774204;1;172;159;122;59;126;638
080166727174;1;215;278;129;50;107;779
005745816938;1;115;152;122;107;103;599
065330776765;1;228;264;192;118;67;869
068230934693;1;291;239;229;75;164;998
025717528951;1;95;264;192;92;56;699
019129811917;1;106;152;112;92;153;615
076364293987;1;199;148;214;95;88;744
022191616840;1;250;172;299;70;109;900
066154912813;1;136;120;235;63;97;651
081885321398;1;182;102;240;117;145;786
063503497979;1;171;147;126;73;145;662
094327887030;1;117;147;173;101;164;702
065412734585;1;95;152;174;97;105;623
067266907417;1;126;147;176;76;173;698
004734198658;1;132;171;147;52;105;607
057927998783;1;225;288;237;107;109;966
081908403514;1;176;170;182;93;120;741
095454946939;1;148;219;143;81;64;655
014572332896;1;262;196;118;74;178;828
055501887696;1;280;148;128;118;128;802
060863156457;1;174;287;255;64;136;916
095853599842;1;93;223;144;100;67;627
061845013858;1;185;180;131;98;154;748
017554120665;1;256;270;233;111;52;922
048620130487;1;116;264;250;112;81;823
063551172204;1;239;167;122;115;105;748
032220466423;1;147;121;289;78;75;710
026150473877;1;114;203;111;105;178;711
089970977395;1;272;201;287;106;153;1019
061725423857;1;157;273;244;117;108;899
027734560763;1;194;217;96;119;87;713
036932354675;1;170;150;266;56;125;767
099345124774;1;275;205;106;55;72;713
011593939778;1;115;193;118;88;50;564
091332080982;1;292;244;123;117;68;844
026185256343;1;106;268;175;68;75;692
067130319672;1;123;121;213;78;96;631
003580211762;1;249;179;249;101;70;848
074801085726;1;192;180;288;73;166;899
069218372635;1;228;273;101;57;53;712
063537737118;1;208;142;293;64;156;863
096812751214;1;122;158;298;67;111;756
012268296870;1;263;216;193;73;58;803
085282464832;1;250;94;200;66;146;756
094415773823;1;281;244;231;87;67;910
032745935592;1;270;238;229;97;96;930
088249969377;1;108;112;239;71;120;650
073825314366;1;162;286;158;62;150;818
032393698374;1;150;279;190;106;115;840
010871873196;1;218;271;98;80;59;726
027338982090;1;288;205;113;92;81;779
014587879499;1;217;201;241;67;126;852
093581123495;1;239;100;229;120;80;768
062020211997;1;153;209;168;98;53;681
039815150830;1;277;212;130;117;57;793
092677811515;1;169;196;208;54;136;763
060728874511;1;290;183;195;74;101;843
087307073350;1;92;268;91;67;156;674
043693952692;1;236;219;228;119;104;906
047350155775;1;213;274;218;64;86;855
000018752039;1;120;115;225;96;153;709
019004785017;1;219;162;241;86;122;830
051747281007;1;97;170;230;107;128;732
056879446965;1;103;227;113;63;97;603
005258100173;1;263;213;93;62;117;748
084803439587;1;193;104;149;100;172;718
017388526145;1;270;262;277;112;78;999
035819324652;1;186;241;252;97;57;833
020864444769;1;200;128;124;90;95;637
079021954414;1;144;271;112;95;95;717
026154069188;1;155;96;224;102;154;731
032926579340;1;188;269;192;67;174;890
008731570774;1;187;164;144;118;68;681
025775793235;1;169;205;243;79;107;803
093956519456;1;197;95;157;74;76;599
012484888243;1;117;173;229;80;99;698
073835052168;1;117;207;215;75;168;782
092511018527;1;279;208;218;64;61;830
000681479185;1;204;202;150;92;161;809
073342381837;1;104;168;135;60;103;570
005723555014;1;287;226;129;53;172;867
045249487468;1;145;207;109;83;68;612
089096071135;1;189;278;194;77;128;866
025282853374;1;217;146;231;106;82;782
047250045127;1;234;119;189;54;167;763
038690061638;1;215;162;239;62;59;737
013733659532;1;174;125;239;50;52;640
093910785772;1;259;272;298;90;102;1021
087866201797;1;181;111;210;54;59;615
042654533317;1;239;132;286;80;147;884
035896160236;1;243;178;278;91;170;960
009698572208;1;204;115;277;55;150;801
047771679893;1;272;161;92;86;64;675
021034518515;1;108;91;124;61;169;553
060367749529;1;286;218;112;81;59;756
097464949623;1;288;146;267;61;147;909
056834684296;1;156;218;284;65;177;900
032427162151;1;271;266;239;120;178;1074
013270198579;1;95;163;198;114;92;662
074857639361;1;225;229;254;50;125;883
091387706516;1;140;282;199;114;86;821
001443592164;1;116;196;240;50;70;672
033385984985;1;200;253;250;91;113;907
010243654086;1;99;160;280;79;107;725
014932475665;1;115;171;207;94;154;741
044952946685;1;193;220;141;51;164;769
067927963989;1;200;214;110;106;79;709
063714487197;1;209;162;103;92;104;670
094717925473;1;122;227;179;80;172;780
031721668185;1;139;261;280;111;56;847
052906535142;1;243;151;159;51;105;709
024058334689;1;132;234;296;119;143;924
023246279504;1;86;219;156;98;69;628
044391013771;1;229;183;255;77;119;863
043213864408;1;171;217;210;83;139;820
053396572364;1;274;238;189;73;64;838
025779842325;1;267;107;297;72;95;838
045208244231;1;237;142;158;62;83;682
007326748739;1;158;215;92;86;94;645
080723004720;1;232;154;264;55;168;873
059489800200;1;243;119;279;110;156;907
001968853489;1;235;159;198;51;74;717
078745424769;1;167;279;167;99;63;775
024557409847;1;266;163;270;96;109;904
005676678900;1;102;131;234;57;168;692
045419637657;1;229;128;166;87;161;771
037270290778;1;246;102;222;52;164;786
069453790761;1;235;145;279;84;113;856
068207661151;1;194;94;167;101;155;711
047133639297;1;109;279;275;109;84;856
063455022489;1;109;123;116;96;117;561
010877950697;1;247;117;148;114;171;797
093923966186;1;249;209;232;61;177;928
043267282316;1;173;114;111;88;94;580
052853599906;1;259;153;110;91;103;716
054532700897;1;171;278;148;106;109;812
044443877820;1;90;109;249;104;82;634
058967015267;1;215;239;274;50;104;882
013238091245;1;268;217;127;109;71;792
031301412187;1;180;262;186;75;175;878
058175319253;1;245;215;264;88;165;977
091818337055;1;187;269;272;75;149;952
005417836423;1;126;143;219;107;174;769
051528309912;1;84;112;136;61;130;523
009520518355;1;254;188;167;77;120;806
056202729249;1;139;180;223;96;85;723
055325881472;1;260;253;206;80;166;965
063959734042;1;179;177;155;72;158;741
022490966941;1;163;284;285;101;134;967
092390459340;1;227;133;206;75;87;728
007306819632;1;96;225;160;61;174;716
004270400276;1;290;214;157;116;121;898
001297330033;1;84;257;140;61;143;685
090496983096;1;242;215;166;81;108;812
020380249634;1;260;116;160;60;136;732
040665148573;1;259;230;148;99;51;787
037264949168;1;220;134;150;105;108;717
085642800659;1;180;260;228;68;154;890
005423699951;1;111;93;143;95;63;505
037907295857;1;175;242;126;86;158;787
031336474455;1;166;216;147;110;143;782
095126965024;1;147;224;216;88;90;765
016002521283;1;241;225;180;89;163;898
046616797295;1;108;261;279;64;139;851
094572800213;1;212;170;200;50;66;698
061995501797;1;121;134;173;64;96;588
054281804298;1;178;211;293;111;73;866
097390483916;1;123;272;202;72;127;796
065822146355;1;167;255;165;118;99;804
092290679921;1;193;258;197;112;52;812
093413281058;1;118;175;91;106;100;590
011632700176;1;261;181;285;84;139;950
033577429522;1;148;147;150;59;88;592
003782694191;1;151;196;126;90;162;725
000553939605;1;274;97;102;102;89;664
054413200523;1;183;143;248;72;149;795
029151977325;1;247;120;237;70;69;743
022587795230;1;292;96;145;63;75;671
058312943211;1;162;146;195;58;159;720
009998687257;1;102;207;180;66;106;661
024708515442;1;209;217;226;79;127;858
024246261703;1;219;113;294;87;172;885
095156094307;1;243;219;105;116;62;745
097127365377;1;99;204;130;67;142;642
034372627280;1;127;230;174;104;141;776
037249753727;1;93;258;200;118;152;821
035691667031;1;221;111;277;76;164;849
096682959108;1;234;279;120;58;177;868
058316164115;1;189;284;206;109;164;952
065179346417;1;245;284;253;93;126;1001
086105525715;1;229;151;254;69;115;818
057286500726;1;138;170;230;83;159;780
008375138916;1;210;242;237;59;164;912
068031008787;1;165;116;178;87;152;698
092383987632;1;289;198;291;97;166;1041
056839104955;1;203;82;101;53;153;592
095011904030;1;84;85;281;69;157;676
068780889898;1;220;275;237;109;154;995
036605987000;1;244;175;199;76;170;864
099572264173;1;193;83;218;92;51;637
073997465460;1;99;86;189;117;88;579
018548379556;1;223;99;283;89;62;756
031612636157;1;107;90;282;67;149;695
009466919634;1;231;183;188;73;164;839
067944621729;1;188;181;299;94;77;839
095980289897;1;183;89;299;63;55;689
088161096397;1;277;160;162;61;59;719
038999537891;1;269;209;228;81;90;877
008247454950;1;247;90;123;60;90;610
040012607127;1;250;245;265;78;153;991
024376181426;1;264;275;130;81;63;813
092977283102;1;102;140;104;96;163;605
095789748591;1;280;134;163;108;61;746
036789676780;1;81;226;191;102;50;650
099159989746;1;211;155;127;84;105;682
047733586211;1;138;167;277;88;66;736
003824616008;1;237;188;100;100;108;733
009692012252;1;134;123;195;109;53;614
017759386889;1;279;109;253;59;166;866
002129568416;1;276;98;145;95;130;744
079460171979;1;241;287;219;50;71;868
015841041866;1;284;241;143;95;169;932
023588472595;1;219;104;205;61;130;719
004202952322;1;176;228;216;66;72;758
080936805967;1;142;271;151;92;96;752
011820629729;1;251;224;197;57;133;862
035371383064;1;146;165;207;114;93;725
058348887558;1;105;203;166;115;72;661
026761557197;1;198;173;273;53;120;817
017745501899;1;236;150;245;72;165;868
078816749551;1;137;261;158;116;64;736
046613984256;1;139;187;276;83;105;790
077385373925;1;147;130;278;77;136;768
022846729203;1;85;114;125;70;162;556
011907881194;1;230;162;117;114;83;706
088403592053;1;83;132;181;76;55;527
017111489855;1;96;249;146;53;60;604
090050713019;1;152;180;204;52;59;647
012782156516;1;224;165;243;65;77;774
065591610770;1;104;200;210;60;141;715
093758876194;1;158;276;130;77;67;708
065438083105;1;102;80;203;111;50;546
089995981891;1;131;148;281;87;145;792
073489134534;1;240;281;221;109;142;993
011364428557;1;244;270;118;100;92;824
069160857839;1;272;129;274;64;56;795
098126313368;1;180;228;181;111;128;828
087056920591;1;184;135;155;100;108;682
010754903175;1;258;260;91;55;147;811
083189849496;1;254;185;125;108;117;789
081075660456;1;147;142;276;87;125;777
030916784964;1;133;235;287;92;119;866
099354004584;1;241;223;247;54;118;883
046738183480;1;123;188;222;74;149;756
058134167027;1;160;229;119;87;169;764
060282560417;1;166;243;293;102;67;871
087373356669;1;111;210;168;113;130;732
096614045996;1;141;248;186;118;61;754
019314427734;1;192;128;210;120;117;767
098930488710;1;221;267;138;97;70;793
015633482069;1;118;260;242;88;91;799
065166151695;1;213;288;270;103;100;974
008050980180;1;289;84;234;115;60;782
089282508544;1;116;122;277;60;55;630
017963916580;1;279;155;165;97;81;777
046579969508;1;287;96;170;105;170;828
088887832956;1;290;127;168;86;51;722
011989496172;1;90;115;108;72;147;532
057985189472;1;234;185;169;114;178;880
062280529660;1;251;162;197;120;134;864
094663804821;1;209;255;161;98;61;784
005349886019;1;269;156;207;77;73;782
051914232357;1;194;137;254;72;70;727
027731000950;1;197;200;265;102;135;899
095911400523;1;160;241;166;112;66;745
009506920616;1;183;246;90;71;55;645
049215858379;1;217;202;181;68;94;762
001680533960;1;292;263;275;55;151;1036
086227655254;1;85;159;226;90;161;721
040133408909;1;155;104;109;60;159;587
017417375373;1;151;283;277;79;101;891
090880302236;1;256;160;252;51;75;794
004409147836;1;284;140;226;96;160;906
056742127477;1;106;206;288;115;116;831
095071702287;1;171;158;99;109;70;607
009319916765;1;228;133;108;64;52;585
099684002151;1;167;181;119;78;67;612
012074039522;1;161;158;227;110;144;800
061006460886;1;241;217;202;68;109;837
024963812136;1;173;189;126;55;146;689
058495090224;1;286;97;134;100;55;672
069277032650;1;165;154;241;83;127;770
040614787078;1;127;160;292;77;93;749
060977592055;1;204;264;256;112;89;925
036442411987;1;132;110;283;71;170;766
037626609862;1;289;214;264;101;85;953
053277753949;1;138;277;110;89;123;737
067791810748;1;117;249;227;85;76;754
080623747944;1;149;244;230;93;127;843
052668653493;1;124;98;135;61;107;525
056800199153;1;83;88;265;78;81;595
011992726715;1;220;229;182;58;163;852
085171259968;1;229;182;112;75;138;736
046862094977;1;286;151;274;62;157;930
010876264942;1;254;91;121;117;163;746
098789164547;1;156;220;105;51;50;582
020472799127;1;106;272;124;94;116;712
018142988195;1;240;170;162;62;65;699
052580943664;1;209;169;178;116;76;748
049250040533;1;281;144;155;67;62;709
097226102765;1;256;236;155;101;89;837
034690080842;1;127;139;178;108;123;675
062319721727;1;127;176;265;110;165;843
004626998030;1;199;256;227;67;79;828
048968632797;1;165;225;118;107;159;774
004419786777;1;151;224;188;62;159;784
006188193113;1;148;174;145;108;86;661
001968287497;1;128;284;215;83;104;814
082358971989;1;131;178;143;59;108;619
002699119521;1;222;110;269;106;125;832
027406393924;1;198;148;174;64;79;663
015582139514;1;272;278;255;66;61;932
046822752564;1;175;124;156;54;175;684
022162235420;1;280;278;222;69;130;979
086166863260;1;105;193;291;113;66;768
036616744002;1;98;202;218;108;120;746
098758543840;1;112;209;271;74;64;730
031036823927;1;292;227;177;68;100;864
048566489865;1;276;154;223;54;141;848
068363514247;1;212;106;269;105;172;864
016058778482;1;93;233;210;85;96;717
034472673940;1;154;96;206;118;58;632
075937765944;1;168;172;179;89;88;696
028603471142;1;205;162;122;64;75;628
018697749817;1;260;258;172;87;113;890
030071089701;1;270;108;263;94;71;806
091820019296;1;92;204;284;80;106;766
022726056724;1;179;121;292;54;143;789
033736427108;1;136;184;293;71;50;734
085176419471;1;291;197;129;63;151;831
080147393036;1;273;138;91;70;155;727
021211249218;1;112;253;234;51;104;754
010508238597;1;220;135;192;92;111;750
062282527044;1;223;132;188;60;58;661
094030328782;1;199;167;174;82;66;688
094152800757;1;226;266;206;115;145;958
022436676424;1;106;97;269;65;130;667
002248242274;1;109;182;187;113;59;650
028660836383;1;243;93;197;70;154;757
040168980303;1;136;117;105;59;140;557
020528806396;1;159;182;225;60;67;693
039350273174;1;220;196;115;50;137;718
013773598189;1;273;83;97;93;60;606
029457305619;1;172;170;128;94;114;678
097240949303;1;160;105;125;67;157;614
017792064894;1;195;203;212;59;73;742
083826993626;1;206;133;278;82;139;838
037062086811;1;285;113;153;116;65;732
096433658944;1;121;220;120;109;111;681
088517781766;1;171;158;144;117;118;708
035253800859;1;214;285;231;72;118;920
058304448004;1;240;283;259;63;125;970
045090948652;1;222;161;254;93;150;880
043413985446;1;276;279;178;67;155;955
063985823949;1;165;150;224;99;74;712
039265300758;1;175;170;154;98;168;765
025955319104;1;258;252;126;105;97;838
048070476473;1;193;104;180;86;159;722
087737193462;1;123;201;269;64;145;802
071242507250;1;180;160;186;85;105;716
009247484645;1;87;82;131;55;133;488
049053614269;1;276;217;191;95;83;862
068488955327;1;224;129;273;71;72;769
077151097528;1;186;86;219;100;99;690
093686298362;1;157;107;160;101;144;669
042656729642;1;118;204;271;108;63;764
067563549096;1;181;257;191;93;73;795
015185613294;1;192;199;249;57;53;750
029986316778;1;182;111;135;57;86;571
031013922019;1;190;156;221;93;103;763
018787565706;1;176;80;161;87;147;651
019735250593;1;120;121;125;90;76;532
050353848556;1;221;275;209;80;156;941
088874852572;1;134;203;133;84;135;689
084410562462;1;180;117;97;102;86;582
053517609341;1;117;257;141;78;132;725
097456771379;1;119;233;191;75;156;774
076940696094;1;220;94;260;62;149;785
011319248512;1;103;280;143;78;63;667
071954708569;1;108;87;127;51;127;500
073160865110;1;287;216;95;91;122;811
057843685163;1;94;162;146;75;109;586
010179068027;1;143;256;233;109;64;805
084925279759;1;89;213;265;75;166;808
004132433707;1;163;86;159;76;133;617
042499230358;1;229;167;262;100;69;827
076860840447;1;205;285;99;111;97;797
089381434491;1;206;191;264;64;128;853
089748520101;1;230;131;209;70;172;812
021828387202;1;232;233;172;111;156;904
035325010529;1;163;275;206;102;178;924
093412397756;1;169;205;194;58;137;763
016839755271;1;275;111;212;109;66;773
003207335854;1;215;122;101;103;124;665
018887679988;1;222;220;202;53;90;787
028983776808;1;225;220;294;59;150;948
018170465411;1;250;194;196;50;66;756
076927996638;1;136;263;181;87;153;820
060861080663;1;167;232;261;86;80;826
062333272181;1;267;187;118;54;73;699
065571323188;1;130;207;107;69;58;571
007738075706;1;96;187;257;120;104;764
060224557450;1;241;170;227;85;122;845
009888750555;1;86;117;146;118;65;532
013206117782;1;203;199;105;68;77;652
027785392325;1;150;122;268;115;135;790
052446861385;1;249;114;215;71;94;743
009174211035;1;262;238;274;71;125;970
074242802320;1;125;248;115;98;59;645
003131292060;1;159;190;251;106;78;784
011522609175;1;96;284;150;87;63;680
055876345509;1;178;278;90;63;98;707
026865304510;1;226;240;201;65;79;811
000600585933;1;260;105;161;107;115;748
018874364900;1;155;264;296;85;101;901
070241389364;1;228;154;107;117;115;721
066345730912;1;111;152;270;73;172;778
045634518319;1;218;203;102;54;166;743
085635203564;1;225;126;217;117;141;826
074820695132;1;286;273;203;83;166;1011
083495366634;1;271;96;249;120;99;835
006676924872;1;201;94;132;89;102;618
032869255590;1;165;81;228;59;112;645
014565411536;1;136;86;206;56;110;594
053715305803;1;271;137;113;51;144;716
026171672242;1;94;95;203;94;174;660
008730633615;1;111;148;206;57;127;649
025706218749;1;177;183;173;98;81;712
086564381189;1;116;256;91;52;148;663
074716080873;1;178;227;213;67;109;794
014930299997;1;94;83;257;63;131;628
036344761323;1;247;113;288;65;68;781
069599981174;1;90;164;274;99;148;775
059847947871;1;219;84;195;87;120;705
086759704274;1;178;218;204;59;145;804
005381445880;1;266;248;186;68;162;930
043904357041;1;83;251;286;89;137;846
077759297654;1;247;95;103;102;85;632
049446273703;1;129;80;247;115;145;716
041106068073;1;175;216;141;66;137;735
054642372383;1;249;243;131;99;76;798
052601520900;1;137;107;288;88;90;710
009794650705;1;221;135;100;68;51;575
046714905777;1;267;169;209;92;77;814
090989580395;1;216;185;139;100;90;730
031388330005;1;240;211;134;50;110;745
082676299000;1;281;138;189;55;162;825
056903293512;1;163;244;283;85;144;919
086095216416;1;174;92;249;84;115;714
012533401796;1;187;97;253;117;58;712
057572129080;1;212;227;141;97;125;802
003683946373;1;215;276;211;104;160;966
093670867133;1;203;213;300;82;154;952
068551064736;1;269;154;180;82;148;833
013201553322;1;97;280;125;77;133;712
032649751458;1;115;227;115;97;79;633
022655929823;1;134;189;158;111;86;678
017493722638;1;106;242;260;113;58;779
080027341479;1;261;127;183;90;115;776
055046953646;1;176;168;281;112;174;911
025770631767;1;155;123;217;82;66;643
049438610103;1;157;255;185;71;98;766
076071147404;1;240;174;252;73;136;875
057793981366;1;113;260;91;76;172;712
094309516213;1;164;123;180;78;100;645
003627974095;1;171;287;124;50;54;686
053309295369;1;165;204;168;83;106;726
093145001062;1;114;233;294;67;134;842
087852077488;1;208;153;143;105;163;772
064748987224;1;124;117;236;117;177;771
042325419023;1;289;158;158;51;73;729
005830616591;1;217;166;283;61;85;812
001211151625;1;215;120;197;79;71;682
084471593413;1;262;257;175;54;102;850
080642666325;1;81;141;192;105;86;605
060047887735;1;179;191;205;113;159;847
063974754138;1;222;201;137;73;126;759
041187003838;1;274;198;144;111;153;880
077301106745;1;153;145;268;85;162;813
048564353527;1;99;162;143;110;145;659
055786790704;1;268;165;160;106;157;856
033017023010;1;208;162;231;80;166;847
081761831427;1;292;261;125;62;137;877
069463584296;1;286;108;299;118;155;966
090598965123;1;153;119;197;99;141;709
055927728076;1;161;125;204;112;104;706
051939920610;1;213;172;227;84;165;861
022415698784;1;101;190;163;105;164;723
026969346275;1;118;244;262;64;73;761
061541245415;1;256;170;263;72;107;868
067785949349;1;212;151;173;66;97;699
090380508941;1;115;204;174;94;87;674
026086266928;1;210;241;293;69;58;871
000533284801;1;84;234;248;75;154;795
030891367326;1;126;83;174;99;86;568
090539643788;1;92;92;149;60;108;501
093416612146;1;83;108;92;81;147;511
013171411916;1;99;158;155;90;151;653
071227338851;1;185;81;225;95;132;718
032367484339;1;152;98;113;114;111;588
035052672187;1;253;156;228;97;150;884
093624774616;1;149;87;244;102;120;702
043681365408;1;98;166;176;113;89;642
061324191172;1;114;108;180;53;74;529
097547735345;1;105;177;193;70;111;656
045756993589;1;171;150;266;112;142;841
016890892613;1;86;287;286;87;154;900
020728047929;1;254;109;234;60;75;732
099197168814;1;164;263;203;108;94;832
018581149637;1;101;232;214;77;110;734
003617358196;1;131;150;152;63;159;655
061285389312;1;238;219;169;113;87;826
036313887730;1;262;87;223;75;114;761
088483699311;1;151;270;256;65;119;861
003105078431;1;160;114;183;106;88;651
092323710265;1;190;102;111;64;126;593
098262043192;1;278;204;143;118;57;800
098698797513;1;165;216;225;55;119;780
087596224923;1;114;128;114;97;131;584
001052471451;1;241;266;166;82;115;870
031004495334;1;97;128;243;70;96;634
012541394740;1;135;156;170;79;124;664
065846514768;1;225;120;211;62;63;681
079170180246;1;148;191;123;115;120;697
063487859179;1;214;219;184;53;134;804
007108065077;1;85;105;110;74;112;486
078790100079;1;185;176;190;115;112;778
070873185533;1;185;207;117;96;161;766
077946207515;1;85;165;159;66;161;636
034192528608;1;181;255;188;61;91;776
024179628470;1;102;255;191;95;56;699
038032011608;1;183;87;129;79;77;555
020912935706;1;131;127;296;71;78;703
081771691103;1;289;288;122;110;118;927
062703385394;1;143;110;251;59;67;630
075079678039;1;131;157;234;91;63;676
081135138253;1;161;146;243;102;175;827
010470000960;1;277;169;211;77;97;831
006301856069;1;188;240;107;94;72;701
006550114704;1;241;201;286;115;86;929
075911923900;1;159;282;242;95;55;833
000833353451;1;283;150;166;81;162;842
011410661489;1;81;208;160;51;122;622
079649977052;1;144;203;255;87;118;807
094977185171;1;250;110;254;76;126;816
037120976173;1;184;269;98;118;172;841
056787485834;1;288;101;155;102;165;811
038819491418;1;253;211;104;105;164;837
013241258483;1;172;251;146;100;178;847
044708592881;1;138;208;179;73;51;649
047474102459;1;171;92;135;73;132;603
084074427325;1;166;210;261;84;95;816
048225192355;1;93;206;247;99;162;807
070742268111;1;171;158;296;108;50;783
056869310628;1;141;269;158;89;150;807
008569918290;1;165;238;199;65;84;751
019016416139;1;80;276;271;58;94;779
067577658483;1;257;166;162;64;125;774
023573013072;1;217;142;289;95;175;918
086236794677;1;111;92;95;66;151;515
041947817725;1;196;235;127;88;140;786
029204548404;1;287;213;222;110;77;909
096378265084;1;234;253;288;61;133;969
045744613566;1;272;235;267;102;72;948
033915097176;1;284;277;173;120;154;1008
067195049815;1;160;280;163;84;162;849
056353767731;1;199;117;184;102;58;660
069206017786;1;131;202;155;54;140;682
086778035131;1;85;261;237;63;86;732
009873419411;1;196;179;239;93;153;860
013441572625;1;125;203;102;54;167;651
033576331589;1;227;177;211;80;140;835
071819560866;1;273;217;198;62;87;837
048930923322;1;125;245;207;57;118;752
048283187923;1;90;110;161;89;53;503
096586677545;1;213;149;146;97;91;696
038038743581;1;255;122;154;73;82;686
056563686869;1;125;219;190;62;171;767
035387552698;1;131;242;236;77;146;832
053755545502;1;148;151;91;96;72;558
075448138171;1;153;157;105;80;158;653
090028458084;1;131;160;143;64;178;676
042134994989;1;290;82;201;95;175;843
004338626477;1;150;212;217;117;56;752
015625471793;1;103;237;96;92;61;589
013224005804;1;196;221;238;84;98;837
058733040408;1;173;220;172;89;63;717
002418209974;1;125;173;287;114;135;834
014488932183;1;123;198;272;72;160;825
088639119812;1;272;252;126;89;176;915
089257205768;1;151;232;137;50;75;645
086736031226;1;266;172;172;94;129;833
043094458583;1;186;145;113;68;88;600
041045366529;1;290;97;107;75;94;663
045313252296;1;103;248;205;103;54;713
040679803592;1;216;215;265;111;128;935
071414317763;1;166;262;167;75;132;802
083094227846;1;271;86;244;60;170;831
083347285540;1;261;111;109;88;74;643
054678665491;1;274;133;243;104;57;811
044071077258;1;117;249;214;51;169;800
096273836770;1;279;111;263;94;72;819
078639032412;1;205;88;269;119;168;849
028632992441;1;240;180;201;82;61;764
038981481728;1;103;206;98;58;84;549
020289058194;1;130;123;212;76;123;664
023415923647;1;125;209;165;111;111;721
048999786136;1;89;225;147;84;94;639
017370843940;1;232;103;230;52;52;669
038680108552;1;95;256;164;90;171;776
086834677832;1;94;97;163;60;151;565
078273946234;1;242;256;216;107;61;882
006089962871;1;160;87;201;91;115;654
009011952522;1;93;176;234;109;86;698
032395381942;1;113;276;222;77;85;773
096668778558;1;241;165;222;76;152;856
053097385656;1;261;142;189;85;152;829
013781579591;1;80;110;242;76;68;576
047300202931;1;201;208;285;52;172;918
078972030936;1;260;131;184;65;79;719
029603810462;1;271;115;203;75;55;719
027322399289;1;89;80;221;97;108;595
001650322746;1;97;103;183;104;152;639
069204474884;1;277;245;199;87;143;951
039852012397;1;286;256;212;59;52;865
098209059017;1;173;128;99;60;142;602
039765782364;1;263;200;278;59;156;956
099443740830;1;220;248;253;107;166;994
093205394230;1;194;210;162;65;95;726
036092432423;1;210;92;266;72;134;774
084509367683;1;193;200;113;104;134;744
094849049966;1;118;92;226;96;104;636
088760454377;1;104;94;150;82;105;535
097656817950;1;137;170;250;51;63;671
072641711407;1;210;220;270;70;123;893
078278153471;1;185;107;266;119;163;840
052001142394;1;80;163;226;53;113;635
042784440611;1;189;155;108;79;165;696
027869945236;1;225;266;150;89;95;825
087333226376;1;84;241;211;64;107;707
060989854844;1;115;130;264;54;139;702
018274051011;1;142;247;133;85;161;768
081043392792;1;203;128;291;88;172;882
025940504237;1;154;259;276;100;139;928
016341478663;1;203;267;99;66;69;704
041179119233;1;252;160;92;91;95;690
014349204780;1;91;227;265;76;157;816
028280102140;1;172;222;210;109;144;857
004440771553;1;119;250;216;50;156;791
032245667822;1;212;129;215;116;131;803
092743359788;1;246;283;195;73;76;873
093228480735;1;288;246;254;115;140;1043
061302781976;1;151;189;171;87;98;696
096874269252;1;189;90;299;91;95;764
043563667605;1;185;191;231;115;86;808
084124476811;1;177;280;278;118;95;948
082380238114;1;150;87;235;113;90;675
021599575017;1;166;227;107;56;122;678
036996623539;1;187;201;169;88;158;803
052028715396;1;166;116;279;65;82;708
014997997226;1;186;223;181;66;154;810
010810353811;1;101;115;279;87;174;756
040555967826;1;245;106;195;109;176;831
005938479331;1;237;94;217;82;77;707
013446115159;1;127;219;165;113;50;674
018396981662;1;229;212;298;118;173;1030
046210832389;1;134;154;113;83;141;625
020875541376;1;114;137;143;119;68;581
053687515949;1;184;98;124;114;85;605
083924002005;1;99;109;229;87;73;597
064233440299;1;217;82;134;50;126;609
042473356472;1;89;216;172;70;121;668
083966955073;1;114;178;271;81;162;806
016631524912;1;189;257;118;80;153;797
059026130261;1;157;179;216;97;165;814
021636813161;1;171;169;156;87;104;687
009586948778;1;161;212;294;114;52;833
081401694457;1;188;145;104;94;167;698
030551305333;1;192;179;110;79;53;613
018887532996;1;246;184;98;101;79;708
097862512715;1;84;166;165;100;157;672
024545421080;1;226;235;169;71;140;841
036078989852;1;158;284;170;107;119;838
042816534230;1;261;207;300;105;122;995
045451760717;1;186;132;104;67;158;647
042350213475;1;233;179;119;83;177;791
016367934189;1;220;217;197;94;168;896
006034353705;1;108;93;153;69;144;567
031837892119;1;186;262;135;54;75;712
050138213929;1;275;286;209;52;100;922
012217716723;1;151;156;272;65;163;807
028145202512;1;209;188;270;105;177;949
096532101897;1;270;219;288;54;124;955
067412169870;1;90;138;177;65;171;641
073120522331;1;163;95;165;67;112;602
083506670645;1;131;188;175;98;120;712
036900778209;1;164;146;296;82;105;793
094549565086;1;210;238;285;104;101;938
004082327626;1;106;114;164;95;60;539
038552464817;1;271;136;191;81;103;782
074453771290;1;177;251;186;114;166;894
096899304702;1;237;98;129;104;108;676
004263738397;1;184;121;220;113;111;749
076828575994;1;202;242;262;89;83;878
001790618306;1;234;252;111;89;57;743
055333695638;1;181;175;259;104;73;792
042059616784;1;275;258;200;64;104;901
079755444523;1;159;170;155;91;124;699
065427457317;1;220;193;117;90;155;775
099834009590;1;192;269;244;79;149;933
025184297654;1;99;269;111;90;109;678
086400555025;1;106;164;135;55;134;594
046247032850;1;227;148;142;119;72;708
016615221347;1;176;271;288;59;81;875
025540394112;1;84;219;284;70;110;767
084331968039;1;191;246;177;50;56;720
045842998630;1;233;105;96;110;153;697
012115771868;1;159;264;121;116;82;742
018158867374;1;248;259;180;119;178;984
058299958275;1;244;258;217;104;130;953
061807985934;1;227;191;283;77;72;850
074893288255;1;85;108;288;118;137;736
001411414177;1;276;216;291;64;137;984
062795324856;1;147;88;158;75;173;641
064340639610;1;92;102;280;69;52;595
022779244609;1;137;136;126;65;121;585
040665033379;1;100;134;246;88;63;631
007766952384;1;272;189;158;95;168;882
028487032719;1;220;274;101;65;84;744
071737814630;1;238;147;121;105;93;704
023664552393;1;135;187;217;99;112;750
061009987944;1;178;137;222;74;67;678
002305467839;1;179;156;279;75;105;794
027633514776;1;126;158;158;89;172;703
000258346410;1;231;246;216;83;83;859
093947834938;1;183;257;192;79;146;857
034294225528;1;158;203;108;56;153;678
022975923216;1;98;93;263;102;92;648
056926760367;1;214;238;177;56;153;838
062993227079;1;213;97;122;62;111;605
047990091002;1;123;131;154;94;162;664
085517378767;1;217;173;293;114;86;883
082341721747;1;133;149;150;81;99;612
047979749928;1;102;210;258;115;160;845
035342436911;1;187;166;108;71;123;655
043505438312;1;287;142;279;105;75;888
056928708637;1;111;167;100;103;73;554
026315893419;1;257;157;211;117;152;894
098034841197;1;203;149;130;78;166;726
008127319666;1;103;132;146;82;177;640
027035099081;1;248;97;186;75;67;673
050018406935;1;187;143;258;71;177;836
070678055844;1;256;266;172;72;60;826
016973653110;1;236;162;135;89;139;761
084629129179;1;177;104;235;84;102;702
053991427673;1;239;163;130;83;120;735
042562690524;1;201;170;287;58;72;788
022004938989;1;98;80;148;116;72;514
041052621351;1;256;253;295;80;163;1047
079291650376;1;159;97;92;102;78;528
055869572476;1;215;94;293;74;102;778
063771279505;1;167;94;276;77;126;740
072096695470;1;128;175;145;73;67;588
069749223516;1;195;208;131;64;78;676
022838554021;1;184;139;98;108;51;580
014109085976;1;214;269;201;107;65;856
013936443024;1;174;245;121;102;159;801
068080043815;1;252;218;298;114;77;959
008510991544;1;207;274;215;73;51;820
080947537270;1;216;260;297;80;147;1000
008267217216;1;147;257;265;98;87;854
003722470711;1;131;237;222;82;57;729
088726194537;1;153;97;230;84;56;620
067786681649;1;264;214;97;50;77;702
020094915911;1;257;162;217;53;86;775
095434023411;1;178;154;270;84;81;767
083232562862;1;89;111;231;81;75;587
040624034656;1;214;141;103;53;103;614
075438536590;1;116;103;95;120;175;609
018564955129;1;84;178;93;102;87;544
007334432126;1;178;178;226;72;140;794
081389895345;1;144;157;236;106;106;749
090986327729;1;222;164;144;89;151;770
070724497932;1;104;274;258;87;109;832
073285558024;1;150;170;199;118;154;791
038141230979;1;289;179;132;67;121;788
015356833903;1;221;100;114;94;64;593
071021080891;1;138;127;198;75;130;668
019738976134;1;154;201;195;99;133;782
084449392690;1;255;93;196;74;59;677
072205923055;1;233;223;111;68;117;752
098873075829;1;131;211;188;57;173;760
046552336557;1;265;96;120;59;118;658
068704750909;1;128;108;169;62;111;578
097165798706;1;103;94;291;71;148;707
070573093904;1;232;179;113;101;113;738
078706118440;1;146;155;156;50;175;682
057087617733;1;125;128;264;97;102;716
001946037312;1;133;230;224;88;69;744
018240597999;1;130;183;246;110;117;786
025485289691;1;95;175;268;96;168;802
090130388633;1;162;123;201;74;99;659
098160077847;1;105;93;236;68;140;642
051018790560;1;90;109;152;73;140;564
054006134533;1;193;234;235;72;125;859
074206503554;1;101;99;292;101;168;761
048081590540;1;134;170;119;111;165;699
072975487762;1;111;269;125;58;105;668
062518693945;1;83;187;213;109;143;735
051181179663;1;138;283;153;111;92;777
022473858465;1;119;199;229;74;74;695
061554233344;1;255;273;154;87;71;840
060457950785;1;239;234;107;111;155;846
042029023205;1;237;207;200;98;146;888
041714509519;1;172;163;100;110;87;632
044356781486;1;182;171;188;59;89;689
061121903832;1;278;172;211;92;152;905
053684457364;1;223;264;286;76;112;961
002580186134;1;188;228;282;52;93;843
088631303328;1;93;134;212;101;137;677
053599391467;1;231;191;202;96;62;782
056036721382;1;146;274;99;116;73;708
018366003558;1;266;101;125;58;159;709
086944588007;1;97;84;250;111;158;700
042996763129;1;157;246;228;70;141;842
012438385707;1;262;284;133;89;132;900
046093892748;1;172;220;242;112;93;839
045916749291;1;103;113;113;77;116;522
068787738173;1;100;111;207;59;114;591
033132662713;1;159;151;262;67;84;723
069617139015;1;125;256;263;70;110;824
022240835236;1;185;131;162;60;119;657
089958620111;1;112;283;96;71;131;693
028678612589;1;213;167;262;78;89;809
035788822565;1;160;81;206;63;117;627
048703664886;1;209;84;240;94;69;696
044940066144;1;279;239;121;116;55;810
041005669805;1;120;170;165;90;93;638
055084673192;1;265;92;217;77;132;783
009751018522;1;204;153;156;83;86;682
054438958824;1;92;239;125;53;101;610
072150046281;1;198;181;188;78;50;695
018201113024;1;177;141;117;68;67;570
041883984921;1;152;257;244;51;75;779
006355926354;1;230;272;219;94;93;908
034193958834;1;169;168;139;66;112;654
050640230179;1;135;262;102;103;114;716
031534067571;1;217;237;218;103;159;934
067154495699;1;160;137;127;70;166;660
011561885633;1;180;80;131;120;159;670
046829209294;1;264;116;137;50;63;630
042138856189;1;259;108;140;100;153;760
068647467090;1;290;206;300;51;79;926
048632878333;1;137;104;208;97;136;682
006386278306;1;117;221;149;51;87;625
057199449051;1;215;123;234;105;129;806
060003185374;1;147;280;192;96;116;831
084714573737;1;134;213;97;119;115;678
042276592640;1;210;146;238;105;106;805
052176043374;1;251;149;256;56;154;866
089849321674;1;257;276;150;65;178;926
052334623938;1;182;211;151;110;150;804
018378309371;1;263;202;152;75;52;744
084821703267;1;209;217;174;50;66;716
064753120840;1;158;260;186;68;147;819
023102892288;1;277;155;156;63;161;812
084612662884;1;226;283;192;86;120;907
017932862808;1;195;242;256;96;67;856
081824814238;1;202;137;167;77;125;708
094438460336;1;171;199;144;109;88;711
079771804942;1;201;90;251;64;83;689
026114742666;1;263;233;275;52;85;908
017427144601;1;196;132;215;108;161;812
032335705070;1;175;91;218;57;70;611
087706402995;1;101;114;213;92;82;602
060182652459;1;279;251;161;57;154;902
025831264138;1;195;280;182;91;110;858
050993479047;1;88;176;163;69;129;625
049420874014;1;276;195;218;53;119;861
086248170849;1;287;279;244;120;91;1021
096122213567;1;162;86;135;56;163;602
084865651042;1;85;94;299;113;158;749
077294395259;1;236;280;283;120;147;1066
030053750061;1;277;235;234;116;77;939
076608031023;1;276;149;109;91;62;687
099188341795;1;250;153;98;99;169;769
031190895011;1;191;175;157;97;138;758
054999942540;1;105;241;178;81;152;757
077142946790;1;116;128;107;68;152;571
003849270967;1;193;212;171;83;103;762
014989229105;1;207;274;291;61;89;922
021408373924;1;271;175;263;85;125;919
049702605523;1;172;127;280;81;134;794
015789515028;1;187;277;290;64;50;868
041544188686;1;194;141;100;51;174;660
073938116054;1;240;183;213;97;170;903
076576919401;1;100;134;286;92;167;779
050293724422;1;227;261;214;81;65;848
078980808146;1;131;249;143;97;133;753
007091490207;1;246;125;91;119;90;671
072323088861;1;197;238;135;79;161;810
087020135807;1;232;273;174;52;91;822
055455373386;1;172;135;192;83;157;739
032656757842;1;132;225;255;99;91;802
050387750969;1;289;157;161;53;124;784
013570784816;1;286;247;220;82;94;929
010692198461;1;178;264;171;69;141;823
091754276494;1;271;243;284;60;101;959
091539875208;1;212;95;149;60;60;576
054025003723;1;80;258;205;107;52;702
030379164330;1;195;115;107;91;128;636
089832753928;1;213;120;149;80;105;667
098180992348;1;279;283;105;104;57;828
026710693330;1;203;142;202;112;99;758
001710028102;1;177;171;117;66;160;691
034960979965;1;219;170;209;89;124;811
087763758384;1;214;211;169;52;73;719
007158968809;1;241;191;226;117;131;906
013004716076;1;117;190;107;66;171;651
025120453448;1;273;163;182;100;135;853
054833521008;1;164;193;229;75;133;794
043124976840;1;179;234;143;119;52;727
008269411032;1;121;218;284;66;91;780
051143248342;1;104;140;194;55;138;631
045354693897;1;195;121;192;53;152;713
001401318324;1;169;199;107;58;68;601
085309708855;1;155;202;129;101;141;728
092379016106;1;264;177;102;97;137;777
034785788470;1;102;252;228;82;108;772
016880299321;1;152;172;145;94;99;662
037448283667;1;97;160;137;50;74;518
069249515128;1;98;99;259;105;123;684
000628772667;1;273;108;279;84;136;880
095383673004;1;222;143;195;90;70;720
062597795415;1;95;206;293;50;122;766
019682308308;1;202;136;99;92;71;600
033598943313;1;261;225;136;79;62;763
037660504351;1;146;107;160;113;52;578
039345437407;1;103;271;225;116;120;835
084869115272;1;229;192;223;110;142;896
058432505361;1;259;229;264;113;80;945
000462589008;1;229;98;239;107;80;753
086834443448;1;131;139;136;101;171;678
078602956301;1;203;227;216;100;174;920
063367303266;1;228;121;230;75;92;746
041984260453;1;288;251;261;85;148;1033
018989087718;1;272;94;222;82;141;811
097363985391;1;280;249;151;114;111;905
049748187110;1;156;138;296;83;150;823
021792010549;1;97;113;241;90;64;605
052930443569;1;132;174;233;68;154;761
046662158819;1;237;170;114;51;66;638
085231828293;1;117;205;256;55;131;764
061553518145;1;248;200;92;85;128;753
064049752480;1;255;105;286;101;135;882
093618247207;1;149;180;168;106;102;705
049728640962;1;138;206;166;107;67;684
091274595499;1;140;131;127;100;73;571
093731440386;1;225;91;281;80;102;779
024902762142;1;97;218;222;60;131;728
030457678655;1;94;185;172;98;83;632
066156858588;1;148;285;206;94;169;902
052665679754;1;224;90;131;109;128;682
042224144593;1;141;202;231;88;119;781
041174300710;1;116;218;153;76;142;705
029341924697;1;213;136;229;99;121;798
098981153482;1;284;89;109;109;59;650
015813430539;1;197;216;222;61;114;810
087520197176;1;134;234;243;64;167;842
004639484013;1;286;111;243;91;166;897
072694853882;1;146;154;91;109;163;663
060140256610;1;221;196;291;96;166;970
047698502710;1;246;196;202;93;87;824
009483733758;1;148;181;102;105;118;654
053985087279;1;210;97;184;58;105;654
091495987055;1;189;113;195;115;164;776
050535117242;1;220;133;278;75;169;875
044380817529;1;268;93;225;55;59;700
031322916469;1;152;160;92;82;125;611
022938980890;1;276;93;190;59;124;742
043397874732;1;124;220;132;72;106;654
074892823981;1;253;203;267;92;76;891
010817452212;1;87;181;224;82;107;681
088745526174;1;205;188;119;76;60;648
067198484355;1;287;98;106;50;74;615
069246609478;1;137;182;213;56;161;749
074844842441;1;143;88;167;77;128;603
064283126361;1;107;90;263;102;163;725
052256932180;1;251;200;239;115;70;875
031008227234;1;116;102;174;105;117;614
082199488518;1;91;218;274;60;152;795
090079776395;1;237;136;172;81;54;680
019868612062;1;228;275;166;62;115;846
008100608145;1;222;143;148;72;116;701
019045279101;1;231;227;186;77;130;851
036650732102;1;109;279;282;88;173;931
075212792948;1;170;219;259;71;133;852
050345418472;1;130;249;220;120;110;829
066659240117;1;248;157;156;100;109;770
066597858428;1;172;199;135;111;138;755
031096216871;1;249;107;196;78;69;699
064046951119;1;165;215;275;115;74;844
066798273086;1;126;97;127;78;148;576
009253533569;1;272;225;277;82;85;941
043443494182;1;86;268;137;69;148;708
062065118041;1;193;256;265;108;118;940
004552575203;1;94;158;120;96;145;613
032622206849;1;260;218;174;72;51;775
013201143720;1;109;277;133;104;65;688
018640602050;1;213;187;124;95;92;711
085043793835;1;239;237;192;93;77;838
061417513994;1;232;133;297;109;110;881
052255482677;1;188;231;296;93;150;958
016990712469;1;159;129;90;66;75;519
091697368031;1;136;130;130;69;142;607
042587234518;1;187;266;229;65;94;841
086335210729;1;192;281;244;98;98;913
099682799151;1;165;250;166;77;101;759
044831236763;1;240;275;179;82;154;930
054586591080;1;230;196;279;83;142;930
014927585372;1;120;115;222;108;145;710
016042536603;1;187;281;199;91;173;931
076427383515;1;217;220;143;71;99;750
044386927617;1;84;145;278;57;154;718
004470243766;1;218;202;290;77;165;952
019838426199;1;129;134;137;94;117;611
019526515084;1;108;273;151;84;91;707
011326927170;1;225;212;122;109;74;742
099042531537;1;282;218;267;84;142;993
028188876970;1;237;285;228;63;113;926
039633545439;1;245;158;213;63;122;801
063987506893;1;229;279;283;54;177;1022
034808049637;1;132;84;110;76;59;461
018335406483;1;166;185;146;51;60;608
085350128564;1;273;205;236;101;94;909
059532436946;1;198;195;135;99;131;758
051585186961;1;266;155;294;81;147;943
011307561081;1;253;222;185;78;151;889
057190484124;1;215;193;150;96;94;748
048378015567;1;200;259;145;74;119;797
016626896510;1;214;117;218;52;71;672
066752285947;1;91;110;285;76;168;730
006109931133;1;198;195;228;56;176;853
053045545949;1;236;135;215;70;162;818
003376138166;1;251;130;271;87;51;790
076757307507;1;135;184;268;68;123;778
059002930759;1;109;235;189;60;94;687
059615463865;1;90;255;118;69;165;697
098316661590;1;112;161;124;80;136;613
036966297258;1;244;253;275;61;144;977
096859983496;1;161;194;90;104;54;603
053543815804;1;224;178;156;107;133;798
028330953058;1;100;222;141;62;131;656
034355162815;1;268;174;189;82;77;790
030008054859;1;229;178;109;113;103;732
096837632054;1;218;276;284;70;119;967
071058290044;1;93;283;159;58;63;656
071647791872;1;217;192;186;100;67;762
099533467262;1;134;246;232;88;165;865
080323699974;1;107;166;127;53;125;578
082503757645;1;126;204;141;58;141;670
035471041839;1;81;272;146;111;79;689
039904153363;1;234;106;158;81;51;630
024315532768;1;178;222;200;75;68;743
042859289150;1;209;200;106;69;174;758
078149075627;1;139;254;203;115;139;850
019464526544;1;139;176;244;97;65;721
038858907200;1;205;137;241;93;176;852
000142729192;1;147;246;137;95;168;793
062884323548;1;191;134;244;117;101;787
025156500739;1;190;255;193;87;141;866
002483886831;1;239;217;178;77;128;839
009543376235;1;281;232;231;111;106;961
029195574185;1;269;148;196;75;65;753
010981619630;1;101;194;207;117;81;700
032236441325;1;220;169;261;106;123;879
041008867948;1;188;211;296;70;153;918
006579340619;1;94;131;248;68;74;615
038972486102;1;287;221;105;93;140;846
032078094432;1;101;173;221;64;153;712
055643262444;1;142;198;200;91;55;686
037572543557;1;225;222;213;70;59;789
043329523208;1;130;172;300;107;170;879
022517656369;1;261;134;288;96;61;840
003813748605;1;268;267;290;54;158;1037
077417353381;1;185;224;210;89;172;880
025366273986;1;95;195;114;75;71;550
006141990897;1;221;218;186;90;64;779
084039833851;1;146;108;193;107;59;613
046459554169;1;233;150;119;108;59;669
051764506721;1;229;94;179;62;162;726
014635803805;1;256;179;202;58;146;841
032120538806;1;198;168;277;79;67;789
044433514235;1;205;216;145;110;118;794
052809495707;1;217;229;251;60;93;850
026756228119;1;127;206;243;73;120;769
082994211016;1;109;154;141;101;53;558
084731113006;1;185;117;201;117;157;777
019513021221;1;226;155;121;63;80;645
031781281317;1;142;164;272;119;89;786
044229068150;1;116;148;94;69;164;591
096608630971;1;230;220;101;72;149;772
058349651362;1;143;193;112;77;86;611
089714911288;1;125;106;132;116;162;641
068708514630;1;242;158;183;88;112;783
090850221757;1;273;267;199;81;134;954
094618161603;1;178;218;126;54;158;734
031638640116;1;275;203;113;104;97;792
010449254213;1;254;85;231;95;127;792
054015899132;1;99;193;183;72;87;634
047007107936;1;110;242;266;64;134;816
014217754884;1;204;197;262;64;107;834
082064880918;1;147;142;186;88;91;654
088220066047;1;100;167;133;111;166;677
051010850541;1;228;80;117;65;72;562
085202527937;1;211;137;159;94;178;779
022122230867;1;159;113;205;71;159;707
043982522544;1;128;227;274;103;167;899
009143963838;1;109;238;162;101;167;777
049217775149;1;265;173;264;58;58;818
071579018232;1;130;104;220;75;177;706
087233688602;1;83;240;163;107;56;649
007992080697;1;195;244;233;110;137;919
003429805649;1;173;231;99;118;72;693
042911936581;1;215;105;256;73;89;738
042855221643;1;173;120;203;68;113;677
090658313758;1;211;102;160;77;89;639
066739848836;1;204;272;218;77;98;869
085913389364;1;147;256;161;66;121;751
036462901798;1;169;180;194;60;175;778
047775760270;1;189;133;288;119;84;813
031141957046;1;254;86;262;86;81;769
020371283834;1;116;171;276;79;66;708
001462734893;1;159;268;126;67;131;751
017688550660;1;147;280;190;86;105;808
029365024041;1;133;184;118;92;172;699
052587908078;1;243;266;91;60;135;795
022568643939;1;268;141;224;81;171;885
005531995610;1;282;157;280;56;121;896
054557185664;1;99;189;190;64;61;603
094825922113;1;132;120;239;76;100;667
009952931609;1;115;138;288;109;125;775
075768200129;1;269;248;142;103;137;899
037502454716;1;100;160;285;52;51;648
004545629575;1;165;178;251;71;89;754
093751375313;1;199;125;264;63;134;785
040576800840;1;203;272;206;90;133;904
009142450758;1;197;168;126;56;117;664
088088062250;1;174;216;189;100;176;855
045567082468;1;248;103;202;107;113;773
084814360868;1;115;167;151;97;73;603
007691693366;1;150;268;280;98;118;914
074033157843;1;90;180;228;91;80;669
064908005415;1;113;219;283;64;159;838
079831618905;1;154;205;109;106;142;716
053956309628;1;174;246;205;105;95;825
019500589570;1;289;273;243;114;159;1078
050694871390;1;182;185;108;68;153;696
087005994584;1;232;216;289;77;68;882
070848340867;1;289;95;254;100;90;828
008186832103;1;87;183;283;117;107;777
035251577305;1;263;89;295;115;143;905
077476845349;1;291;158;274;84;56;863
031482878615;1;211;119;238;81;81;730
006100760202;1;80;258;255;78;158;829
042989520899;1;198;144;286;106;50;784
032716100132;1;219;191;270;105;119;904
033545428049;1;223;200;140;61;163;787
095115352683;1;156;235;250;88;128;857
002778174999;1;143;216;125;61;172;717
031844077630;1;248;216;208;102;89;863
005244920668;1;274;234;288;65;137;998
026295116105;1;148;199;271;58;175;851
066671700439;1;153;267;269;113;112;914
090421521035;1;199;191;155;90;105;740
076769413085;1;89;122;102;81;149;543
056714729152;1;184;98;226;54;97;659
018984356008;1;86;160;121;87;158;612
055697642571;1;98;214;104;63;117;596
091348966124;1;199;245;239;91;139;913
004773797893;1;273;221;246;113;56;909
018181541667;1;157;192;205;93;62;709
014857383103;1;156;110;91;114;51;522
017185082497;1;274;283;226;117;83;983
081477504462;1;276;109;285;103;79;852
084134421604;1;172;248;243;69;157;889
044394698361;1;227;188;268;96;59;838
009241828179;1;210;259;252;89;90;900
039122270270;1;153;201;193;105;82;734
082713642322;1;258;159;285;96;123;921
026749966005;1;118;242;290;98;118;866
093527421560;1;274;151;100;114;100;739
063371714526;1;135;285;216;78;69;783
017149776286;1;90;282;247;101;60;780
028475849122;1;135;91;190;103;171;690
017686333459;1;187;145;191;62;138;723
018484117678;1;159;133;210;106;50;658
035386525406;1;83;247;141;117;72;660
019933966143;1;149;162;176;107;65;659
019213900260;1;190;157;136;107;114;704
046026589199;1;103;130;248;98;163;742
044635303675;1;273;208;251;118;172;1022
022859947741;1;124;90;115;71;139;539
072293428947;1;287;181;178;114;70;830
096592669932;1;83;270;174;79;104;710
081713075634;1;289;142;248;66;162;907
047559013101;1;134;155;286;107;104;786
047169957353;1;275;218;262;102;145;1002
012537180769;1;257;231;300;93;56;937
075156882650;1;234;120;152;61;114;681
036555631348;1;213;146;283;50;88;780
012959239662;1;277;114;206;115;166;878
072553265446;1;92;207;199;83;159;740
072894064553;1;109;229;133;66;59;596
015607711216;1;249;179;225;72;103;828
083288645500;1;108;207;168;86;147;716
064546039185;1;236;104;267;105;125;837
050084859076;1;206;280;152;89;120;847
098741193196;1;196;176;117;51;111;651
068008746537;1;213;223;214;98;124;872
069270098404;1;220;239;168;107;132;866
018090605347;1;144;142;140;71;79;576
021849876197;1;247;238;250;76;116;927
096088186600;1;147;244;163;65;129;748
091560083420;1;98;134;181;80;132;625
048687103022;1;134;118;236;53;166;707
083575293495;1;280;169;179;89;132;849
082932716134;1;192;110;107;74;124;607
079438051490;1;208;264;169;69;160;870
058142072192;1;245;100;231;60;119;755
077515037821;1;182;193;168;60;68;671
089232858504;1;289;253;195;100;77;914
061605382387;1;125;237;244;100;165;871
034893605140;1;215;260;219;66;156;916
041308523528;1;229;187;160;103;65;744
001717809977;1;213;131;237;82;95;758
071783126015;1;172;238;115;69;146;740
087179175665;1;280;199;265;86;99;929
012557045233;1;149;120;224;66;102;661
065096927838;1;193;124;194;82;75;668
006900916064;1;259;183;294;71;91;898
008357320529;1;236;126;233;99;157;851
059336250367;1;278;134;111;79;167;769
005308925978;1;230;193;291;86;173;973
009248107747;1;101;163;259;87;119;729
033991732969;1;177;246;101;90;72;686
022494246183;1;159;128;253;57;80;677
002008725587;1;131;115;91;89;144;570
064680643050;1;152;249;272;87;168;928
074132514455;1;91;228;105;71;99;594
061946993414;1;191;166;231;104;161;853
098929205434;1;213;150;95;113;100;671
079869319125;1;205;245;126;75;108;759
036346314906;1;157;132;194;106;158;747
080315949167;1;183;279;133;53;98;746
009199739471;1;132;96;90;119;145;582
055315864410;1;119;87;200;55;125;586
068764154800;1;225;246;129;84;158;842
033848188162;1;199;181;183;84;114;761
022770791552;1;219;145;178;61;153;756
023317088533;1;164;147;172;62;75;620
098898374142;1;257;169;175;119;101;821
064905978728;1;188;221;130;101;56;696
050088487470;1;196;288;234;120;142;980
069154320470;1;134;84;218;75;120;631
073184612361;1;153;150;145;100;54;602
034816301625;1;181;230;246;120;80;857
093487908210;1;175;132;93;106;162;668
033355536979;1;221;150;266;97;149;883
001475803894;1;157;250;127;85;149;768
080715384931;1;223;254;169;85;119;850
008149380486;1;187;257;120;65;171;800
033268905052;1;270;125;228;68;140;831
038452114097;1;269;236;191;119;158;973
039252329610;1;242;159;287;94;86;868
096300239064;1;120;205;195;105;130;755
061692714027;1;208;273;258;72;141;952
039724028283;1;273;83;266;83;146;851
022106332266;1;151;80;299;98;161;789
000798480253;1;205;223;213;86;64;791
039223472502;1;195;106;136;73;76;586
087028649595;1;140;118;100;112;71;541
067678667707;1;124;212;273;82;85;776
097336525668;1;214;202;132;60;143;751
002286100957;1;246;88;155;93;104;686
075278696362;1;211;259;165;57;173;865
061476588301;1;236;277;108;113;154;888
037811679238;1;172;108;168;115;151;714
073244628182;1;102;193;151;57;61;564
041075104631;1;209;171;294;99;92;865
057517415296;1;101;178;288;77;71;715
045939989492;1;161;163;175;79;147;725
013131014872;1;188;183;122;85;172;750
079452235642;1;110;261;260;95;131;857
056368149476;1;210;191;250;103;127;881
045652717195;1;80;230;207;88;113;718
006660485032;1;103;224;201;99;175;802
093492336830;1;176;218;111;59;66;630
085477992130;1;226;232;251;57;98;864
082076151504;1;145;212;293;64;164;878
044498156870;1;202;234;183;101;136;856
060337514982;1;159;225;215;56;115;770
072330459284;1;286;200;105;85;149;825
056381405348;1;175;171;275;103;90;814
081530139032;1;153;115;234;56;169;727
075972023574;1;211;168;214;71;65;729
019382590505;1;264;176;198;114;89;841
096474834776;1;155;155;93;71;127;601
097285059072;1;156;170;100;57;157;640
045597126527;1;91;233;291;77;118;810
030423180796;1;286;173;132;114;76;781
039243812905;1;208;223;291;101;68;891
053748136185;1;135;201;227;85;78;726
098487370012;1;243;187;258;79;121;888
064901819600;1;238;282;153;71;154;898
059069969661;1;81;143;147;51;87;509
060556876969;1;244;288;196;59;87;874
082244471621;1;281;90;94;87;84;636
031558826906;1;126;109;244;83;134;696
003706279574;1;185;219;95;69;157;725
042669683464;1;284;81;95;78;103;641
052494696764;1;160;283;274;118;86;921
078065526863;1;134;166;100;70;137;607
047011238043;1;215;131;254;55;125;780
058198508183;1;197;272;299;93;78;939
077699269992;1;135;136;283;115;62;731
040168046415;1;164;214;272;101;60;811
043802567446;1;209;137;296;65;167;874
070528790171;1;160;121;230;90;69;670
026401991405;1;130;214;202;59;158;763
050680282520;1;226;265;207;98;98;894
048700220011;1;213;265;153;63;138;832
027919177034;1;246;103;297;58;160;864
084556814053;1;278;171;207;83;60;799
017445618973;1;174;216;280;114;171;955
080950958662;1;181;170;124;107;137;719
017925097245;1;280;137;296;109;53;875
034571894601;1;266;166;104;100;90;726
020225145253;1;176;223;258;63;83;803
044339048406;1;261;186;113;55;95;710
018146588160;1;231;170;211;76;162;850
024363234446;1;115;126;223;114;133;711
089225632650;1;211;273;103;75;126;788
045590378331;1;243;129;203;89;107;771
060640769533;1;205;270;120;119;162;876
035287245889;1;165;91;144;55;124;579
088916294380;1;99;192;286;87;52;716
016024672521;1;149;83;255;76;78;641
050459685185;1;265;149;294;111;109;928
034958084475;1;90;187;221;80;104;682
094571659040;1;157;205;173;63;84;682
039388940997;1;125;163;134;111;138;671
029768834003;1;238;90;109;104;50;591
032858453893;1;235;205;103;111;150;804
036677294185;1;80;177;120;107;123;607
064307482092;1;95;269;144;106;73;687
054421892735;1;237;171;115;56;123;702
006158489836;1;206;112;165;111;83;677
031487776511;1;177;265;212;111;118;883
006092009843;1;288;278;115;57;62;800
077662811538;1;182;166;170;111;156;785
083618887901;1;186;83;298;59;151;777
023754531276;1;275;251;294;67;146;1033
047126535500;1;233;130;183;97;112;755
017064135631;1;277;195;144;87;69;772
096210711910;1;215;93;270;111;120;809
070399191737;1;250;192;91;104;174;811
047995608845;1;199;105;292;119;72;787
053520995801;1;290;114;154;107;97;762
048422341456;1;222;180;260;104;121;887
088821907986;1;118;239;93;62;153;665
091408919208;1;190;216;140;52;168;766
070524995585;1;157;157;293;119;69;795
045695574360;1;142;248;130;120;136;776
087861894309;1;273;146;286;84;159;948
066189043924;1;119;228;158;110;81;696
072031644619;1;283;280;174;109;119;965
052820537925;1;128;105;264;57;176;730
065305195229;1;158;183;199;89;133;762
082095534901;1;150;218;123;54;54;599
058296305830;1;174;229;94;75;110;682
032212906223;1;216;177;169;103;80;745
089815545968;1;177;163;151;69;163;723
031832778528;1;238;105;136;68;168;715
022299336358;1;272;280;205;51;86;894
097909665653;1;242;88;200;59;76;665
019763376504;1;126;198;190;109;82;705
024071818402;1;205;250;151;115;84;805
054677667079;1;224;259;123;80;62;748
072103805659;1;270;90;279;102;79;820
059618633201;1;124;150;159;79;99;611
025222496618;1;149;201;234;113;108;805
099358511517;1;155;240;107;101;142;745
096259776641;1;207;137;219;106;130;799
096717898962;1;163;217;105;65;148;698
061812119890;1;126;91;148;76;145;586
025778483387;1;214;184;231;74;109;812
000992741903;1;259;145;263;75;82;824
029795656642;1;190;269;163;73;50;745
006666312649;1;267;172;116;99;143;797
021925874042;1;104;101;126;103;106;540
081729959637;1;132;101;131;63;111;538
056770072822;1;210;157;142;55;124;688
076437493031;1;242;158;116;114;70;700
060414178568;1;239;124;100;50;93;606
018881781486;1;170;117;151;86;86;610
035843189677;1;97;189;92;54;165;597
033668956540;1;96;197;234;60;141;728
055901913860;1;146;152;108;82;107;595
000963001508;1;251;131;103;72;130;687
086213926388;1;89;193;236;61;165;744
034241587907;1;131;276;177;116;102;802
093788137408;1;175;248;299;70;88;880
037805296987;1;123;239;256;90;123;831
012309815937;1;137;217;118;96;59;627
072540248775;1;259;112;208;67;105;751
096904589419;1;194;128;248;61;145;776
093676419872;1;167;107;183;106;54;617
085594071679;1;126;259;275;117;172;949
074782770692;1;121;135;134;77;110;577
027315678093;1;252;211;163;62;121;809
060994679160;1;100;107;227;59;128;621
009506077093;1;271;236;204;119;152;982
005523087272;1;201;93;206;104;79;683
034836672016;1;246;122;225;72;173;838
026074203246;1;256;185;285;101;104;931
003161516467;1;249;100;106;54;102;611
094832326407;1;148;234;140;57;171;750
002365499498;1;209;167;285;87;109;857
027332046439;1;88;129;95;73;56;441
064540608851;1;127;151;178;86;157;699
054406199716;1;108;142;253;113;120;736
072890343928;1;278;193;258;92;58;879
069400409935;1;127;228;254;77;61;747
036603695743;1;252;210;131;112;139;844
049591969788;1;101;284;103;63;95;646
094147520245;1;110;104;286;111;134;745
072247763371;1;170;109;210;67;82;638
005683091488;1;164;250;112;66;62;654
005027260503;1;141;157;218;85;130;731
092981028448;1;142;213;297;92;111;855
027220780783;1;235;139;206;120;72;772
085048130239;1;236;216;128;93;94;767
007053569894;1;113;246;290;84;89;822
011497635581;1;169;176;288;54;84;771
003643396274;1;179;217;210;110;165;881
067153757322;1;110;113;281;106;145;755
090125503702;1;278;93;91;61;159;682
036702667303;1;195;152;192;54;139;732
024109349329;1;131;86;237;91;72;617
064163366259;1;201;267;182;90;102;842
075566917545;1;111;238;121;51;61;582
014648445966;1;289;220;145;84;114;852
023345096622;1;246;182;239;117;94;878
017789980025;1;248;157;206;57;173;841
058885177494;1;195;171;242;105;169;882
072116034066;1;187;91;222;73;116;689
075598574083;1;261;140;105;65;84;655
025783009812;1;291;211;163;87;140;892
050671298485;1;82;216;98;63;103;562
056057878583;1;169;105;256;91;124;745
073954511603;1;181;200;290;58;169;898
077179551708;1;283;216;173;67;75;814
052697261406;1;132;243;181;114;51;721
037349326144;1;117;256;163;77;83;696
000226250024;1;280;257;190;110;93;930
070942361605;1;283;186;123;93;164;849
014077948956;1;222;261;223;93;124;923
039105663511;1;229;231;230;106;110;906
024204471913;1;143;185;90;59;130;607
050135004594;1;99;195;185;60;151;690
055809207776;1;120;242;158;88;174;782
019774442487;1;276;262;266;117;159;1080
006146232565;1;285;102;251;90;165;893
046845979326;1;148;198;209;83;88;726
084313512472;1;194;260;94;81;63;692
070594414397;1;266;288;224;68;125;971
080091041730;1;188;89;196;96;118;687
025245452416;1;237;179;126;113;104;759
081566306482;1;285;156;195;74;107;817
000669142183;1;92;271;254;117;139;873
020122992481;1;261;208;114;100;135;818
041922143570;1;235;95;211;57;116;714
016121554848;1;183;92;183;100;115;673
000127219880;1;155;200;197;115;168;835
094816859356;1;145;105;207;61;142;660
079576054723;1;267;208;265;61;68;869
086565266354;1;213;143;200;80;151;787
049062490602;1;88;185;143;96;149;661
055346189161;1;85;102;104;84;86;461
031512627125;1;182;212;227;78;88;787
017557555056;1;163;253;96;116;114;742
045696558222;1;258;140;243;113;154;908
053494561664;1;161;212;98;54;71;596
066620290363;1;83;106;131;94;103;517
021698239475;1;152;191;133;55;158;689
079667756584;1;206;256;278;62;165;967
022243054718;1;119;224;182;54;111;690
074300341643;1;250;100;190;116;165;821
069409237514;1;278;181;260;60;57;836
022457905971;1;272;247;193;76;111;899
043686289456;1;109;160;140;72;77;558
075919344846;1;138;109;199;81;67;594
081665975407;1;202;196;276;51;125;850
064220663597;1;91;249;234;50;58;682
082290185339;1;170;209;123;81;84;667
000490205786;1;197;176;121;79;111;684
069481895432;1;140;220;95;101;119;675
083690663194;1;275;167;173;117;131;863
029974715955;1;274;153;154;111;141;833
075489796700;1;190;83;279;72;126;750
024407627143;1;142;279;158;101;106;786
041058335228;1;135;143;146;95;126;645
057839565563;1;252;263;199;71;126;911
060493741914;1;239;157;207;51;112;766
032096520075;1;255;256;227;114;164;1016
062390640919;1;177;253;272;61;147;910
048534226974;1;290;136;143;55;176;800
073183028892;1;285;243;158;100;86;872
083891524297;1;157;253;184;95;105;794
032188326663;1;185;95;253;103;84;720
075375499489;1;266;194;111;79;64;714
091905199111;1;145;232;287;103;113;880
068916177805;1;144;268;278;54;133;877
092267431397;1;111;183;172;75;118;659
044219518436;1;195;214;138;118;70;735
090559881240;1;204;283;162;110;156;915
036869682786;1;153;162;161;104;79;659
010768065423;1;144;168;250;56;157;775
038141087504;1;274;234;165;117;50;840
038487679246;1;87;136;191;71;125;610
013423931854;1;224;285;106;120;119;854
001414926747;1;141;236;243;96;62;778
000048627220;1;202;118;260;77;53;710
083788914945;1;82;261;209;50;60;662
054260260524;1;256;173;255;57;87;828
085902041806;1;278;182;186;57;118;821
093773335193;1;88;200;111;75;83;557
053679904926;1;150;125;262;68;163;768
015370375626;1;191;255;146;70;57;719
077519983630;1;288;101;133;112;144;778
008182903619;1;179;119;245;112;121;776
041739951841;1;234;142;228;81;142;827
018377631779;1;291;144;94;91;61;681
078549378015;1;144;111;122;90;108;575
068935656066;1;200;199;227;101;172;899
064191092558;1;249;285;124;70;73;801
032802143465;1;239;112;229;114;95;789
075691162906;1;275;163;126;117;65;746
006414698981;1;207;195;244;83;54;783
015785521384;1;176;115;203;69;160;723
033463921901;1;263;243;119;89;124;838
051528970605;1;196;113;221;106;82;718
037585089658;1;176;90;295;75;95;731
008124409451;1;191;157;118;56;90;612
073554742562;1;271;185;223;76;83;838
094486657956;1;176;234;251;53;83;797
079552499238;1;188;266;117;64;88;723
005791249819;1;189;214;159;63;141;766
091812940031;1;197;206;137;95;84;719
050475056634;1;117;186;165;57;50;575
069185050158;1;102;187;155;78;74;596
001407107735;1;81;108;218;52;147;606
075630328943;1;111;138;262;99;120;730
010258396628;1;271;231;270;84;134;990
089543289600;1;279;209;193;67;123;871
073833379668;1;221;105;118;64;76;584
095798280081;1;266;137;293;54;85;835
079268175250;1;281;238;285;100;102;1006
072930742482;1;253;259;232;86;88;918
038476245727;1;194;206;242;107;52;801
081988693694;1;134;216;279;100;147;876
003505994792;1;165;109;144;54;121;593
057833985514;1;200;241;244;107;160;952
024943798082;1;107;119;252;55;168;701
008919893956;1;199;150;241;105;123;818
066188805002;1;81;239;257;85;135;797
019669993008;1;100;208;134;84;138;664
099323000464;1;217;217;135;86;70;725
043536314261;1;156;132;288;68;137;781
044248888924;1;156;82;227;73;72;610
040749227712;1;129;201;211;120;123;784
054001132041;1;220;137;236;98;138;829
054915268820;1;275;106;219;58;64;722
075282025273;1;205;258;94;50;54;661
008475904322;1;217;201;283;61;82;844
055446909908;1;107;217;139;53;135;651
098782221627;1;252;265;133;104;65;819
056107111973;1;174;171;132;81;74;632
026658546464;1;168;119;267;120;118;792
048057798257;1;93;263;279;90;103;828
083973571455;1;173;131;104;103;119;630
050258240668;1;218;92;197;64;140;711
010098141378;1;254;113;286;65;111;829
069806644732;1;238;121;125;108;50;642
016820961256;1;85;138;96;97;110;526
024877981525;1;196;221;283;90;68;858
061613201906;1;128;124;100;74;100;526
093295276498;1;157;239;101;91;129;717
082055344089;1;81;229;160;62;155;687
069585770033;1;145;84;152;84;50;515
089708750909;1;243;123;260;86;96;808
071639850158;1;122;248;134;120;65;689
062317123319;1;236;234;211;109;136;926
031726050555;1;235;98;297;113;90;833
026157884744;1;80;232;273;79;98;762
079134804037;1;88;149;159;118;91;605
044128518283;1;136;169;93;102;177;677
036576802299;1;157;100;153;115;166;691
045163328545;1;239;142;243;120;95;839
045018915175;1;258;116;212;94;177;857
097218118589;1;143;149;127;110;170;699
002495986048;1;273;258;124;100;134;889
077811781401;1;201;153;211;54;146;765
014997346351;1;171;171;218;83;92;735
022564770318;1;259;239;167;50;90;805
000879404281;1;269;220;237;53;88;867
049075341120;1;122;164;138;73;76;573
021952233040;1;253;230;117;63;96;759
093016529585;1;159;136;218;89;96;698
006971019066;1;137;169;214;119;65;704
071940518306;1;80;119;244;106;89;638
019064707710;1;204;188;168;94;107;761
009784356730;1;138;80;96;115;103;532
080206226622;1;272;82;266;90;174;884
054751298118;1;277;132;185;61;58;713
044151295338;1;194;93;251;77;122;737
008093044314;1;154;255;108;98;102;717
055907144106;1;99;125;221;82;101;628
099574486128;1;182;286;107;82;107;764
092101123946;1;214;126;93;57;104;594
031636580102;1;213;158;174;72;112;729
030121881851;1;256;126;239;120;79;820
070641617848;1;132;130;205;120;86;673
001932069008;1;287;193;149;116;124;869
095814395500;1;96;130;257;54;101;638
053164139797;1;142;160;276;101;83;762
023320092148;1;213;273;198;88;133;905
096826866610;1;280;240;138;113;92;863
068006597556;1;229;255;167;107;177;935
060059921850;1;239;166;126;96;134;761
064622710264;1;161;269;222;54;121;827
016889887618;1;165;100;294;118;137;814
037039344411;1;178;105;124;78;74;559
080329892567;1;185;288;229;120;92;914
056105156858;1;234;254;287;62;164;1001
009536737763;1;238;224;244;120;68;894
078121703024;1;192;224;172;69;135;792
051868543164;1;100;184;181;110;170;745
088792995918;1;223;158;195;109;54;739
090898680920;1;262;108;274;60;145;849
038214987235;1;275;198;227;71;122;893
028090873457;1;160;225;149;81;106;721
084394685953;1;212;144;272;52;166;846
036642965972;1;266;139;287;120;169;981
091033057050;1;251;172;237;67;134;861
006631792274;1;194;162;127;63;147;693
062837593185;1;149;242;102;95;60;648
030143043120;1;126;222;214;103;133;798
022384951652;1;132;191;205;97;148;773
060290405711;1;130;188;183;83;54;638
078266288326;1;217;93;235;69;127;741
054084798363;1;258;193;206;105;109;871
002673861806;1;242;255;256;106;140;999
010326491343;1;259;116;217;111;129;832
042079924663;1;251;244;146;64;87;792
081150494604;1;245;114;130;118;117;724
014448566865;1;99;229;288;64;112;792
054693003773;1;134;261;244;91;78;808
054996561239;1;259;206;249;53;176;943
083356278473;1;233;263;203;109;162;970
039497788199;1;159;284;248;117;54;862
073572972049;1;220;218;162;74;69;743
053164270023;1;126;230;226;58;155;795
081522798017;1;164;208;145;118;170;805
055728541918;1;202;244;101;104;70;721
088727795612;1;200;196;249;104;84;833
046402068688;1;83;229;265;68;64;709
059892106428;1;138;216;173;70;79;676
083189639110;1;259;117;246;86;125;833
035265802040;1;155;263;116;62;133;729
012999784480;1;254;231;122;110;158;875
042750098701;1;274;145;284;59;103;865
084369279692;1;121;116;240;98;71;646
039494019706;1;182;86;111;51;96;526
015134968092;1;192;274;173;110;101;850
068640452598;1;137;155;227;102;157;778
018958760895;1;235;185;288;76;170;954
026079559442;1;209;144;227;65;52;697
035343977250;1;105;156;117;70;51;499
063368580968;1;85;80;195;113;138;611
047478460320;1;121;212;191;87;96;707
048899129977;1;183;134;265;80;60;722
038396715039;1;139;272;235;65;55;766
044238594935;1;246;152;120;53;135;706
044024588936;1;221;222;247;66;58;814
094154641565;1;246;182;198;118;176;920
066995122431;1;149;162;150;55;115;631
087470624633;1;111;110;267;109;119;716
048095311824;1;96;281;145;82;67;671
029952434803;1;91;94;144;89;89;507
018720624661;1;116;129;263;64;83;655
049531943552;1;214;109;155;57;126;661
018671481852;1;102;170;130;84;50;536
094753945765;1;141;232;263;73;148;857
025273143162;1;284;111;214;98;112;819
062648132620;1;285;237;142;59;121;844
055557569108;1;154;178;272;78;107;789
086440406811;1;148;282;282;117;145;974
052451543018;1;189;166;164;53;93;665
020493532004;1;268;106;206;53;142;775
088937098462;1;169;184;112;58;164;687
038567909129;1;85;141;241;118;83;668
076539695174;1;103;170;293;111;106;783
081475756303;1;118;188;237;98;64;705
056321864898;1;180;184;152;53;168;737
083231845166;1;101;140;252;64;69;626
061295160086;1;169;107;206;94;123;699
041231760312;1;140;194;249;96;53;732
002951862759;1;163;193;131;109;92;688
089985781755;1;161;93;206;99;99;658
079224461401;1;126;166;147;79;119;637
020720486706;1;275;277;229;111;109;1001
073714742417;1;152;137;99;101;108;597
099580916030;1;100;227;186;73;78;664
026524362717;1;222;179;297;67;62;827
009285290299;1;213;127;290;107;156;893
096089168200;1;88;262;125;107;64;646
099467317760;1;133;110;158;56;151;608
002790063322;1;153;213;295;97;141;899
005895449084;1;253;148;192;86;82;761
046050199042;1;165;171;187;69;140;732
027570806955;1;109;138;204;105;175;731
020978516920;1;238;140;166;79;125;748
085830857888;1;81;100;296;117;80;674
006480850175;1;153;192;284;116;178;923
018965751205;1;142;188;239;53;158;780
091270533591;1;93;223;276;82;111;785
087081138859;1;220;126;160;67;97;670
010046089646;1;284;85;194;76;97;736
069883456598;1;239;93;256;72;165;825
022136263384;1;186;145;242;105;169;847
003042083830;1;119;201;116;114;140;690
093832187514;1;160;181;286;92;73;792
024806036612;1;263;240;119;79;72;773
040325128204;1;279;176;183;87;124;849
018335279468;1;136;182;266;115;144;843
085849094399;1;258;103;233;66;101;761
030155218051;1;170;239;201;107;159;876
067686355797;1;201;248;113;64;118;744
064181292807;1;254;105;252;117;69;797
007130187237;1;114;220;170;106;159;769
016672199651;1;273;228;99;117;54;771
065812097140;1;185;278;265;92;60;880
064168833927;1;107;171;240;98;147;763
060927338993;1;158;212;211;55;150;786
084436759771;1;88;92;256;94;78;608
004526436680;1;285;122;172;98;122;799
057973076613;1;253;86;279;111;168;897
043220992856;1;204;221;99;100;162;786
030517896137;1;274;137;210;73;115;809
056249218348;1;199;279;98;70;162;808
085799667701;1;85;120;270;60;121;656
035700076799;1;233;284;179;97;178;971
021703092366;1;208;280;184;71;81;824
027455256362;1;283;282;300;52;52;969
086611285849;1;84;116;202;63;168;633
033829877664;1;250;282;239;50;114;935
052402352065;1;205;180;158;54;50;647
026592497039;1;263;91;98;86;84;622
041727798889;1;161;94;176;93;123;647
047102793674;1;91;259;191;72;80;693
033989589224;1;237;182;176;103;79;777
006361422323;1;271;282;283;107;59;1002
042708196940;1;166;286;233;90;60;835
056554754587;1;133;152;250;56;104;695
082744503391;1;262;237;296;73;61;929
046667349164;1;181;170;181;54;161;747
002309667645;1;284;250;170;86;127;917
018111813118;1;116;221;124;84;124;669
061376796276;1;201;263;291;88;94;937
090784988301;1;212;279;108;119;100;818
091592904995;1;180;200;139;66;56;641
076784029480;1;239;226;160;88;98;811
063274339100;1;283;231;193;79;77;863
037342853679;1;247;173;206;84;164;874
071679157488;1;173;258;209;85;160;885
076379128017;1;234;156;114;92;152;748
090641406020;1;108;147;300;54;55;664
083649798434;1;275;148;160;115;155;853
027988761444;1;118;99;103;107;73;500
010882253259;1;279;173;195;98;93;838
040750010421;1;277;257;262;108;161;1065
023665879706;1;166;130;111;53;87;547
027652791853;1;269;211;173;79;65;797
005119768903;1;241;223;195;55;50;764
057275671860;1;266;206;207;96;88;863
092586028260;1;95;161;292;118;104;770
011738608720;1;269;158;289;99;94;909
031431563998;1;239;222;195;65;90;811
024839064352;1;238;268;256;94;167;1023
093306017232;1;290;132;264;86;136;908
078025191621;1;206;145;277;119;107;854
068713067711;1;260;223;292;71;62;908
020900065394;1;150;87;220;56;104;617
028819398235;1;204;249;162;64;99;778
017482076031;1;179;272;136;81;172;840
039816587453;1;139;122;147;66;55;529
076521146163;1;158;237;104;99;141;739
073752243429;1;151;231;115;90;169;756
034585800865;1;91;144;209;104;76;624
035012355518;1;177;124;213;86;59;659
004747506373;1;162;201;144;93;81;681
045135398486;1;88;249;100;94;72;603
002796107150;1;272;99;239;103;58;771
039241776394;1;232;207;232;75;97;843
075679920980;1;173;164;110;90;65;602
036534936208;1;145;282;182;109;175;893
029267250395;1;201;208;272;90;124;895
074317851469;1;148;139;180;101;131;699
078915304485;1;223;128;158;87;150;746
038124606194;1;202;232;223;89;76;822
003363624771;1;255;91;229;59;88;722
051702092338;1;250;90;162;68;129;699
034785997973;1;160;197;97;77;145;676
017015910105;1;209;144;224;104;161;842
092373276977;1;248;211;168;58;121;806
088195968192;1;129;116;258;54;144;701
003537423918;1;268;239;254;80;82;923
077064581739;1;103;231;124;102;132;692
023342518890;1;265;275;223;83;76;922
050561234673;1;267;141;108;63;53;632
096094075536;1;118;118;121;79;98;534
002688157427;1;88;87;222;73;60;530
023757913995;1;248;101;157;107;98;711
016659004219;1;247;273;244;66;61;891
099444274253;1;129;152;281;79;159;800
018277427557;1;184;229;272;80;155;920
077412642111;1;245;102;189;110;90;736
046992910625;1;202;115;259;50;99;725
063263728425;1;132;206;139;59;82;618
002574393023;1;121;108;257;77;155;718
086107319749;1;120;172;168;119;139;718
045552611891;1;120;173;287;53;165;798
079631257495;1;142;103;178;115;88;626
077946018709;1;291;138;291;82;111;913
099252316554;1;217;101;114;64;72;568
097041711818;1;136;221;198;93;136;784
054653138828;1;188;120;264;76;61;709
004112576682;1;212;146;255;94;75;782
042240724498;1;134;281;227;63;70;775
039338391363;1;190;146;205;68;115;724
063495034720;1;108;92;257;88;138;683
045617039174;1;140;119;90;101;50;500
032778766771;1;176;212;260;100;170;918
010518334693;1;288;227;239;62;117;933
014501373365;1;224;101;224;88;150;787
066351879216;1;202;212;192;113;120;839
031356791257;1;150;186;209;117;111;773
003044261230;1;88;224;217;83;121;733
098126837604;1;117;181;189;75;129;691
066319486323;1;96;147;220;104;85;652
049648906296;1;280;247;168;91;123;909
050429122473;1;226;148;159;111;118;762
057854504991;1;107;222;202;103;134;768
085755706722;1;204;151;118;94;98;665
076736885453;1;84;87;204;78;94;547
025905721294;1;123;128;141;79;116;587
003923636854;1;179;198;230;63;169;839
057592302276;1;196;280;154;117;114;861
080300152305;1;101;198;146;76;161;682
031142303493;1;235;161;276;59;156;887
053831342599;1;229;233;283;84;55;884
093244161237;1;153;155;104;58;81;551
053732288727;1;274;200;198;107;140;919
046578722863;1;246;167;110;94;159;776
017474186170;1;201;118;263;51;57;690
085194097629;1;85;124;195;100;87;591
018792498631;1;87;147;213;120;154;721
039083190590;1;276;130;121;54;162;743
050844626314;1;191;263;113;109;106;782
078927015448;1;205;252;127;57;134;775
005764634695;1;203;234;227;79;123;866
013746077360;1;150;271;206;56;93;776
088876366999;1;278;155;197;115;150;895
057701970324;1;288;229;170;103;79;869
025837085457;1;275;282;171;97;66;891
038617682338;1;136;162;129;77;110;614
009231246855;1;258;271;176;63;100;868
081560951985;1;126;284;274;111;140;935
060026903576;1;123;126;222;83;67;621
044066453537;1;167;195;134;110;159;765
066331994014;1;215;156;181;118;64;734
096185196545;1;230;209;140;63;93;735
037556842176;1;257;141;246;103;89;836
096458379086;1;150;122;163;68;117;620
094342507457;1;123;216;104;114;99;656
039910988040;1;142;174;115;79;106;616
047562390899;1;213;94;134;62;140;643
030688519115;1;280;177;256;64;120;897
086336784085;1;115;89;118;103;145;570
054696900280;1;146;260;264;71;168;909
058172611314;1;188;226;233;62;55;764
022670924766;1;113;150;180;96;137;676
059085530311;1;152;85;173;110;164;684
039406234277;1;279;224;229;108;77;917
006694936819;1;178;252;268;76;174;948
019309354242;1;231;236;148;70;58;743
035604318183;1;254;226;220;115;158;973
098107796166;1;254;197;134;83;90;758
041326790082;1;88;169;240;101;139;737
088702261818;1;144;233;273;71;75;796
060921445456;1;220;143;94;79;94;630
085626305254;1;82;150;193;60;164;649
012784548540;1;238;131;147;62;74;652
010285782381;1;154;139;206;93;137;729
070000441071;1;209;192;244;64;62;771
073074531343;1;148;133;134;66;59;540
054606888308;1;224;283;236;54;74;871
061532424090;1;287;179;205;90;119;880
080335205497;1;177;266;166;103;118;830
091119281059;1;102;91;300;57;140;690
096733614254;1;180;81;138;52;78;529
056359817119;1;279;170;288;102;132;971
030927868306;1;162;140;199;71;73;645
088626919497;1;176;119;201;117;100;713
053640321031;1;103;211;161;94;91;660
036674140520;1;148;164;173;72;152;709
040749722698;1;170;89;229;88;156;732
042519258861;1;252;215;192;84;174;917
067125963860;1;128;91;216;99;77;611
016799641223;1;94;149;263;80;79;665
048518387550;1;238;255;101;59;117;770
038160792382;1;282;161;213;60;119;835
088828657876;1;108;107;248;71;141;675
053988874854;1;209;107;101;66;50;533
026583167363;1;135;116;135;61;172;619
062424815197;1;105;236;279;109;169;898
093960505586;1;152;252;128;93;87;712
086042475700;1;192;237;195;92;96;812
028049312311;1;125;171;134;56;160;646
051560174570;1;91;259;239;72;106;767
044824938627;1;106;99;238;107;132;682
053106846721;1;248;152;177;74;53;704
033895036254;1;233;268;284;70;128;983
029724723535;1;156;150;291;90;89;776
057027624221;1;177;96;269;62;66;670
042337757205;1;215;106;153;76;173;723
085265213610;1;211;157;200;54;57;679
092886710436;1;237;238;253;108;92;928
042429545956;1;251;250;169;78;73;821
049922364733;1;85;92;285;78;162;702
070693796773;1;224;270;221;110;127;952
073296651649;1;117;241;170;61;158;747
074029699871;1;117;181;125;110;146;679
033660098136;1;178;173;248;112;151;862
070241514361;1;263;167;156;90;58;734
018490875581;1;222;84;171;59;168;704
002536340100;1;112;277;286;50;128;853
020857189537;1;99;138;288;56;158;739
042901153111;1;83;269;159;98;176;785
084821409671;1;156;96;186;67;116;621
072408932205;1;276;270;139;91;127;903
074978247085;1;272;216;272;99;100;959
087948740115;1;283;86;180;112;174;835
019504933857;1;93;141;284;63;162;743
009414028046;1;231;219;121;118;159;848
048200203248;1;147;167;238;108;166;826
085198688521;1;184;279;162;79;134;838
063615139778;1;110;116;153;87;112;578
010922715758;1;168;108;170;115;177;738
013655762356;1;292;202;171;80;70;815
048162433146;1;215;137;260;63;106;781
080467377929;1;119;119;273;51;101;663
058092561723;1;258;168;249;91;71;837
092380446786;1;178;134;215;73;74;674
011721012206;1;200;140;178;71;109;698
027677264529;1;220;194;104;92;146;756
092528054029;1;112;98;236;118;51;615
090275154791;1;151;156;141;79;60;587
092422788685;1;156;167;272;69;63;727
082530831358;1;240;263;238;51;127;919
083807044322;1;101;93;117;119;94;524
086552754622;1;248;107;211;64;94;724
019979776396;1;95;285;221;85;102;788
070698796072;1;282;219;226;115;171;1013
024869524208;1;158;127;194;109;117;705
022542184769;1;173;189;270;56;162;850
068399526113;1;275;265;233;109;119;1001
059360249347;1;264;261;286;99;109;1019
024486993316;1;113;271;190;79;151;804
072057640181;1;248;275;287;64;135;1009
008846423921;1;219;283;223;74;158;957
046393122692;1;209;265;180;87;168;909
056120454645;1;277;254;134;102;93;860
044126544741;1;163;196;191;81;153;784
024012447588;1;247;226;112;76;68;729
087611328877;1;276;172;242;65;128;883
041408758323;1;100;267;261;79;58;765
016437807565;1;282;263;173;80;84;882
089352402951;1;173;231;116;120;126;766
030056932291;1;125;201;206;73;138;743
054813651884;1;85;168;269;65;62;649
045735581013;1;139;186;110;64;108;607
036105294445;1;157;262;116;77;59;671
001514963775;1;243;227;260;53;159;942
029013691096;1;195;225;125;62;177;784
072346682893;1;179;223;212;103;143;860
039846504030;1;212;280;272;55;89;908
075618766625;1;289;200;272;71;102;934
095939537770;1;131;116;242;89;146;724
096926656182;1;203;217;179;104;137;840
045730065125;1;98;122;123;61;175;579
021091425616;1;193;107;298;114;87;799
035835545044;1;148;88;192;99;177;704
016405026410;1;281;216;204;67;133;901
013863686929;1;247;182;232;111;141;913
060863822104;1;155;133;296;65;76;725
020216130729;1;249;86;144;66;59;604
014767931744;1;241;80;190;50;122;683
009862772140;1;127;192;237;95;84;735
075462742791;1;256;194;225;66;161;902
020480114235;1;233;286;163;95;51;828
046122272300;1;177;216;167;60;177;797
013159998426;1;102;132;128;83;147;592
047565430894;1;214;165;158;51;61;649
087092744397;1;196;210;293;118;106;923
044448596738;1;152;156;218;93;123;742
077322411492;1;150;107;201;100;87;645
098189682589;1;123;251;159;62;82;677
030112900109;1;201;130;115;108;120;674
053469422272;1;283;160;258;82;70;853
068466574301;1;220;84;220;91;169;784
074602971097;1;243;151;189;69;154;806
009578517389;1;260;138;147;92;85;722
019975798043;1;233;157;113;55;130;688
028608542519;1;238;147;143;93;170;791
052362409761;1;89;115;98;104;118;524
089217245143;1;105;280;155;98;167;805
067518847305;1;125;143;243;57;73;641
017560999822;1;113;286;251;99;154;903
066470777313;1;253;94;211;113;75;746
074056032580;1;154;217;188;55;55;669
038767934796;1;202;232;201;71;137;843
054336324188;1;100;246;201;91;126;764
021350158935;1;189;217;90;92;67;655
044495333350;1;212;253;141;120;147;873
017729250237;1;119;195;189;109;51;663
075780012552;1;97;206;269;69;107;748
098595937584;1;130;189;297;115;140;871
048422825374;1;148;250;296;90;113;897
049996215565;1;286;252;177;94;103;912
037335233304;1;235;118;190;105;134;782
081779494705;1;142;166;107;82;140;637
052798041403;1;165;94;126;95;163;643
002393881163;1;155;153;168;63;96;635
086697781158;1;219;159;164;66;52;660
063287197439;1;241;143;289;70;74;817
026946731790;1;278;196;250;76;132;932
036648424892;1;213;158;243;108;76;798
013737138838;1;284;84;177;111;71;727
065923561449;1;242;234;95;71;161;803
098921044179;1;150;235;136;62;55;638
051078404789;1;176;204;252;57;68;757
094909714963;1;237;267;91;77;166;838
002863559406;1;271;182;259;97;147;956
014479469893;1;143;251;276;82;85;837
038052637647;1;257;267;113;78;97;812
004188469159;1;217;263;183;69;129;861
019750378469;1;198;195;237;69;66;765
084562729082;1;106;281;202;79;54;722
023202444075;1;184;274;192;83;158;891
060992689835;1;261;87;283;50;169;850
060266538307;1;98;252;182;77;116;725
076023363526;1;174;237;125;120;157;813
041732163588;1;87;179;155;90;81;592
002997232386;1;128;281;263;100;120;892
072665401905;1;220;183;100;87;91;681
079524590347;1;185;211;186;95;79;756
054668510229;1;139;159;228;112;60;698
063251636615;1;284;149;243;100;51;827
079583940612;1;96;115;94;55;169;529
060417275917;1;237;118;183;100;54;692
072318482163;1;177;223;147;61;63;671
046177014164;1;213;152;155;111;165;796
018973084870;1;179;151;94;112;174;710
080029748770;1;276;222;242;57;154;951
007386864868;1;133;169;270;80;94;746
044620998244;1;141;184;92;119;157;693
021853473003;1;226;106;287;94;87;800
084226418837;1;291;225;287;101;111;1015
008570377675;1;211;129;164;91;142;737
071259104341;1;142;212;124;83;68;629
050474386719;1;99;127;155;88;54;523
027167082942;1;271;101;238;53;126;789
070570386345;1;150;283;274;51;131;889
074991142230;1;286;205;225;82;80;878
084727051517;1;94;217;103;56;152;622
074882333396;1;228;268;142;110;178;926
031532235360;1;168;282;126;87;62;725
088647379240;1;86;202;249;54;163;754
064143448478;1;190;147;296;66;151;850
035401964996;1;268;250;95;65;89;767
064892003726;1;156;144;131;106;93;630
009811792299;1;88;215;158;53;54;568
067009637302;1;282;177;166;107;160;892
072773159204;1;111;217;249;76;63;716
014210524578;1;208;91;141;85;95;620
053018595442;1;223;159;155;118;113;768
008349809135;1;200;170;168;70;130;738
051537909119;1;266;84;148;54;152;704
072852612693;1;216;207;284;70;74;851
044291369036;1;170;216;229;71;111;797
050272440539;1;92;241;282;52;62;729
080810436649;1;204;158;122;56;143;683
024568893707;1;169;182;251;100;50;752
056901445618;1;103;211;132;83;97;626
035784873215;1;245;218;291;119;164;1037
001361008055;1;260;127;142;106;61;696
059255303776;1;169;95;285;63;175;787
075748829126;1;214;131;186;70;105;706
047132565243;1;112;80;232;99;103;626
032076601528;1;169;218;184;51;105;727
069746316381;1;80;119;219;64;91;573
094769365394;1;141;182;297;116;175;911
074481297161;1;151;287;268;108;123;937
078015006555;1;281;142;156;100;117;796
099651604240;1;185;116;132;66;51;550
050247454745;1;142;242;171;64;119;738
040221450472;1;252;243;299;94;128;1016
007277794591;1;238;158;206;111;135;848
057661414238;1;137;173;170;55;135;670
005824387211;1;204;159;195;95;69;722
088678661806;1;200;282;216;83;160;941
012242561591;1;270;192;106;77;111;756
099478937009;1;234;80;273;108;80;775
041214698790;1;224;261;237;71;58;851
064667093694;1;265;184;279;69;151;948
017145246611;1;109;200;115;81;77;582
066577700059;1;260;113;140;120;128;761
055971319617;1;229;206;263;59;165;922
075745414701;1;111;139;216;54;137;657
099353190832;1;262;218;288;106;131;1005
068656702058;1;283;276;284;115;92;1050
070798292253;1;248;223;221;65;109;866
078055521490;1;264;240;102;77;103;786
087926343116;1;190;226;213;90;161;880
036665511334;1;146;102;156;119;82;605
088250622974;1;253;97;276;61;82;769
050057484359;1;149;252;136;77;148;762
078539759398;1;164;236;165;75;89;729
017241887702;1;284;232;241;103;93;953
037651215225;1;140;209;249;57;145;800
054812371004;1;169;127;175;73;87;631
007382759073;1;145;159;267;58;91;720
032833026132;1;181;90;274;56;87;688
075496735154;1;120;224;212;61;87;704
016736354326;1;275;257;248;98;62;940
002438402720;1;238;177;228;82;63;788
070303753217;1;175;245;224;94;92;830
093298358010;1;198;84;147;98;177;704
056134165647;1;130;140;189;82;55;596
092534777060;1;83;110;272;52;116;633
024222332705;1;247;241;214;64;130;896
030718097248;1;168;230;296;64;176;934
043116578156;1;141;82;243;87;61;614
026073358993;1;231;264;118;84;138;835
073437506022;1;181;87;167;54;128;617
005217906803;1;292;199;196;74;164;925
052553851059;1;286;242;221;60;142;951
076070705531;1;82;94;119;55;147;497
081521217395;1;86;154;246;50;166;702
052320278348;1;130;221;117;85;171;724
049553626896;1;285;130;102;66;110;693
031006712593;1;253;80;154;82;154;723
090292544448;1;188;92;169;67;127;643
048455882330;1;116;134;186;98;68;602
052627019828;1;140;90;176;107;90;603
076028167495;1;94;153;233;94;174;748
024908647618;1;222;117;107;58;106;610
022284491005;1;178;99;111;61;124;573
069028055694;1;117;200;141;102;141;701
063139352064;1;268;259;230;82;78;917
019098057554;1;250;108;225;88;70;741
097229789391;1;161;98;235;68;76;638
005403912585;1;247;226;223;78;97;871
052330502813;1;126;207;165;74;152;724
065416174442;1;116;86;205;55;113;575
062591373420;1;103;156;115;100;153;627
065372154862;1;126;172;217;65;104;684
055237579391;1;216;153;180;117;63;729
063613475828;1;250;183;99;90;151;773
047269489777;1;282;224;224;111;114;955
063437988870;1;147;86;207;60;68;568
049333773005;1;174;279;122;71;100;746
056181727571;1;163;120;157;58;96;594
023726240342;1;271;192;204;118;68;853
021303398825;1;258;164;287;95;96;900
099347704525;1;142;288;207;108;107;852
031062200661;1;171;265;171;108;90;805
091546482599;1;287;92;173;69;156;777
047613530319;1;251;118;266;107;77;819
020217805196;1;173;210;296;74;105;858
076745085088;1;236;251;125;61;143;816
094259565142;1;226;192;258;84;132;892
065254782991;1;289;96;294;119;154;952
024485518542;1;100;201;268;50;78;697
047157793809;1;192;126;205;62;136;721
021511098833;1;274;238;174;88;61;835
049481306137;1;150;133;199;116;93;691
018183170045;1;116;282;221;82;154;855
006885474237;1;112;134;290;62;77;675
052265549962;1;179;276;271;96;106;928
059771803459;1;150;90;139;107;60;546
069442371488;1;288;218;160;59;96;821
058483026658;1;92;101;269;68;127;657
057398486245;1;238;80;157;82;102;659
085547231026;1;198;282;291;101;123;995
079683377604;1;171;164;276;73;69;753
096217683224;1;270;92;197;77;148;784
054178792772;1;144;82;136;98;88;548
050981892203;1;253;129;109;53;163;707
071901770190;1;144;162;279;57;59;701
069170350718;1;188;218;99;99;119;723
021658539240;1;256;226;238;59;151;930
056380835974;1;251;175;257;78;170;931
079838014706;1;236;96;178;62;55;627
000866241069;1;271;189;266;62;57;845
002533681843;1;160;280;161;52;136;789
076036334476;1;223;116;265;60;128;792
072848698405;1;137;264;177;80;95;753
060304223815;1;250;115;137;88;82;672
081833628605;1;229;258;147;79;52;765
030455791818;1;246;108;295;50;158;857
020106535330;1;188;190;199;111;135;823
086626670369;1;201;237;189;59;118;804
004017824611;1;188;121;122;102;91;624
084321613113;1;205;172;118;54;123;672
013228300865;1;204;91;274;80;153;802
016772769052;1;94;179;118;59;78;528
092730147281;1;234;128;97;78;140;677
013976898041;1;187;266;239;110;90;892
012614921588;1;145;136;211;115;159;766
076695326598;1;197;81;103;59;64;504
089609701075;1;217;254;263;84;118;936
054203455883;1;222;226;170;98;79;795
079080137097;1;221;112;135;52;148;668
086139027221;1;91;197;286;103;117;794
019401664912;1;289;252;248;103;173;1065
066605004363;1;160;230;167;67;97;721
034960438767;1;270;114;175;116;58;733
072003539924;1;250;149;108;73;107;687
085835085090;1;292;240;93;87;67;779
085516198985;1;178;260;298;101;171;1008
049175812671;1;89;102;281;54;143;669
048178937287;1;89;199;226;109;113;736
070666795760;1;210;124;103;114;158;709
051119322603;1;185;117;264;106;141;813
026862348509;1;88;245;217;62;131;743
009329607671;1;197;198;108;114;147;764
012957912590;1;123;125;230;105;103;686
036008415322;1;268;254;136;110;129;897
028000187280;1;270;188;160;87;77;782
087592863706;1;120;198;246;50;104;718
009112058630;1;234;82;179;51;61;607
067392502112;1;137;189;156;55;161;698
071612776958;1;250;153;244;89;147;883
055662240115;1;241;267;246;78;134;966
075381179512;1;287;93;254;69;73;776
071807994922;1;104;162;192;105;55;618
021859620225;1;192;281;106;98;102;779
017770550439;1;209;194;235;102;173;913
037841204455;1;94;87;246;80;117;624
000109214402;1;272;247;105;89;173;886
088399804372;1;91;247;238;118;173;867
020242526355;1;111;283;242;107;151;894
059480146582;1;88;279;214;68;171;820
018343079688;1;99;86;277;80;88;630
063033297687;1;240;188;205;105;177;915
088279849765;1;224;131;237;76;146;814
063505845076;1;219;187;170;107;98;781
060706344817;1;85;265;274;71;99;794
027437361039;1;142;198;241;82;96;759
012625183316;1;218;147;233;56;57;711
082472406023;1;91;253;203;69;134;750
047612569327;1;84;151;137;85;155;612
021293806817;1;287;282;189;63;76;897
057629454447;1;231;248;113;76;63;731
031876782963;1;177;172;219;74;61;703
089029566733;1;286;214;256;120;123;999
024345332450;1;149;255;122;112;90;728
058848833671;1;246;185;160;63;105;759
077199397647;1;151;287;257;118;71;884
096028355978;1;253;283;268;72;104;980
021174387655;1;137;125;97;82;175;616
043281366086;1;210;220;93;65;92;680
035251116914;1;184;232;99;118;175;808
032065948612;1;208;188;193;120;109;818
058413214312;1;208;129;206;68;153;764
073445617513;1;205;265;195;110;55;830
084609799421;1;156;217;118;66;93;650
070971532141;1;282;169;297;88;108;944
020885239755;1;235;216;229;73;60;813
047676725450;1;171;91;132;118;157;669
020313746805;1;250;208;167;97;175;897
032294275941;1;169;120;158;71;152;670
028777486243;1;199;173;266;87;139;864
021025437323;1;198;230;146;103;171;848
083559618532;1;127;195;151;68;168;709
077923467939;1;281;178;179;59;125;822
099175136247;1;168;252;289;75;103;887
099377351268;1;243;112;247;62;84;748
061255891364;1;86;141;235;89;60;611
080197962587;1;169;285;151;79;114;798
059065275087;1;213;139;177;73;136;738
050847091959;1;123;274;219;69;55;740
020091505694;1;280;84;160;120;154;798
098591249957;1;91;159;258;59;119;686
041507066326;1;110;104;177;100;116;607
026074453232;1;278;84;213;63;60;698
043734998953;1;226;133;128;59;74;620
088003659775;1;276;90;226;65;91;748
073340812903;1;140;170;265;115;168;858
047128567305;1;171;262;217;87;73;810
054045460842;1;239;236;240;115;114;944
025224741630;1;204;84;282;83;107;760
052764237912;1;233;262;287;100;68;950
085446448670;1;166;112;291;51;105;725
047002022983;1;176;119;202;75;135;707
071958815880;1;170;287;172;85;55;769
062882788319;1;113;135;266;108;151;773
008961596699;1;214;259;218;108;114;913
072654660500;1;129;157;274;84;53;697
082285364169;1;161;221;213;59;167;821
031014655055;1;158;272;286;84;169;969
016810149579;1;270;194;149;58;84;755
094353383720;1;151;190;157;96;102;696
050391237910;1;83;101;203;56;138;581
090430877143;1;177;261;132;60;175;805
070575406286;1;267;197;152;99;99;814
079476912558;1;290;181;135;118;86;810
095510394866;1;266;182;204;59;81;792
007088324923;1;284;225;164;62;50;785
006441894848;1;241;186;248;89;110;874
038130309103;1;108;169;152;111;65;605
082455068486;1;166;134;90;106;67;563
084556072366;1;184;223;263;51;154;875
060080041443;1;228;142;240;71;80;761
076169857905;1;152;173;161;74;163;723
076729246687;1;223;168;300;111;88;890
021540590015;1;136;196;145;95;73;645
061604925876;1;166;217;94;107;64;648
077938548136;1;247;149;245;74;106;821
003364831672;1;104;189;277;102;135;807
089099594800;1;288;210;229;102;133;962
041173765249;1;226;91;128;94;111;650
091302233133;1;206;96;164;74;170;710
034444978725;1;234;92;167;66;121;680
018995215666;1;159;157;258;112;155;841
008388106150;1;112;168;117;70;148;615
029144229977;1;261;239;236;50;145;931
084538535529;1;280;252;251;70;137;990
041941591492;1;255;236;96;66;143;796
011511609153;1;129;142;131;68;142;612
045929807615;1;280;210;160;50;98;798
059129724608;1;266;195;181;52;89;783
052968644348;1;266;170;215;75;127;853
066835637688;1;253;115;162;113;131;774
007774866897;1;107;113;269;69;79;637
028996858162;1;209;192;264;62;166;893
041013221282;1;100;282;260;52;147;841
053973927526;1;265;121;95;84;133;698
091652278834;1;88;273;189;96;74;720
096386063573;1;285;260;228;116;70;959
057549349010;1;112;248;298;54;174;886
097407799518;1;213;97;280;68;98;756
072326507036;1;292;285;174;75;59;885
015045761540;1;156;97;181;106;114;654
006983246686;1;158;115;284;59;114;730
077525312209;1;207;235;280;75;178;975
099052335419;1;263;85;254;71;51;724
057518576220;1;227;259;290;71;54;901
059457388779;1;252;279;151;85;111;878
053326728328;1;248;257;138;52;90;785
032630418352;1;253;240;154;83;104;834
011113813785;1;267;155;164;91;97;774
030378834670;1;96;81;200;58;131;566
049601802179;1;260;189;300;59;105;913
024854430827;1;129;99;151;73;159;611
026043113595;1;155;131;253;94;88;721
052322475412;1;131;207;274;89;151;852
084881788990;1;223;97;146;105;94;665
023187528196;1;261;130;256;104;99;850
034090811681;1;205;261;253;56;144;919
056961064258;1;162;248;92;53;82;637
092695770737;1;86;92;150;114;169;611
067227734292;1;271;110;297;52;142;872
089862749728;1;281;87;245;70;111;794
083098892502;1;123;183;289;68;82;745
097363699866;1;154;189;229;61;120;753
069997509433;1;186;214;138;55;149;742
068537796598;1;202;190;121;65;105;683
021391471458;1;196;285;210;96;62;849
099693993707;1;206;92;215;61;150;724
083779088580;1;175;272;164;104;107;822
049170789888;1;100;85;167;87;148;587
080952115218;1;256;145;270;84;171;926
052790332247;1;181;115;226;71;97;690
023054833938;1;273;92;225;59;175;824
002477358792;1;231;210;255;120;128;944
026554545398;1;243;144;262;52;90;791
087275072097;1;147;96;267;116;87;713
048665880566;1;106;109;263;54;66;598
038909726743;1;98;122;218;55;177;670
099017054917;1;291;264;190;75;105;925
006605366259;1;92;241;159;102;78;672
062455106858;1;108;256;257;85;103;809
080141803373;1;173;95;285;119;56;728
069247395111;1;201;110;193;117;174;795
041003617665;1;90;97;102;93;129;511
054092221814;1;161;129;108;59;69;526
054809052171;1;84;211;127;75;76;573
014491814902;1;92;81;173;78;64;488
001896460551;1;227;133;164;71;64;659
005850095819;1;286;173;283;50;108;900
099016371900;1;262;280;169;78;148;937
032729682869;1;218;84;147;117;135;701
068209355866;1;153;171;272;118;177;891
054270764977;1;140;283;258;69;163;913
017588847251;1;133;106;197;53;98;587
010947657224;1;251;217;90;83;74;715
034547325381;1;100;175;182;74;147;678
022524572438;1;279;262;106;55;93;795
020811736891;1;239;105;224;88;81;737
023501860669;1;156;130;164;57;150;657
047316042313;1;95;161;229;99;57;641
031368156367;1;253;103;234;67;105;762
061326560244;1;197;86;279;101;100;763
002988503225;1;258;287;156;66;167;934
084493456123;1;130;197;151;102;68;648
007169175207;1;246;180;95;105;162;788
020589803969;1;119;192;107;55;170;643
093917317439;1;94;255;222;109;59;739
064228041698;1;270;227;112;111;68;788
053255945224;1;88;209;179;52;103;631
078119190150;1;200;141;121;113;98;673
027873247391;1;110;88;209;115;81;603
067776239143;1;292;214;201;57;176;940
085009441402;1;226;288;283;102;115;1014
081737459708;1;147;138;122;75;79;561
056939147855;1;175;94;298;54;73;694
037516925266;1;162;240;177;59;155;793
061088004239;1;207;247;162;109;99;824
044245507252;1;270;181;269;83;146;949
095314327779;1;241;171;156;117;115;800
033612299385;1;227;112;223;55;104;721
016328361407;1;145;221;278;102;110;856
090549949401;1;134;167;196;102;155;754
001641623887;1;86;94;107;54;93;434
074490486705;1;246;116;129;98;163;752
088506475673;1;130;134;123;83;152;622
064205208512;1;228;142;156;108;102;736
088000087736;1;208;210;159;67;135;779
075186240880;1;233;213;147;68;157;818
001751814579;1;131;183;256;51;89;710
054545223792;1;284;96;290;51;62;783
024291826274;1;176;280;122;68;63;709
035531472898;1;202;224;131;97;174;828
086489322384;1;109;130;148;56;63;506
090342021771;1;120;161;91;58;75;505
044512728996;1;222;89;102;110;119;642
033901452107;1;204;186;258;102;110;860
013299995340;1;91;261;296;110;127;885
035977173379;1;157;217;262;89;105;830
060533601116;1;235;241;284;117;76;953
033242494746;1;286;249;262;89;98;984
069332935225;1;262;208;122;88;164;844
091596311046;1;204;288;124;109;101;826
052535134142;1;162;217;131;84;62;656
086976163829;1;222;218;96;92;68;696
005814631557;1;233;250;128;72;91;774
070702260761;1;156;144;231;60;140;731
080192924311;1;165;176;103;55;114;613
031057853517;1;166;202;273;88;107;836
027584519368;1;217;113;122;107;167;726
021746967316;1;240;192;249;56;98;835
010893394081;1;187;277;151;88;89;792
076550977695;1;101;226;210;92;76;705
062512141169;1;241;122;281;56;131;831
062185605166;1;263;218;211;51;111;854
034275395769;1;123;139;293;71;85;711
056484625454;1;267;103;220;107;58;755
073107032881;1;148;220;163;54;68;653
006636246046;1;156;124;143;102;122;647
024686324319;1;181;184;293;82;153;893
036751422481;1;260;94;180;62;142;738
022238519102;1;252;255;96;71;148;822
090080164137;1;94;125;120;94;65;498
061013114528;1;257;91;204;112;124;788
046615614994;1;240;194;228;50;52;764
065926279551;1;208;241;211;52;147;859
082771024990;1;265;209;168;51;53;746
090249179182;1;158;166;254;63;156;797
057329366198;1;253;259;113;101;173;899
088448126444;1;93;105;212;72;84;566
031580839583;1;94;279;241;82;130;826
026425121446;1;275;141;269;112;166;963
025894202075;1;191;188;212;101;110;802
051163361743;1;138;163;280;96;131;808
085195468195;1;203;180;158;100;128;769
005619894139;1;213;197;117;104;90;721
076657809870;1;176;254;134;83;57;704
038713711410;1;131;186;268;53;76;714
021704673850;1;253;254;162;55;117;841
086219037089;1;217;151;162;120;102;752
041189728360;1;265;90;106;76;96;633
077590711112;1;283;134;208;85;135;845
062642243347;1;278;80;260;96;77;791
047348791364;1;137;272;161;108;109;787
091516593430;1;91;108;284;99;91;673
064746154623;1;158;218;212;87;115;790
023739360854;1;207;202;269;105;93;876
073339894498;1;172;89;94;109;54;518
090100648205;1;128;115;182;62;89;576
009887895020;1;259;151;109;113;103;735
032547009514;1;258;248;299;111;157;1073
088255179839;1;204;105;145;107;137;698
078206446798;1;259;225;153;115;86;838
002841801418;1;274;148;199;97;121;839
093244778613;1;106;106;112;112;101;537
075068203995;1;110;240;261;113;84;808
010510825354;1;264;202;202;67;95;830
083182482407;1;221;179;135;50;136;721
025364541647;1;286;165;193;98;161;903
089629798335;1;81;104;205;57;166;613
096523593651;1;268;202;290;95;83;938
067417707767;1;268;243;128;71;134;844
018595060160;1;183;249;141;106;109;788
003867556982;1;221;145;294;80;112;852
009572605469;1;197;136;129;86;75;623
058462479355;1;243;228;238;77;55;841
001107475063;1;243;228;272;114;122;979
000384541858;1;181;114;115;59;171;640
047699617911;1;169;211;143;98;67;688
098268174702;1;281;102;118;51;165;717
065183067000;1;197;140;166;67;173;743
007239223454;1;199;238;199;67;86;789
027921875027;1;171;279;270;118;137;975
038825510113;1;131;150;188;106;93;668
069076529296;1;284;114;257;68;92;815
072703525382;1;225;215;167;64;131;802
067604871437;1;113;113;108;62;140;536
046479774245;1;281;222;139;119;143;904
078358171809;1;273;283;218;106;54;934
091934223750;1;273;197;285;95;54;904
028016562488;1;255;270;109;53;150;837
054148218782;1;185;267;184;77;155;868
089191300016;1;110;165;212;68;137;692
032699395660;1;245;154;157;53;156;765
066632356255;1;243;259;233;53;78;866
070699149310;1;240;106;191;92;56;685
042364790009;1;251;138;127;105;84;705
014541655321;1;208;279;146;105;159;897
009416995974;1;98;275;245;116;149;883
011863890231;1;172;149;175;92;173;761
002863579523;1;193;284;262;88;108;935
033748379314;1;118;216;213;117;159;823
093932950872;1;123;91;154;76;140;584
004554031046;1;98;84;288;96;62;628
003369077646;1;229;210;171;88;87;785
082860953278;1;214;278;180;89;82;843
044374901461;1;174;238;195;56;153;816
015368641082;1;115;175;243;108;57;698
099967854486;1;105;259;230;84;67;745
067441568166;1;210;272;198;118;53;851
057480770929;1;213;131;257;99;92;792
053758620055;1;153;253;288;103;91;888
083517516298;1;201;123;153;87;149;713
057607115348;1;133;192;150;110;53;638
005220999229;1;270;189;208;64;178;909
054572170432;1;165;146;241;65;157;774
047996241924;1;210;248;258;56;126;898
024960329693;1;220;107;167;85;70;649
064889340621;1;113;86;146;85;151;581
004419558390;1;174;228;130;69;82;683
015475012429;1;88;178;138;88;132;624
084576143409;1;82;123;270;104;83;662
070923268353;1;261;88;93;118;102;662
090659050828;1;263;180;198;115;147;903
050582987531;1;269;88;268;66;66;757
040044082348;1;184;135;236;52;147;754
070470610209;1;208;120;269;105;169;871
041678695101;1;147;107;139;77;60;530
039643546154;1;152;114;233;77;174;750
057041988781;1;245;181;137;114;69;746
034223528563;1;279;166;150;93;94;782
060674713766;1;106;202;249;67;77;701
061381073920;1;191;228;146;109;65;739
084769946269;1;161;112;272;74;156;775
027968661629;1;142;135;135;51;78;541
001699754736;1;119;242;211;87;161;820
018118338967;1;275;162;290;84;120;931
032524945421;1;223;88;211;58;55;635
010718444862;1;292;260;226;114;169;1061
072849683967;1;97;240;199;85;164;785
088661339624;1;271;231;270;86;89;947
089511457834;1;266;198;160;78;88;790
014080559051;1;105;123;116;58;96;498
087187540296;1;170;265;238;76;74;823
001900761031;1;181;192;272;53;63;761
060488695227;1;263;174;142;87;152;818
003520091475;1;118;85;130;73;137;543
027562066269;1;190;140;95;60;107;592
046563177988;1;264;273;107;97;130;871
037676326352;1;171;273;148;70;159;821
051464623092;1;288;177;177;103;101;846
038174383555;1;116;205;105;92;91;609
067569390395;1;192;107;171;50;83;603
058709408151;1;216;204;265;84;150;919
044086948720;1;176;272;92;91;82;713
014314827757;1;174;217;172;120;75;758
047439006716;1;229;130;145;65;121;690
006534726175;1;274;132;154;80;80;720
061348089673;1;267;105;217;105;87;781
002367892007;1;173;197;91;62;81;604
039637979520;1;192;267;201;60;108;828
003507621300;1;168;134;111;51;146;610
016983525279;1;141;248;200;73;136;798
074433971424;1;188;111;135;113;80;627
063145620588;1;137;187;94;58;122;598
008356092703;1;112;135;130;103;152;632
092711205928;1;279;185;287;100;177;1028
056703375632;1;210;152;190;54;147;753
042195181367;1;239;189;186;91;175;880
086209958673;1;120;147;157;101;57;582
047488388197;1;245;234;224;100;119;922
031222657255;1;247;117;270;99;129;862
095784343140;1;213;260;139;78;136;826
043758579934;1;284;103;266;71;84;808
081637329376;1;176;190;106;116;78;666
045271408050;1;133;196;257;66;111;763
049593138704;1;121;128;145;99;82;575
072302264943;1;146;242;249;62;89;788
091419809654;1;85;108;158;117;66;534
060276607467;1;252;219;245;70;173;959
040123808700;1;93;199;182;115;66;655
023284105082;1;238;182;185;66;118;789
072506982972;1;268;134;277;114;55;848
033878311325;1;279;161;109;62;70;681
013780025873;1;103;84;296;84;61;628
059155475520;1;158;174;243;79;85;739
063004957378;1;164;238;236;52;136;826
039853093218;1;101;281;170;117;123;792
064875535972;1;269;130;155;85;132;771
006776962813;1;276;196;275;113;178;1038
023618411344;1;125;285;262;59;81;812
046448791364;1;117;109;155;78;74;533
023170252181;1;178;245;218;54;60;755
061139831262;1;170;232;128;86;137;753
075787507611;1;214;136;297;101;94;842
026543529991;1;250;286;98;93;131;858
014745780662;1;170;170;296;77;142;855
023366198219;1;185;146;225;116;67;739
086415246688;1;169;255;258;83;140;905
027209296517;1;287;159;132;52;90;720
070304702476;1;157;273;272;106;139;947
062703619289;1;152;90;291;59;167;759
054406067967;1;95;282;117;73;134;701
055401753055;1;90;171;260;70;94;685
092708654512;1;158;113;208;72;176;727
058315193136;1;250;218;266;71;80;885
073768678099;1;248;117;275;107;149;896
016845392320;1;193;209;299;101;167;969
055385879312;1;292;276;116;104;139;927
075022292063;1;172;169;191;52;119;703
071395727614;1;116;126;226;100;74;642
018689616492;1;101;171;276;52;105;705
070528104833;1;109;163;232;110;59;673
044148691563;1;254;136;295;79;55;819
012302192510;1;139;229;135;74;64;641
070420158755;1;108;193;234;85;62;682
083497896923;1;163;250;127;105;143;788
077996683474;1;241;203;112;75;84;715
092903994510;1;165;203;181;71;110;730
067924240260;1;200;144;221;118;139;822
079899169149;1;276;219;192;114;126;927
032512253254;1;144;258;236;83;78;799
018499037152;1;272;119;248;51;88;778
079398812442;1;136;174;131;54;172;667
011587486539;1;183;219;239;117;113;871
020621909719;1;229;94;278;94;160;855
058302759141;1;147;110;244;103;89;693
006202290277;1;165;278;112;67;90;712
040711294822;1;88;211;254;58;78;689
017961975689;1;185;151;221;82;166;805
080553723228;1;259;95;206;113;138;811
066764851222;1;248;263;113;83;157;864
028216415824;1;128;178;213;99;176;794
034526382402;1;145;276;192;105;111;829
056751990603;1;289;191;252;114;177;1023
099768396438;1;119;121;101;71;125;537
097392014987;1;160;190;221;119;65;755
042655792572;1;215;273;149;50;129;816
002618503463;1;261;264;243;111;127;1006
072756438600;1;222;251;180;107;58;818
045771291147;1;107;230;92;68;159;656
003951231616;1;117;266;189;113;148;833
028868750714;1;134;257;133;55;69;648
041233705765;1;137;87;279;110;152;765
065761944811;1;212;101;209;97;125;744
005048184672;1;80;147;207;85;161;680
041921479721;1;158;184;216;107;105;770
006556452624;1;130;104;183;50;178;645
004102367009;1;151;267;129;119;112;778
069571187587;1;86;165;227;82;88;648
037705533168;1;139;272;245;74;67;797
004779402682;1;247;223;236;65;117;888
098151152542;1;197;199;112;106;84;698
044372715376;1;158;166;266;51;66;707
097987582447;1;136;192;150;88;157;723
063439708169;1;137;185;139;106;50;617
096418317669;1;251;276;217;116;135;995
085992858029;1;94;114;125;83;87;503
093946276271;1;172;160;293;93;64;782
056215420271;1;133;90;158;98;50;529
079476715866;1;289;237;124;71;83;804
057220982384;1;212;208;275;80;148;923
087574857477;1;105;218;128;86;122;659
006742867780;1;258;91;112;67;149;677
098469311595;1;105;275;240;106;72;798
058210586073;1;269;184;260;110;108;931
062268018161;1;149;255;269;85;116;874
098725555234;1;203;132;107;108;134;684
041746343263;1;181;267;115;111;72;746
016123672071;1;266;164;110;84;157;781
075707974901;1;134;285;103;84;94;700
005249960755;1;292;172;138;99;162;863
019432937368;1;153;106;257;113;139;768
041112133476;1;103;257;271;77;81;789
034990146680;1;229;157;276;50;55;767
058050052112;1;259;158;250;74;157;898
031504034472;1;109;274;131;90;131;735
062400133184;1;110;135;97;120;64;526
020775642531;1;252;148;258;87;68;813
035332159437;1;153;107;207;50;78;595
060938402146;1;146;254;225;108;153;886
006170472201;1;147;168;187;94;66;662
080068832709;1;282;104;220;74;101;781
082956241633;1;84;180;264;99;135;762
014748387567;1;180;273;207;84;138;882
094739562319;1;236;134;221;69;80;740
033413618422;1;197;133;127;105;132;694
093337922856;1;94;207;238;58;174;771
033611941750;1;82;117;298;106;150;753
065221940762;1;124;220;227;57;124;752
045152210526;1;162;188;202;56;91;699
063596199272;1;208;174;103;81;133;699
052443524720;1;223;264;214;86;139;926
094104316285;1;176;274;271;80;110;911
084270977044;1;117;207;202;86;85;697
071498596645;1;272;94;154;89;152;761
077188614713;1;93;177;299;84;173;826
000938835788;1;230;168;190;85;119;792
061382376429;1;84;190;250;87;127;738
056250099815;1;86;182;264;114;143;789
009998701847;1;225;125;280;97;97;824
036539344742;1;165;226;192;103;119;805
073063117660;1;112;198;213;61;65;649
034005146878;1;197;148;295;53;99;792
015023842314;1;236;101;238;114;135;824
074996536553;1;250;238;284;90;134;996
048201416850;1;104;131;157;79;108;579
079375046793;1;144;167;222;66;87;686
022474273770;1;87;189;93;112;64;545
011051591045;1;255;193;294;109;156;1007
026789769062;1;235;269;147;61;121;833
037514503989;1;229;144;190;119;98;780
017405139613;1;128;106;271;67;114;686
035279724004;1;128;122;251;97;152;750
060025581800;1;164;234;230;95;155;878
029529128096;1;155;204;238;106;123;826
058912099500;1;224;121;129;98;157;729
015654067902;1;180;245;270;67;111;873
012329114002;1;156;136;261;89;173;815
055795833556;1;170;228;216;91;172;877
080311564364;1;271;232;156;76;157;892
015024537693;1;218;150;222;86;63;739
038124539152;1;87;142;141;54;149;573
065135390670;1;280;149;238;59;95;821
062369496769;1;277;246;123;55;166;867
067393751068;1;290;232;274;109;139;1044
012374175757;1;212;271;104;104;161;852
067746078544;1;88;283;201;97;119;788
098343875821;1;247;165;119;99;119;749
008147928401;1;180;241;261;91;141;914
096194005499;1;189;163;214;74;166;806
094257719725;1;172;143;132;85;136;668
018808415621;1;98;204;216;55;164;737
084173840269;1;216;212;259;75;103;865
067355291171;1;88;102;113;77;138;518
022294042801;1;248;262;198;113;63;884
068849166035;1;130;102;100;57;155;544
049829035571;1;270;102;266;72;141;851
036082435687;1;176;89;298;53;166;782
053796557886;1;98;254;189;65;107;713
029845454039;1;85;251;202;87;152;777
013406285565;1;235;288;147;106;53;829
040969054618;1;242;271;187;95;117;912
070873184080;1;282;187;200;54;122;845
007947314003;1;237;286;119;64;128;834
035879106046;1;195;119;105;70;86;575
054220541739;1;197;207;267;104;79;854
093150446522;1;172;106;108;72;98;556
085844988656;1;202;189;94;71;73;629
099791605119;1;135;230;99;88;162;714
009181489757;1;131;127;148;116;118;640
032834617145;1;245;218;269;55;77;864
069959058297;1;284;262;262;59;63;930
083770210446;1;251;87;205;57;140;740
086354513933;1;185;239;206;72;72;774
034987571812;1;90;120;265;70;58;603
060681754058;1;251;177;108;86;74;696
060610678645;1;284;177;273;101;150;985
086475059017;1;195;162;250;51;86;744
050599544639;1;234;259;101;107;100;801
039222519312;1;182;166;192;106;95;741
031231800007;1;235;116;99;81;96;627
009062143729;1;197;114;199;82;69;661
056247948760;1;91;115;252;90;143;691
041855328366;1;113;209;139;68;70;599
048673152663;1;177;276;133;108;122;816
031279466784;1;225;168;248;55;123;819
090806677804;1;135;234;149;104;108;730
076010639677;1;149;102;255;117;56;679
058082754258;1;212;96;224;59;118;709
076076444084;1;190;130;274;90;94;778
055148848279;1;98;275;142;85;115;715
079246432755;1;191;249;256;112;137;945
072475588009;1;271;147;114;79;118;729
058244355716;1;173;276;191;113;71;824
025753207185;1;230;285;292;77;98;982
029134572715;1;142;281;148;111;129;811
058958220780;1;246;268;114;63;69;760
079765120481;1;191;243;176;114;108;832
066131185070;1;221;91;168;88;66;634
045308956282;1;124;108;91;109;96;528
011407578141;1;288;121;269;99;69;846
082244935514;1;219;221;234;111;126;911
040081339774;1;249;251;196;62;78;836
086608667843;1;271;107;136;77;92;683
018842680433;1;272;229;147;120;64;832
020038853267;1;262;286;172;53;108;881
079751784138;1;176;213;142;78;94;703
067433578213;1;284;261;215;94;150;1004
027105528562;1;191;256;195;90;59;791
020307096064;1;217;128;282;54;135;816
002360284922;1;102;231;111;67;121;632
079490332297;1;249;172;110;63;98;692
021971227315;1;108;178;200;75;78;639
040614395421;1;243;120;90;90;106;649
062740288273;1;85;193;268;120;65;731
085198081225;1;198;234;125;103;136;796
027307403053;1;258;239;221;59;66;843
080805602408;1;98;251;264;69;53;735
096021237855;1;282;172;165;58;97;774
047404057295;1;191;119;231;83;113;737
018990501398;1;105;107;240;100;61;613
088737552622;1;262;201;271;69;72;875
055685984108;1;181;82;96;103;92;554
012423042186;1;164;119;162;95;56;596
096577793073;1;168;239;249;101;77;834
034637080564;1;103;148;277;80;154;762
098135763750;1;211;288;161;58;63;781
017923467783;1;81;286;192;100;55;714
084048618956;1;85;255;286;115;170;911
066103716309;1;87;228;226;80;121;742
033458810443;1;100;240;244;94;128;806
000313324506;1;166;185;276;88;63;778
056567107941;1;254;269;201;110;166;1000
013707863576;1;174;236;111;61;82;664
067788357618;1;169;92;112;98;177;648
075933912374;1;104;106;297;66;58;631
035289957832;1;171;188;157;108;144;768
080133348352;1;132;164;133;77;64;570
096849733102;1;150;161;133;68;105;617
019854661040;1;165;174;128;110;63;640
011382024794;1;262;117;222;77;140;818
080432872981;1;164;130;233;101;174;802
092580472373;1;259;287;144;114;76;880
064281789029;1;137;197;216;85;92;727
003482787152;1;271;257;123;107;85;843
035332984449;1;217;172;296;58;114;857
014655459705;1;128;163;155;105;136;687
073374785383;1;244;262;167;96;129;898
017950557757;1;210;240;278;87;64;879
015939800832;1;172;178;278;93;126;847
030892514215;1;199;248;277;61;64;849
057033133479;1;181;283;227;105;120;916
082069434322;1;114;249;164;113;69;709
095294430162;1;185;232;109;74;126;726
059697325962;1;95;101;163;120;116;595
099903086787;1;150;254;179;90;68;741
028083687277;1;183;92;297;55;173;800
077437049676;1;196;91;157;85;117;646
046682035308;1;216;132;133;90;110;681
006513862643;1;207;127;242;58;161;795
058233834306;1;102;108;287;117;98;712
060314337140;1;140;172;220;53;50;635
046528451491;1;87;177;194;53;173;684
003910472324;1;174;177;172;113;121;757
059699480111;1;152;137;169;115;50;623
083152837457;1;99;184;157;50;138;628
091556953323;1;140;222;296;97;120;875
036152143969;1;224;223;190;57;135;829
086811686080;1;165;192;240;94;81;772
055274014347;1;184;232;126;117;91;750
052206727045;1;226;150;110;90;121;697
086617769207;1;258;169;258;113;145;943
083290046554;1;212;274;107;79;132;804
049212597178;1;271;284;248;86;152;1041
037969153817;1;162;172;300;54;80;768
040322446409;1;229;206;117;59;125;736
007387586807;1;166;228;143;79;55;671
034533521816;1;214;126;180;69;72;661
088317088543;1;251;210;136;70;95;762
086518106494;1;148;92;154;76;66;536
011145415150;1;171;157;216;115;136;795
096028619668;1;228;256;125;111;98;818
089239732026;1;206;253;276;90;52;877
083465522595;1;88;137;278;58;158;719
060258830290;1;125;169;188;86;73;641
067206815927;1;187;250;240;70;150;897
060254226556;1;248;91;240;82;73;734
014159433491;1;125;182;223;118;96;744
093110396484;1;82;164;128;82;152;608
072196019341;1;106;151;251;108;163;779
023728210326;1;157;164;123;62;141;647
028954836380;1;252;278;200;65;128;923
000340117473;1;206;252;253;105;56;872
006375121200;1;207;111;272;116;105;811
046382580011;1;128;168;193;74;150;713
077966224937;1;226;89;274;72;151;812
010952669521;1;105;257;297;101;55;815
031736628066;1;282;218;271;54;94;919
097834300471;1;127;281;165;65;96;734
010578584260;1;269;132;277;77;167;922
071557325665;1;241;96;191;88;132;748
007407167711;1;120;86;135;98;165;604
018079217942;1;161;229;146;59;142;737
080979485996;1;260;272;219;67;115;933
090167645610;1;242;246;252;61;118;919
083872039178;1;123;151;242;92;162;770
073198992030;1;169;111;166;98;164;708
091465182361;1;257;226;168;104;104;859
088602530511;1;98;223;253;107;121;802
005266516033;1;191;183;102;113;171;760
096497567785;1;148;221;99;66;134;668
035147301399;1;90;81;213;67;81;532
025455219177;1;188;229;246;57;138;858
028993187220;1;198;151;117;99;114;679
065361876845;1;108;146;207;93;88;642
038291279553;1;220;266;186;95;102;869
080520290101;1;270;230;278;98;70;946
024936838300;1;188;135;101;110;101;635
002550819730;1;242;167;131;119;174;833
011012919326;1;154;245;129;86;68;682
077711933776;1;186;227;118;74;79;684
033307923611;1;90;94;208;76;50;518
060530470543;1;106;214;162;112;80;674
066293668096;1;130;246;190;81;114;761
070583363110;1;260;100;294;99;110;863
043569602990;1;98;243;185;104;156;786
038770130354;1;105;253;168;100;144;770
083803679918;1;246;203;266;119;152;986
008898274520;1;158;204;204;101;150;817
084511381973;1;220;187;194;74;151;826
050177049163;1;135;105;165;71;90;566
013310874992;1;270;272;225;118;64;949
071160077066;1;183;253;164;56;55;711
069291159081;1;241;211;270;102;96;920
035162817557;1;109;173;262;98;121;763
062665595111;1;120;87;184;110;160;661
074202908064;1;247;220;167;60;157;851
019213546492;1;232;162;185;119;157;855
070401014330;1;88;188;140;61;177;654
011604662700;1;273;111;283;86;69;822
003361764484;1;239;271;93;70;80;753
062186217804;1;127;261;263;88;100;839
020226414659;1;265;103;140;74;71;653
081533328747;1;156;160;262;72;52;702
064240725633;1;107;87;205;62;140;601
054381342918;1;245;212;211;55;176;899
068470788239;1;188;204;125;82;166;765
054085890787;1;81;217;142;62;52;554
041169028364;1;184;239;190;74;119;806
074181462584;1;218;269;267;106;54;914
059281160014;1;234;224;206;73;115;852
094848004067;1;277;206;226;100;154;963
006636189957;1;97;158;246;90;167;758
003543736836;1;280;120;195;105;71;771
098611827114;1;287;207;104;93;76;767
080436085326;1;277;209;91;55;75;707
034471330962;1;139;142;114;99;98;592
096249808734;1;100;120;146;59;140;565
056109700591;1;102;178;181;65;78;604
070516676452;1;247;114;235;103;158;857
092220343576;1;215;113;208;58;73;667
015511302621;1;121;250;263;99;164;897
030584181761;1;166;95;131;98;124;614
032027251412;1;129;217;101;84;101;632
055957079614;1;200;140;278;96;119;833
047031069855;1;237;102;182;102;98;721
013736854445;1;203;196;152;62;166;779
062843129555;1;108;96;114;72;142;532
000454562093;1;264;191;228;89;155;927
012397087553;1;179;128;192;106;96;701
059724607093;1;190;245;93;113;103;744
052335416798;1;186;164;111;77;60;598
079192788678;1;122;135;106;68;85;516
053610846793;1;156;261;251;75;154;897
020422337244;1;174;90;138;84;134;620
092772951207;1;204;171;125;56;138;694
046223602631;1;220;146;229;51;97;743
029925121749;1;116;124;97;77;136;550
038574250653;1;165;82;244;97;159;747
067860580363;1;273;82;179;74;61;669
038983473653;1;259;132;190;66;161;808
036369086603;1;156;271;236;78;117;858
072334297256;1;179;110;237;109;86;721
077270547967;1;205;168;147;52;108;680
072360407241;1;83;150;124;100;75;532
058826280922;1;114;266;219;63;58;720
025969244205;1;287;189;269;108;93;946
003403582299;1;245;198;242;93;118;896
000621803387;1;165;118;239;75;112;709
005435943882;1;277;146;283;118;115;939
092761925124;1;97;88;99;96;104;484
063414865534;1;203;221;291;106;164;985
068809611150;1;222;100;290;84;113;809
014701526007;1;203;173;117;100;143;736
094840653054;1;232;281;275;109;61;958
093246157674;1;209;229;282;92;61;873
091679524790;1;245;217;239;102;173;976
066389473119;1;256;95;203;74;63;691
078102095989;1;118;141;286;107;113;765
074027822497;1;184;162;100;97;125;668
099549859635;1;100;251;267;54;162;834
029883920084;1;90;218;265;113;92;778
068010236238;1;132;83;270;50;128;663
091445932023;1;187;118;190;92;132;719
049128989112;1;246;174;170;92;59;741
054451068115;1;273;168;161;111;78;791
054415543895;1;280;154;269;57;165;925
053588683052;1;103;256;121;67;115;662
019877338595;1;188;111;279;84;156;818
098427994409;1;110;283;239;85;119;836
057754188233;1;264;234;163;71;65;797
098639417457;1;210;130;145;62;61;608
064796620048;1;165;103;135;62;100;565
092943977174;1;84;176;134;69;132;595
056681008212;1;219;199;261;105;50;834
099905085382;1;202;272;213;55;121;863
009384882139;1;154;91;165;62;89;561
062440567083;1;138;174;161;97;104;674
037492972470;1;90;86;297;55;119;647
003119578314;1;213;144;110;87;120;674
077425838052;1;207;127;299;118;63;814
023647895956;1;236;113;236;66;119;770
015890394928;1;177;172;148;53;158;708
029496839333;1;204;189;139;118;150;800
012776441934;1;285;159;167;113;157;881
033192948024;1;212;80;155;84;166;697
016972980857;1;291;85;207;57;168;808
080041161558;1;118;138;150;72;71;549
070642178432;1;258;152;271;70;126;877
034505879259;1;139;197;136;90;50;612
092054585700;1;192;167;107;117;131;714
050611685973;1;121;255;134;62;114;686
061989877669;1;138;223;218;96;67;742
044857231071;1;110;140;140;85;102;577
053071920331;1;257;212;289;88;67;913
030531447523;1;226;206;137;110;121;800
078022262031;1;251;282;136;58;167;894
020185774622;1;114;241;246;110;106;817
077791595176;1;218;135;236;57;92;738
085698007636;1;200;115;121;50;64;550
051230899298;1;138;211;123;82;122;676
014408870843;1;94;219;298;103;55;769
024393116091;1;113;153;245;61;141;713
057230748455;1;127;122;269;109;93;720
088822055821;1;262;219;141;61;74;757
068199656131;1;111;134;208;64;169;686
050109907262;1;130;129;148;70;167;644
038057226810;1;89;110;179;54;113;545
097064036558;1;253;160;126;114;159;812
026031188409;1;102;159;108;67;105;541
063548044611;1;95;93;222;73;143;626
021163525568;1;284;194;263;114;103;958
080646342117;1;172;260;222;51;69;774
053892250502;1;110;228;152;119;70;679
017310868559;1;141;162;239;98;117;757
075538731711;1;263;285;92;100;65;805
049330974954;1;244;284;163;68;154;913
017943614471;1;98;120;245;86;87;636
030280774221;1;91;283;90;99;106;669
028410136106;1;257;170;189;68;120;804
011203555814;1;277;237;239;92;127;972
031678638097;1;139;108;205;74;126;652
041630424250;1;234;225;121;63;52;695
079236162154;1;134;121;189;65;80;589
010456378610;1;231;169;165;86;72;723
048319779230;1;164;280;278;120;100;942
070667961203;1;285;150;277;98;110;920
064086212886;1;208;86;210;72;158;734
099343646282;1;161;229;214;52;134;790
079695893565;1;175;263;191;119;93;841
012319360229;1;249;158;153;75;71;706
041189972608;1;122;102;205;59;117;605
095071970684;1;168;276;230;95;61;830
037844893481;1;241;215;279;97;100;932
022328343805;1;82;239;189;69;72;651
063253788042;1;122;281;96;65;96;660
078575531867;1;228;252;133;75;156;844
002117350495;1;287;152;179;97;72;787
077796316346;1;269;280;153;117;105;924
094493714718;1;126;94;235;114;83;652
071912935019;1;173;281;129;55;175;813
097776864924;1;128;150;144;111;140;673
073921239426;1;261;101;258;95;165;880
031632547323;1;264;200;109;68;90;731
066156947199;1;108;218;145;57;61;589
026515732981;1;240;275;262;57;160;994
061958030233;1;266;196;230;105;76;873
050361948543;1;125;218;257;69;58;727
073047615919;1;109;209;150;66;98;632
077579872071;1;230;177;243;95;106;851
057537788443;1;283;244;199;56;59;841
091711580305;1;229;192;206;75;171;873
031005601680;1;266;140;181;60;157;804
005906420381;1;80;284;250;85;80;779
018485120807;1;258;281;259;62;114;974
009356233423;1;215;205;208;81;109;818
038109244317;1;193;92;259;51;62;657
092407939574;1;273;177;203;104;105;862
003897049161;1;201;198;132;112;83;726
049283137222;1;144;218;291;89;157;899
016304932027;1;214;204;129;81;172;800
034586328570;1;228;212;144;99;146;829
048155667738;1;128;97;186;50;57;518
021963648220;1;272;225;175;58;97;827
080879458971;1;175;139;158;118;77;667
005066836358;1;146;251;145;105;155;802
071394392130;1;254;262;286;83;128;1013
090682478007;1;157;110;281;76;82;706
045868711740;1;193;146;244;114;156;853
063254696662;1;219;135;190;75;81;700
001042938316;1;280;277;258;98;99;1012
028824858365;1;93;265;224;60;123;765
009781207813;1;253;139;225;59;133;809
094823020057;1;185;161;110;99;80;635
069434179972;1;109;223;123;89;96;640
039946272792;1;155;111;145;101;109;621
093927013090;1;292;200;112;88;157;849
089107869095;1;128;258;139;98;62;685
074736001490;1;177;202;241;61;93;774
086038659819;1;136;182;259;100;142;819
045198195232;1;155;260;106;88;155;764
048393899948;1;137;87;266;85;96;671
093257306740;1;277;154;147;82;109;769
080673978322;1;85;229;296;72;163;845
063359791766;1;270;122;148;64;116;720
059408440607;1;122;169;221;90;93;695
085055085113;1;95;126;154;102;131;608
063133132794;1;115;248;109;108;149;729
002068132203;1;106;126;147;114;91;584
090811752832;1;162;87;243;68;90;650
022559859852;1;223;255;173;76;99;826
057538671895;1;120;218;279;53;115;785
025678823210;1;178;259;101;91;64;693
048256586563;1;264;229;222;82;146;943
033346616742;1;111;256;181;74;69;691
072193759694;1;282;113;201;65;51;712
053150915633;1;236;242;121;77;105;781
097898580220;1;82;164;134;96;172;648
018874867893;1;266;203;137;117;178;901
086185430295;1;180;162;148;107;144;741
074773087059;1;163;154;195;50;85;647
044795903920;1;129;229;187;88;146;779
093949199958;1;292;117;203;61;136;809
004940867417;1;84;127;185;88;55;539
030519498199;1;85;235;295;84;70;769
005801379825;1;178;84;294;74;89;719
033416208614;1;276;287;206;76;175;1020
003549552758;1;138;83;172;69;162;624
020464549278;1;125;201;206;111;119;762
054086381079;1;156;215;141;108;85;705
094409413555;1;114;174;195;103;56;642
090120695774;1;204;120;133;86;133;676
083686195769;1;285;256;278;94;165;1078
080629502662;1;111;249;205;105;165;835
039126804023;1;283;227;99;96;83;788
015897161065;1;118;217;150;53;155;693
079322952045;1;91;196;104;105;131;627
040869405954;1;121;239;205;119;71;755
073782948864;1;233;151;110;92;157;743
085412010614;1;205;220;90;102;121;738
065373922455;1;224;85;131;57;172;669
000554623946;1;268;198;149;99;134;848
016670976675;1;134;222;221;57;84;718
055860183602;1;248;283;221;110;155;1017
064137290984;1;189;276;280;52;88;885
036971886653;1;123;83;101;118;96;521
049100298895;1;242;253;220;80;67;862
054156454998;1;226;237;202;57;103;825
061353926382;1;207;200;163;93;138;801
076845483632;1;194;217;171;90;81;753
086331215567;1;151;276;101;54;105;687
065503174686;1;178;183;266;68;56;751
098450357609;1;124;222;262;68;171;847
040652703141;1;108;139;255;104;158;764
031928066699;1;221;160;142;114;117;754
021831946892;1;85;213;168;93;159;718
082687480678;1;256;138;254;71;170;889
089498766626;1;178;212;173;100;107;770
052463722407;1;208;192;284;94;93;871
026234477059;1;257;195;108;61;171;792
009136984043;1;231;103;239;118;114;805
004093821278;1;180;107;262;93;146;788
021674253455;1;233;225;139;73;172;842
043250043469;1;149;259;106;51;168;733
026451017475;1;137;154;280;60;124;755
065831757577;1;272;149;178;53;173;825
052041582230;1;167;267;183;71;86;774
099188049540;1;232;82;204;52;145;715
073313459164;1;158;143;108;56;136;601
022830893278;1;282;245;217;98;57;899
053680154447;1;123;114;241;120;160;758
056312372347;1;83;138;177;53;98;549
066483271074;1;216;191;234;80;170;891
014141437939;1;188;199;243;60;67;757
049144143585;1;236;132;281;120;70;839
065938749226;1;88;275;90;113;53;619
033059599251;1;201;177;136;62;131;707
077877413290;1;218;191;119;51;141;720
094650000149;1;135;98;142;117;99;591
080513752768;1;231;283;116;94;85;809
001314451444;1;262;242;133;108;176;921
082600073878;1;212;257;263;82;162;976
091430795579;1;120;259;215;52;55;701
037907221823;1;104;80;195;106;115;600
065779929800;1;201;112;201;77;160;751
005951744187;1;206;101;114;90;147;658
035047465932;1;192;175;285;72;56;780
050403383090;1;128;130;252;52;85;647
014305739924;1;171;260;256;66;119;872
075525922284;1;256;196;204;66;139;861
065806844335;1;237;111;157;114;173;792
077791281875;1;216;222;288;114;83;923
056433087175;1;167;266;174;111;110;828
096438310651;1;149;232;107;66;89;643
073657809585;1;216;260;113;81;51;721
080991274498;1;153;124;110;95;118;600
070817932153;1;176;108;201;116;62;663
051521516098;1;203;159;112;92;168;734
063411514148;1;185;91;209;82;57;624
094367682976;1;207;146;196;67;138;754
093896206287;1;108;229;173;56;79;645
079433339960;1;240;199;132;91;155;817
027416756255;1;121;97;244;53;118;633
003232345005;1;134;97;292;82;124;729
087074752268;1;110;148;291;98;74;721
037358037237;1;215;271;183;114;153;936
014371625547;1;177;248;175;81;142;823
071200421990;1;200;105;195;54;61;615
089835928895;1;210;264;191;86;121;872
075776692215;1;238;206;139;119;84;786
098914955383;1;262;188;259;83;85;877
073827400248;1;143;214;219;54;127;757
051686090295;1;205;224;163;52;66;710
011572275556;1;269;160;157;55;97;738
047899073832;1;105;98;129;117;123;572
012621041470;1;152;183;171;72;125;703
051838977563;1;176;246;165;112;87;786
005897880483;1;96;165;264;69;147;741
006578555785;1;278;235;128;65;96;802
016200190138;1;83;178;178;119;168;726
047047329282;1;281;281;297;78;80;1017
074189171986;1;123;286;299;110;172;990
019694706826;1;265;158;147;67;172;809
076897244699;1;147;82;260;50;112;651
028594513957;1;207;273;129;92;81;782
098398433768;1;91;283;271;69;133;847
027401300596;1;204;125;195;106;68;698
007209129140;1;105;216;99;82;133;635
015394521503;1;108;252;148;73;136;717
001593285035;1;223;260;161;89;79;812
015971122189;1;168;142;266;63;161;800
024018880280;1;126;256;147;102;101;732
096977210398;1;283;256;102;120;83;844
026442659936;1;166;217;123;110;74;690
073663047755;1;243;187;264;52;100;846
028422373550;1;215;232;98;53;152;750
011021859063;1;174;253;167;80;139;813
000234959430;1;185;198;292;53;50;778
028733219913;1;187;80;239;54;164;724
036285715658;1;117;178;265;73;158;791
087353497706;1;131;145;237;96;175;784
062873265767;1;190;270;229;76;60;825
043041077499;1;227;268;256;63;92;906
067559119945;1;253;85;218;92;89;737
093241737610;1;174;210;173;52;64;673
031634268542;1;130;111;116;65;78;500
051374223774;1;258;128;167;95;92;740
065595216660;1;133;257;291;105;162;948
052808996048;1;184;87;237;58;83;649
047223113103;1;237;187;143;119;66;752
048843788647;1;194;133;281;76;112;796
059591899844;1;288;237;109;119;76;829
059245342233;1;122;232;205;95;76;730
032433807459;1;126;237;281;62;116;822
049269686067;1;261;240;151;119;127;898
021728108554;1;85;201;120;115;73;594
068900039436;1;141;202;172;65;72;652
074925952425;1;166;253;191;82;51;743
086136497827;1;175;251;263;66;72;827
027351422176;1;205;208;147;89;175;824
086611897345;1;108;102;139;100;100;549
066700870775;1;287;240;275;100;88;990
065261220133;1;247;280;168;83;83;861
069104397291;1;287;149;120;62;75;693
015621692481;1;162;280;95;104;104;745
011353596867;1;272;93;194;116;174;849
087776247330;1;247;143;158;90;144;782
016015884916;1;123;112;283;74;140;732
046788174036;1;269;216;194;74;158;911
059683629265;1;270;114;103;88;164;739
076640564571;1;93;246;223;84;172;818
087100931230;1;272;204;224;72;148;920
065780039856;1;292;95;132;101;142;762
040346748459;1;133;134;259;103;131;760
040004946691;1;136;258;280;51;83;808
052233510429;1;289;247;107;73;170;886
089583460962;1;220;232;167;120;158;897
087465962975;1;232;170;182;106;168;858
044605587718;1;206;102;109;58;133;608
003737686265;1;130;194;101;100;162;687
016842193944;1;108;155;139;93;156;651
087960405479;1;243;267;239;92;151;992
078119830282;1;136;234;249;54;53;726
000700171430;1;269;247;211;81;169;977
016703803672;1;251;189;198;108;124;870
059652383443;1;270;116;194;117;76;773
043025155363;1;180;178;217;78;163;816
017935399274;1;235;125;251;109;122;842
003417348153;1;155;176;140;50;87;608
029485355826;1;281;247;275;95;126;1024
087966373607;1;121;125;296;62;139;743
084157585863;1;179;161;231;78;99;748
083696831132;1;100;165;246;84;101;696
017839573021;1;222;132;96;66;125;641
002108463913;1;86;251;124;65;98;624
059631896001;1;235;213;288;89;60;885
010639243251;1;228;259;253;85;80;905
014842545755;1;166;143;110;83;125;627
030459593585;1;254;107;263;77;132;833
032962447746;1;199;210;265;114;148;936
005082604367;1;179;135;216;71;72;673
085266524574;1;133;217;160;80;59;649
066259941439;1;217;140;295;79;83;814
033676363041;1;104;216;138;107;90;655
016037626947;1;201;165;277;108;174;925
015854970170;1;286;126;252;102;130;896
020219051714;1;183;83;125;104;110;605
092383968113;1;223;274;103;73;177;850
011930513651;1;168;223;119;92;138;740
003676102432;1;133;179;201;58;98;669
048784980293;1;154;240;277;86;154;911
029850041078;1;160;241;262;117;171;951
013539551779;1;198;138;124;90;119;669
043091200045;1;225;268;117;64;174;848
027390981729;1;84;222;134;78;75;593
015984424764;1;207;90;262;60;129;748
084880304347;1;138;204;192;115;104;753
061149235903;1;92;100;252;88;169;701
041972747794;1;99;97;92;90;128;506
001089769768;1;118;100;192;82;145;637
001653495728;1;86;265;166;77;169;763
043310764890;1;289;83;98;78;148;696
000731576828;1;100;94;256;116;154;720
074153363911;1;289;119;170;120;118;816
093508905683;1;275;279;168;103;73;898
005924427110;1;105;175;226;77;70;653
050410506816;1;223;123;221;79;92;738
016593379443;1;159;195;110;106;139;709
034860358519;1;286;134;159;112;154;845
015554443911;1;133;141;92;110;105;581
083091113451;1;270;254;180;107;67;878
076343250118;1;167;163;233;82;80;725
076264773733;1;150;280;286;55;167;938
059934189180;1;81;258;255;76;63;733
091090451111;1;136;209;292;51;171;859
035897019413;1;164;270;216;112;163;925
083581457733;1;142;147;101;67;84;541
009942932252;1;101;252;203;120;129;805
072502581315;1;259;257;187;57;53;813
082983823776;1;167;80;116;113;159;635
099119955170;1;138;181;253;64;78;714
085179498979;1;111;90;297;64;144;706
013032480726;1;286;262;159;104;153;964
046635639362;1;189;184;131;88;94;686
003850645704;1;110;161;183;58;161;673
013847018767;1;86;128;292;102;136;744
018465384290;1;227;96;281;78;147;829
049341068495;1;83;148;244;53;85;613
040759625413;1;254;204;131;109;74;772
013766456577;1;176;244;166;50;76;712
024095951542;1;139;119;170;91;153;672
026896006513;1;282;264;286;71;144;1047
010916189441;1;277;266;296;113;133;1085
055327179650;1;80;114;249;50;125;618
046966873300;1;280;84;108;117;140;729
014051972113;1;131;218;113;69;104;635
079575954495;1;251;155;282;101;116;905
017792050080;1;188;163;156;84;71;662
026490624755;1;156;274;288;82;99;899
059267291434;1;187;201;102;69;139;698
003866939906;1;204;224;196;98;78;800
040417006948;1;120;285;131;100;73;709
059501148831;1;214;132;222;99;54;721
048296573863;1;177;273;254;118;65;887
029227288862;1;117;106;251;112;66;652
064866926497;1;121;204;168;108;92;693
009079297342;1;86;165;94;50;149;544
038950195010;1;94;204;156;116;76;646
098546495675;1;281;128;177;86;140;812
081081191526;1;175;184;172;95;128;754
066755330958;1;130;230;243;56;72;731
098838415722;1;188;210;262;80;151;891
033814168994;1;272;219;277;78;52;898
035350098279;1;271;101;93;79;99;643
084945956367;1;205;267;227;63;107;869
035572632354;1;189;223;178;76;162;828
000147548014;1;170;155;123;108;93;649
072803419040;1;236;257;175;99;97;864
094664279431;1;154;125;92;71;97;539
096318761047;1;97;177;123;104;95;596
055372534274;1;264;155;223;82;102;826
063362099145;1;234;164;296;84;97;875
081265784017;1;215;115;161;69;129;689
009277903885;1;112;186;291;60;154;803
076405585769;1;81;208;90;63;56;498
090457880418;1;288;92;276;52;59;767
087661920187;1;175;209;243;90;153;870
016346200631;1;114;262;267;80;85;808
006845078906;1;131;94;147;58;160;590
033880465998;1;266;270;148;55;69;808
056987966214;1;83;270;294;61;62;770
053056312335;1;90;113;154;110;144;611
041313243514;1;271;110;291;67;102;841
058040337415;1;268;158;273;69;137;905
032859368720;1;87;184;141;68;134;614
099584410678;1;225;120;276;72;132;825
030412958634;1;116;85;211;106;132;650
041250137257;1;177;176;123;109;136;721
050875383286;1;250;225;168;82;56;781
004841962221;1;173;90;210;86;89;648
057689289932;1;165;119;100;63;142;589
047659854993;1;265;116;201;113;159;854
076189230696;1;89;122;242;112;79;644
089282396580;1;148;118;91;90;93;540
079666295110;1;87;106;257;109;103;662
078666347755;1;90;151;244;52;166;703
033190165229;1;179;224;241;74;160;878
021864027226;1;81;80;108;50;155;474
078749245521;1;88;146;111;101;65;511
039506848158;1;164;123;171;88;166;712
068779594409;1;268;164;274;71;174;951
004946309702;1;117;257;247;61;76;758
083856479854;1;275;155;211;96;75;812
034029512051;1;160;276;173;93;143;845
025537818726;1;153;184;94;63;156;650
067884446948;1;250;217;216;92;65;840
025862635559;1;169;250;128;78;51;676
087434741179;1;95;89;203;62;95;544
067920119192;1;167;164;214;100;87;732
027583937805;1;246;202;266;56;168;938
092829999801;1;198;225;254;82;53;812
040624865797;1;238;154;226;76;122;816
075961801789;1;199;185;292;51;138;865
077872939606;1;149;273;218;85;112;837
007505516942;1;181;105;143;61;62;552
039078739492;1;213;168;298;85;108;872
024859860548;1;275;231;295;54;93;948
074764404363;1;286;171;134;68;130;789
097474793365;1;125;89;125;83;113;535
060901472340;1;240;229;256;95;159;979
099924906611;1;244;185;140;78;66;713
061398588618;1;113;200;291;107;150;861
032813410468;1;291;218;288;109;56;962
080984542085;1;268;81;96;95;172;712
081274317460;1;205;93;145;88;124;655
069117427817;1;281;164;287;71;56;859
065799444700;1;106;200;92;119;72;589
007652379608;1;292;165;295;68;152;972
079182917707;1;222;234;259;59;149;923
097144503935;1;215;238;152;71;107;783
016014465617;1;169;125;250;63;113;720
036068029385;1;164;116;124;86;57;547
028854546046;1;143;265;186;59;116;769
040066059475;1;241;144;281;70;93;829
086831078483;1;97;168;111;107;144;627
069391023996;1;113;255;95;74;156;693
087400471325;1;183;98;159;58;115;613
024976572734;1;239;219;119;110;149;836
091045041381;1;83;261;205;81;50;680
014693189053;1;256;151;163;99;134;803
065010590202;1;286;165;172;64;175;862
050364133323;1;137;107;210;99;169;722
046648736451;1;180;153;273;87;170;863
014203341643;1;138;195;263;96;52;744
012742015648;1;207;157;265;54;128;811
068527876624;1;271;163;165;109;131;839
029082749913;1;83;195;147;64;52;541
001145725211;1;275;193;298;76;115;957
055029260519;1;128;174;123;117;158;700
082514463772;1;101;190;232;57;145;725
068783892241;1;281;114;223;100;99;817
047049564419;1;281;244;193;96;102;916
022479481340;1;220;232;228;120;138;938
061728068026;1;207;122;122;91;87;629
095970404606;1;292;232;195;119;146;984
097328520914;1;185;219;216;115;138;873
094198121812;1;237;160;156;118;164;835
043197314450;1;177;160;297;77;52;763
076946230729;1;93;220;182;78;54;627
097520009684;1;139;100;108;106;97;550
083009310213;1;269;233;159;71;104;836
017928222509;1;211;197;256;120;176;960
057121072128;1;256;108;240;80;95;779
072558441945;1;173;256;177;83;91;780
030843220116;1;156;201;297;91;67;812
064190476194;1;226;154;262;71;158;871
011558992553;1;143;270;229;103;67;812
002074228587;1;260;185;187;51;153;836
030820307235;1;271;80;124;54;157;686
088372435841;1;181;202;97;69;59;608
029711738175;1;275;111;133;51;121;691
078308313073;1;221;202;188;83;111;805
023486562507;1;269;199;133;95;90;786
024231656695;1;196;258;241;50;67;812
023168099158;1;181;185;195;70;76;707
024815146353;1;97;237;257;96;174;861
084357178099;1;235;242;240;108;158;983
021862573218;1;271;82;284;56;100;793
037273784815;1;129;271;193;63;144;800
087424162749;1;119;115;204;94;137;669
094371399272;1;118;263;227;113;176;897
005315875377;1;113;214;139;73;101;640
005262571878;1;212;87;235;99;66;699
012825991825;1;250;112;276;74;114;826
072464524037;1;210;272;113;107;54;756
028018261155;1;269;89;126;90;53;627
041774462329;1;89;276;255;87;132;839
061314795996;1;139;106;148;57;119;569
075471929385;1;226;132;207;60;80;705
049607990770;1;191;238;211;68;98;806
043992499629;1;88;126;243;98;60;615
022112013998;1;244;112;135;59;174;724
042242579871;1;135;251;94;92;126;698
033332624272;1;153;159;282;90;135;819
077887600834;1;105;249;219;80;64;717
031061527224;1;166;160;192;69;131;718
079923536860;1;141;223;221;94;178;857
011719798400;1;241;128;163;113;144;789
055569035053;1;86;89;107;119;80;481
005304939354;1;120;288;136;99;87;730
073160713905;1;267;106;300;54;167;894
080540764292;1;229;114;227;106;177;853
035448461499;1;163;258;154;94;88;757
070601887120;1;121;148;188;101;64;622
068191691076;1;195;196;115;88;134;728
079252086178;1;194;207;203;89;106;799
002228064022;1;235;101;190;97;121;744
045291875473;1;235;187;251;96;94;863
078486269712;1;157;286;116;61;136;756
013525503853;1;280;89;94;77;177;717
050221198409;1;174;157;275;79;68;753
092474026354;1;84;256;148;80;81;649
064129724428;1;276;99;191;78;175;819
090408078352;1;233;234;162;99;165;893
093411408299;1;254;94;191;119;168;826
001308151710;1;263;195;187;101;66;812
097626217293;1;268;130;281;84;122;885
017643317825;1;229;166;185;91;111;782
096024580320;1;104;178;222;115;168;787
029718731923;1;91;128;276;116;131;742
077985232401;1;246;246;141;118;116;867
069887937624;1;80;265;160;95;162;762
030560819801;1;267;285;258;70;99;979
024056411551;1;195;87;265;114;121;782
041603693798;1;176;227;252;54;60;769
038199796524;1;185;235;219;92;167;898
061998269397;1;289;98;277;58;82;804
027516689033;1;222;150;133;65;74;644
083149537836;1;286;257;114;61;102;820
017692228082;1;246;124;99;95;92;656
062262434961;1;194;177;217;95;143;826
062571565333;1;187;283;162;76;137;845
086791294382;1;260;219;136;119;142;876
014656457201;1;188;99;227;120;82;716
054226728004;1;143;143;284;54;106;730
047313638474;1;238;234;109;72;124;777
023048918945;1;262;91;237;118;132;840
098113977931;1;246;149;297;117;98;907
069930861318;1;273;171;282;53;50;829
003017012474;1;142;251;278;118;51;840
025185533714;1;213;207;108;66;154;748
036370909373;1;248;239;255;50;152;944
092306667332;1;281;192;201;74;148;896
057312966323;1;90;132;231;115;51;619
093089369872;1;177;244;255;89;165;930
060181030018;1;184;271;295;57;62;869
021845952265;1;235;179;252;103;57;826
081663593481;1;219;83;149;53;105;609
088706650183;1;246;173;195;89;94;797
086740943391;1;127;162;211;94;136;730
047998174977;1;119;148;241;55;142;705
030728697351;1;123;167;299;70;96;755
033778023428;1;284;135;241;62;83;805
039523451176;1;92;139;108;102;59;500
065176537087;1;127;157;233;86;159;762
018915424617;1;97;100;211;117;175;700
076348905627;1;245;142;220;50;132;789
099813225153;1;169;123;147;77;125;641
054717825985;1;119;258;199;75;147;798
059918032967;1;95;264;194;53;101;707
034780552443;1;129;165;184;63;69;610
011723526138;1;106;214;178;116;81;695
052686825657;1;208;273;266;85;141;973
094843911918;1;93;137;219;73;83;605
059855932100;1;270;94;125;78;129;696
035347789055;1;229;186;180;77;91;763
044613559272;1;103;162;213;109;107;694
075236265225;1;120;102;157;53;172;604
008834083416;1;273;134;219;110;65;801
027849895266;1;179;121;248;51;57;656
013978699504;1;146;144;102;55;169;616
002059911480;1;271;167;196;51;100;785
061041091196;1;174;138;112;71;71;566
040685178298;1;252;259;261;106;86;964
047032282776;1;127;142;94;98;147;608
080675778009;1;130;285;107;113;138;773
043352011796;1;164;243;246;89;91;833
006510156168;1;191;263;284;84;177;999
078948126216;1;175;137;246;84;176;818
042939477874;1;243;185;240;113;136;917
058038009532;1;86;140;296;101;115;738
004833551200;1;273;224;227;103;112;939
031670826327;1;105;133;143;61;161;603
057844330520;1;122;110;209;85;151;677
040338863423;1;161;208;254;79;119;821
001322818474;1;288;174;160;77;176;875
043662739623;1;169;147;171;74;121;682
003348431042;1;182;171;189;50;68;660
066771800178;1;166;106;269;116;67;724
092193349632;1;253;85;261;120;109;828
084362551724;1;227;238;297;95;62;919
005222429034;1;132;258;101;111;151;753
012759723629;1;186;148;238;77;63;712
087687094592;1;148;226;230;75;166;845
078450363953;1;288;228;276;65;158;1015
017131876224;1;273;136;298;51;116;874
023597624967;1;240;174;196;100;137;847
044210436289;1;157;140;183;51;98;629
088765170157;1;244;137;245;78;156;860
039067668159;1;201;115;191;94;128;729
093770294976;1;273;277;281;88;52;971
002576592554;1;175;154;154;102;134;719
078043922343;1;160;83;173;111;128;655
065990993859;1;105;178;164;71;150;668
011161466084;1;224;148;97;51;112;632
043155312452;1;137;238;170;98;105;748
043793089412;1;209;241;114;53;142;759
074655133259;1;141;201;283;86;168;879
099443239325;1;289;214;150;120;79;852
066352740193;1;132;135;239;81;174;761
073676681465;1;235;178;148;89;66;716
014292150023;1;264;91;237;51;115;758
001727915250;1;140;106;260;59;165;730
077305609126;1;250;217;252;101;116;936
049834230593;1;202;226;176;76;117;797
080810654089;1;162;196;258;80;74;770
063507885380;1;192;251;272;93;134;942
025271102843;1;104;252;131;101;105;693
023290568718;1;253;225;256;73;153;960
094718401754;1;254;238;90;116;141;839
068103836680;1;163;94;251;106;118;732
070602536172;1;244;164;139;87;64;698
073811214123;1;279;134;106;83;51;653
090651594361;1;247;143;287;118;70;865
028633170695;1;170;104;191;97;108;670
054809984778;1;291;250;120;63;65;789
084587796438;1;175;157;109;76;128;645
069559243193;1;174;282;180;50;127;813
076544197099;1;95;158;225;59;109;646
083219852907;1;110;84;243;111;115;663
011910455736;1;151;114;276;103;100;744
029338147851;1;91;158;231;85;156;721
028857210043;1;242;169;152;100;91;754
088496137582;1;291;276;144;57;153;921
045450900650;1;134;244;279;81;86;824
091112435766;1;245;287;91;74;109;806
081590001868;1;93;105;289;100;67;654
020276527166;1;83;122;299;86;146;736
097782381883;1;180;253;214;51;83;781
016779808085;1;152;166;298;89;78;783
010691894405;1;81;182;129;104;104;600
085222419568;1;216;227;95;72;127;737
057901419018;1;129;157;244;71;104;705
057574521084;1;197;121;203;55;169;745
017411327897;1;244;270;197;84;154;949
004260522284;1;226;196;278;110;81;891
031763903414;1;268;128;160;95;125;776
078094241538;1;195;267;152;102;166;882
078541748367;1;206;176;134;73;75;664
014186126542;1;287;167;214;74;91;833
048622914391;1;159;162;228;101;68;718
045879011375;1;280;276;239;90;138;1023
008307190395;1;164;89;137;113;70;573
029069950078;1;88;216;148;85;167;704
006525732650;1;211;102;237;84;136;770
063475795494;1;218;144;133;113;119;727
062051372072;1;228;222;258;113;58;879
022131010979;1;151;131;153;77;129;641
006611553138;1;104;191;282;62;149;788
065932121548;1;199;83;216;104;175;777
084163084927;1;146;99;180;77;164;666
086158022047;1;104;182;256;67;76;685
080120326992;1;193;226;196;81;175;871
020596775598;1;88;156;245;65;52;606
073476808088;1;262;117;131;116;124;750
045064845917;1;144;203;157;91;110;705
075005253264;1;282;116;188;54;98;738
095121685755;1;220;192;286;85;131;914
039463744753;1;137;223;229;114;56;759
049492790402;1;179;122;226;74;150;751
011276042390;1;166;91;100;68;108;533
001996762430;1;142;93;300;91;107;733
098640767840;1;121;241;178;117;119;776
007352658454;1;252;166;245;56;66;785
002600008311;1;236;161;279;75;124;875
044714263217;1;222;217;123;100;58;720
032934242871;1;231;163;248;82;175;899
068144177776;1;252;146;268;64;119;849
038447319831;1;195;139;239;76;168;817
002800853289;1;205;273;135;87;83;783
079596778011;1;203;132;110;70;155;670
047758139075;1;257;193;155;112;166;883
010679922417;1;173;157;299;68;142;839
084511920146;1;166;181;109;52;152;660
027677958514;1;93;93;105;117;68;476
058459889771;1;83;279;286;56;66;770
078462585958;1;188;236;130;106;115;775
021656556439;1;86;190;238;50;102;666
032382494025;1;268;178;165;74;152;837
098924079442;1;247;151;104;72;166;740
033357641678;1;109;112;285;86;57;649
009334834371;1;107;92;174;89;109;571
041794726200;1;114;160;257;74;135;740
081087397582;1;215;218;269;86;122;910
047388935883;1;180;261;266;64;149;920
059890893484;1;273;163;218;118;77;849
008182980801;1;285;239;117;81;120;842
003962576953;1;213;174;140;70;85;682
034651007841;1;289;207;208;77;66;847
037296034260;1;179;235;300;82;85;881
011430365380;1;282;214;157;104;150;907
032057341692;1;233;225;226;97;109;890
074306659612;1;213;270;91;75;148;797
079858741060;1;285;107;151;58;93;694
027088583354;1;84;246;130;56;138;654
093031082159;1;153;283;103;83;88;710
048236515624;1;209;85;124;117;57;592
091792615941;1;98;116;227;53;145;639
092595098702;1;124;276;242;119;99;860
097682927088;1;241;177;293;78;99;888
091852995263;1;221;196;145;63;66;691
028021421097;1;98;191;277;103;154;823
026183062214;1;155;288;271;109;59;882
044009201603;1;280;123;228;80;119;830
008484449731;1;176;224;217;105;80;802
093531772846;1;194;95;193;59;168;709
021880631919;1;201;104;293;115;171;884
089284018799;1;271;266;182;50;125;894
022508208361;1;252;152;231;66;178;879
041662176953;1;118;148;103;92;176;637
010153692336;1;191;103;286;85;130;795
056914925855;1;194;199;293;79;104;869
049377625853;1;168;272;171;103;144;858
031360104011;1;89;202;221;57;55;624
068586703219;1;158;181;121;80;56;596
079851763220;1;173;173;252;90;70;758
075664685841;1;235;173;154;73;60;695
023231263041;1;109;116;235;100;58;618
023716965247;1;106;267;256;69;75;773
089451432863;1;106;99;230;73;85;593
055928367038;1;174;259;267;58;51;809
046481993064;1;118;106;211;71;53;559
053379369312;1;139;217;158;87;157;758
092866233220;1;127;88;215;116;56;602
086667926935;1;281;190;93;75;133;772
089486643679;1;95;204;198;115;99;711
013917421305;1;99;162;171;80;128;640
023606527226;1;218;276;186;61;166;907
009255099954;1;123;282;142;59;64;670
091332064163;1;210;192;92;87;169;750
036562047369;1;219;96;182;75;51;623
076074874887;1;167;240;164;64;163;798
020065643544;1;270;160;289;113;154;986
044901030772;1;215;85;268;69;54;691
046966899509;1;146;272;191;117;160;886
098206333727;1;248;220;228;63;168;927
029641355967;1;239;171;195;65;68;738
028293659243;1;198;220;158;85;175;836
006253176254;1;290;264;286;88;145;1073
066974793731;1;278;89;256;65;175;863
061144126495;1;288;131;154;84;158;815
061259284360;1;276;196;234;52;160;918
065724757434;1;96;150;290;68;93;697
055843004405;1;82;269;255;112;150;868
033853527898;1;205;163;110;114;103;695
001003681353;1;242;200;107;71;122;742
006924780753;1;267;255;277;86;69;954
038394122658;1;100;88;280;101;82;651
061555052536;1;125;195;202;58;58;638
038089220617;1;216;258;133;111;160;878
006235763874;1;86;194;280;57;76;693
005746451146;1;164;88;136;93;125;606
012890470360;1;208;225;155;70;85;743
030641402001;1;184;165;133;82;145;709
093601090884;1;143;196;214;58;72;683
045021970807;1;205;82;238;79;159;763
026480376694;1;175;128;298;66;83;750
004071740970;1;181;151;207;50;129;718
015405076844;1;234;187;277;53;130;881
092277690371;1;122;144;147;91;131;635
032742571650;1;179;107;250;110;81;727
083963934299;1;290;231;154;101;115;891
077005262454;1;273;144;256;77;61;811
050964654349;1;262;124;101;70;71;628
023008306923;1;210;128;139;91;70;638
006047904138;1;222;233;244;57;76;832
030019062970;1;233;267;178;56;57;791
031251342569;1;170;195;259;87;160;871
088018499188;1;254;105;105;98;99;661
079815874683;1;224;253;154;78;86;795
075524599169;1;162;188;171;83;72;676
021739932361;1;115;221;239;76;83;734
066731813426;1;145;230;176;60;105;716
045623400394;1;237;94;120;91;146;688
084670655848;1;159;208;268;78;59;772
052483678945;1;140;93;97;63;153;546
042989554306;1;91;100;95;114;119;519
056958997500;1;134;129;94;113;95;565
019821116693;1;107;230;287;106;145;875
042605599004;1;93;118;143;74;144;572
040396271267;1;134;262;166;102;168;832
050635714843;1;254;108;219;80;65;726
002132763793;1;100;267;146;103;138;754
086462507959;1;90;234;152;50;96;622
043235069438;1;291;166;293;93;177;1020
068092994869;1;201;168;234;50;151;804
057016450681;1;123;253;200;70;132;778
026350629563;1;223;116;203;115;102;759
052390558951;1;151;263;110;65;146;735
016886437761;1;107;207;243;50;167;774
001011183634;1;235;170;220;103;151;879
052500562545;1;82;251;280;50;100;763
099096469782;1;135;189;180;100;119;723
049189561936;1;150;168;298;51;133;800
019861749752;1;266;233;124;87;70;780
081380791833;1;90;89;99;88;131;497
079902494123;1;255;229;176;117;91;868
053607456097;1;199;137;300;78;139;853
027281878654;1;232;271;212;104;166;985
059253692081;1;178;250;170;87;82;767
040863410424;1;116;253;205;83;131;788
032948202964;1;180;254;289;61;117;901
052737780147;1;291;240;203;110;139;983
042073322958;1;117;165;264;76;93;715
021476766988;1;236;107;131;91;101;666
034925828909;1;248;256;268;56;51;879
089248147071;1;112;157;141;112;117;639
021883019227;1;245;179;91;106;156;777
044912131142;1;288;288;243;83;164;1066
057475075114;1;111;160;177;76;59;583
072326576503;1;252;106;117;67;176;718
027958148257;1;194;144;264;120;79;801
034267995071;1;194;254;214;100;75;837
098175828830;1;100;204;193;56;138;691
024776889000;1;136;279;216;66;139;836
048685819855;1;92;138;281;75;97;683
036606710556;1;81;128;146;58;172;585
099565884050;1;269;216;145;54;74;758
038709958664;1;289;164;282;94;120;949
064898042822;1;272;230;247;113;138;1000
038715274715;1;218;97;225;55;87;682
015694477102;1;256;90;219;91;70;726
019827168091;1;262;224;151;61;167;865
043916361244;1;164;215;221;113;62;775
008321544022;1;90;106;110;76;93;475
014774739669;1;134;102;282;96;146;760
090603395247;1;219;139;154;84;65;661
029327445533;1;264;241;127;104;97;833
067948308063;1;192;261;263;82;148;946
004724337127;1;241;207;265;111;117;941
009328409993;1;168;94;300;62;176;800
014783045724;1;252;127;240;58;119;796
007785933679;1;274;252;220;71;138;955
092266471122;1;121;208;195;118;93;735
029302045534;1;225;175;289;66;104;859
058694217283;1;176;264;106;106;63;715
083870008683;1;172;138;229;90;145;774
001470976157;1;164;83;252;79;121;699
092565236303;1;259;232;184;70;93;838
098673157965;1;176;93;250;62;65;646
029566583384;1;142;180;116;69;171;678
021086299606;1;113;146;208;67;157;691
094678103209;1;197;135;229;58;103;722
072711989338;1;187;172;281;85;110;835
015909065432;1;170;164;291;53;63;741
044510945064;1;120;151;281;53;148;753
039958919777;1;207;159;95;118;173;752
009964079551;1;207;216;299;102;71;895
032859183309;1;113;125;295;105;60;698
056198342597;1;134;178;115;93;131;651
078542801579;1;103;204;228;66;98;699
067361674054;1;281;143;160;54;88;726
059886925292;1;151;169;92;81;61;554
010737323755;1;241;258;245;63;86;893
089075750362;1;207;124;221;108;127;787
021135255386;1;155;134;155;55;163;662
000306638234;1;124;100;200;109;65;598
083280663199;1;157;92;119;65;134;567
037656809256;1;185;263;171;120;130;869
077951038651;1;114;121;143;79;125;582
005292852801;1;134;161;205;102;93;695
084283205986;1;222;245;241;105;51;864
006250089884;1;246;206;194;106;153;905
000352209040;1;160;260;94;78;137;729
071876792875;1;123;176;98;114;120;631
063987323530;1;273;117;204;79;119;792
048705581503;1;200;222;291;105;53;871
034873581764;1;146;236;153;77;66;678
004706458401;1;258;161;172;72;72;735
037147061711;1;132;80;201;94;112;619
020106871773;1;219;124;219;108;136;806
099491698798;1;119;164;231;64;146;724
034882918287;1;267;265;109;69;98;808
037784736644;1;113;131;290;50;135;719
078442547044;1;287;175;245;114;96;917
026680093287;1;166;155;119;74;176;690
062661776630;1;153;142;290;97;118;800
028638644331;1;199;281;265;70;120;935
023336864672;1;123;171;232;71;80;677
004963925578;1;168;282;107;69;70;696
011160676162;1;163;153;277;71;128;792
031054279110;1;268;216;251;54;132;921
071306458833;1;80;203;194;108;134;719
047362471408;1;128;279;171;117;148;843
017107838841;1;213;135;289;79;117;833
072664843194;1;270;265;215;72;105;927
051533608237;1;249;276;128;96;174;923
043508253021;1;198;281;125;102;151;857
008219979733;1;192;127;158;66;76;619
068746271204;1;223;255;211;104;176;969
023642220172;1;85;212;224;64;57;642
023488465636;1;123;192;102;50;83;550
032433288346;1;146;217;172;70;130;735
043784520696;1;201;175;110;105;129;720
059588520675;1;170;276;238;84;71;839
084534698305;1;175;240;173;75;75;738
075903515237;1;291;82;277;70;146;866
064104361890;1;183;142;212;115;148;800
076720839080;1;108;264;166;88;156;782
059520826890;1;178;170;114;61;104;627
015357912744;1;228;220;176;73;124;821
095129735743;1;283;283;276;99;169;1110
044776864744;1;107;113;101;114;171;606
013454551764;1;241;204;251;63;58;817
005027752535;1;291;260;105;100;142;898
037491212054;1;207;184;208;57;95;751
078978524483;1;277;121;150;55;173;776
057238568836;1;225;206;116;99;73;719
059596520106;1;257;187;212;78;109;843
070657032892;1;102;214;107;53;113;589
034574901444;1;154;171;92;70;105;592
003785027357;1;173;193;166;112;132;776
055825850125;1;272;261;208;95;52;888
047532586390;1;167;246;245;79;63;800
084323986148;1;83;134;150;61;112;540
090567242617;1;103;230;139;85;101;658
058300719853;1;245;139;272;54;115;825
069223717020;1;108;191;126;55;60;540
018432045504;1;114;152;288;89;140;783
073400314120;1;121;247;282;58;102;810
046376624776;1;267;174;278;114;171;1004
084466825725;1;169;256;215;92;129;861
037445928780;1;138;125;179;71;90;603
016481029138;1;218;202;106;80;158;764
055569663156;1;116;99;167;70;170;622
095970066091;1;129;203;150;92;84;658
022657470554;1;224;165;131;107;121;748
048088859507;1;264;244;240;69;104;921
084392114085;1;221;195;183;61;56;716
048900575232;1;208;248;236;71;106;869
027219047888;1;113;257;149;81;57;657
058513202268;1;125;280;279;97;102;883
019749688119;1;132;119;139;69;116;575
033112620799;1;89;134;293;81;75;672
010303402307;1;224;260;217;55;126;882
011047031120;1;153;201;282;102;140;878
027177961219;1;152;90;259;84;159;744
030371722407;1;132;103;95;67;138;535
012321322577;1;269;224;293;116;98;1000
039488785474;1;264;211;253;111;133;972
069785571571;1;238;85;160;61;119;663
042821795936;1;251;279;219;108;87;944
092098970788;1;268;110;177;90;71;716
019417243492;1;189;86;207;72;85;639
034176440810;1;184;127;162;80;156;709
002144826735;1;227;178;283;68;113;869
060756554575;1;93;122;105;52;106;478
075823211527;1;260;280;185;104;68;897
080150461489;1;167;138;260;89;86;740
078901440623;1;250;112;134;91;92;679
099408632559;1;116;193;279;88;108;784
012300334314;1;197;282;128;80;59;746
043257846711;1;206;230;183;53;171;843
059679829484;1;197;145;190;79;136;747
041312338669;1;110;84;215;102;152;663
059191952735;1;242;233;107;73;92;747
088273667161;1;128;109;207;85;77;606
077446478226;1;147;134;170;84;111;646
027476568827;1;286;187;270;77;59;879
011522286317;1;235;241;190;92;93;851
005244382754;1;280;208;114;58;56;716
017041492381;1;117;176;100;81;175;649
038917105435;1;248;180;178;86;51;743
002061600072;1;148;280;95;66;138;727
001654718950;1;166;155;189;111;85;706
034635705947;1;185;150;254;53;144;786
019519581149;1;119;162;107;72;115;575
059271773624;1;186;258;163;55;102;764
025730108944;1;198;233;104;109;174;818
010374865651;1;214;169;147;108;100;738
085188698251;1;208;210;283;74;168;943
016723557886;1;274;113;95;102;121;705
086569387239;1;95;196;278;92;106;767
018250164873;1;146;275;104;63;128;716
032083843243;1;262;139;297;94;133;925
069202924257;1;90;111;256;59;97;613
075590198026;1;290;244;91;120;65;810
083649373962;1;285;251;234;90;157;1017
057439158345;1;149;227;145;57;85;663
093312860819;1;283;233;177;62;84;839
026018633948;1;255;267;248;78;142;990
006151869795;1;278;226;116;118;106;844
076898710848;1;269;198;166;107;51;791
022543270938;1;203;244;161;65;127;800
036235195432;1;230;137;275;53;89;784
093071700224;1;149;160;103;76;107;595
013451429397;1;120;123;121;94;72;530
008759057693;1;227;106;174;62;169;738
029921869977;1;159;273;177;69;148;826
064954513513;1;216;286;153;82;103;840
027033474618;1;98;175;148;86;132;639
086882193017;1;137;142;232;101;151;763
030059314003;1;89;212;181;107;164;753
033394259910;1;274;178;125;69;141;787
098420745649;1;284;129;235;54;118;820
079755654982;1;221;123;261;94;63;762
026053350675;1;138;204;180;109;173;804
015739938777;1;147;152;153;113;166;731
035668355412;1;128;94;187;120;85;614
011341643966;1;234;270;138;105;171;918
089558231974;1;277;151;99;69;161;757
071402087531;1;122;160;196;119;115;712
003594295291;1;193;235;107;84;104;723
002692537411;1;262;124;163;105;176;830
063658631247;1;275;235;196;78;58;842
094906623496;1;233;88;108;94;52;575
062840973091;1;256;110;135;102;97;700
049517082611;1;108;198;206;107;177;796
042402113196;1;192;117;143;101;167;720
088147241551;1;206;248;231;50;79;814
004982982013;1;274;150;268;92;116;900
006631352086;1;147;122;227;69;164;729
092773323084;1;287;183;150;77;143;840
067118484432;1;141;224;180;117;61;723
014152042395;1;264;255;276;68;133;996
042301763502;1;226;267;214;109;148;964
029621864633;1;254;101;216;62;168;801
024885469194;1;163;270;175;78;76;762
022841845703;1;208;205;215;70;91;789
012602050960;1;116;199;299;107;91;812
096009062811;1;183;146;289;87;55;760
048742083669;1;262;162;171;87;114;796
088736752600;1;121;283;181;97;56;738
003161337554;1;111;157;187;112;69;636
055742319521;1;290;282;184;99;128;983
011906409449;1;219;265;260;84;56;884
057657538971;1;185;102;261;61;159;768
084286323131;1;270;269;168;99;70;876
030078545489;1;255;97;122;59;68;601
020584986248;1;117;281;217;79;83;777
080071398916;1;130;178;276;71;165;820
037878368337;1;196;107;198;85;168;754
087654843708;1;133;156;220;62;153;724
004892630142;1;107;245;212;50;115;729
083789678919;1;230;190;157;65;114;756
041979209176;1;187;261;284;76;68;876
031279164195;1;159;251;218;64;74;766
038880597905;1;89;248;269;112;76;794
032659447866;1;127;106;149;77;130;589
026091131230;1;89;82;193;91;101;556
007805400873;1;88;90;200;107;113;598
092204836826;1;200;158;203;57;91;709
099899967014;1;112;237;143;110;168;770
042876124938;1;90;128;281;92;102;693
099850495855;1;98;107;153;58;141;557
013503395546;1;183;92;198;60;139;672
033519835307;1;271;106;246;69;159;851
000594316965;1;223;176;237;91;129;856
008175693227;1;178;178;159;78;101;694
064360876810;1;283;266;117;94;174;934
043184655647;1;170;252;138;60;103;723
096805209650;1;199;116;108;65;114;602
068480954271;1;101;127;174;90;73;565
067420270471;1;106;152;111;110;132;611
033995508686;1;183;106;278;92;175;834
018221691411;1;141;281;272;107;116;917
047437666013;1;241;239;227;88;57;852
052537400020;1;253;237;121;66;134;811
020234974942;1;95;123;134;117;76;545
055042931981;1;169;149;238;65;162;783
046030803131;1;274;264;210;63;162;973
013355309331;1;231;273;217;89;100;910
043747885996;1;203;187;237;73;71;771
030236834364;1;237;224;244;102;104;911
031399543043;1;268;226;286;90;168;1038
050705565843;1;107;125;269;117;156;774
013921568090;1;247;172;145;106;126;796
051894636714;1;262;172;255;57;98;844
016599001139;1;270;220;140;103;123;856
067894453090;1;134;84;163;54;57;492
046845175487;1;164;273;230;89;146;902
078094474228;1;216;122;105;85;77;605
057280291376;1;272;157;247;118;160;954
067365850213;1;140;215;137;111;148;751
034028974892;1;164;81;295;78;158;776
022132405762;1;233;251;149;86;145;864
090474188980;1;212;129;258;73;102;774
068270484408;1;243;120;240;73;91;767
050145111373;1;285;145;98;72;128;728
033213637251;1;109;189;266;93;79;736
089438615286;1;170;87;122;100;175;654
059834037309;1;162;138;240;76;116;732
033600646329;1;252;111;261;107;125;856
096692313310;1;193;238;221;70;91;813
065873502366;1;226;136;180;110;73;725
072215559185;1;273;218;94;53;164;802
072311287675;1;82;244;171;73;120;690
070354749093;1;271;127;294;91;153;936
096406783782;1;171;150;117;87;175;700
046156096249;1;251;279;138;118;168;954
006245092212;1;158;169;225;103;135;790
050545453067;1;247;80;194;108;124;753
061915627266;1;249;101;135;101;67;653
074156522472;1;138;95;181;94;167;675
094610859966;1;101;210;177;84;145;717
089996844123;1;138;270;210;82;57;757
007368499998;1;168;274;239;106;116;903
082668044427;1;132;263;299;88;151;933
063848775958;1;171;130;300;88;61;750
079326941752;1;275;147;129;118;131;800
090797196917;1;225;283;255;88;96;947
027241308751;1;157;183;238;75;72;725
030358899851;1;243;166;178;63;126;776
075422641330;1;217;89;235;67;171;779
008656354455;1;114;250;242;70;121;797
055465081769;1;226;222;153;88;111;800
033264619439;1;200;186;212;77;83;758
084189573605;1;149;149;249;85;156;788
042009691722;1;96;174;239;74;156;739
008764476132;1;127;126;161;81;112;607
006972377216;1;198;288;117;72;118;793
019652090928;1;291;281;243;111;177;1103
071454383680;1;229;250;99;51;99;728
012997895034;1;88;87;184;78;142;579
095512049922;1;89;175;214;58;141;677
096712119009;1;158;167;289;51;67;732
046834411788;1;88;185;298;96;91;758
035414625486;1;216;166;99;55;170;706
008295312776;1;213;238;130;94;170;845
000063718450;1;142;146;92;105;145;630
098878217607;1;244;167;92;84;178;765
071078130581;1;269;165;160;104;84;782
003951464520;1;153;178;171;83;137;722
005244412177;1;137;235;198;103;64;737
012910098604;1;237;138;160;55;81;671
080973669541;1;280;143;279;69;53;824
071239795602;1;150;267;261;118;111;907
058297878568;1;93;129;93;109;66;490
029474381364;1;288;165;260;79;119;911
047491733419;1;197;84;278;52;143;754
000714583724;1;262;227;135;67;113;804
042126867575;1;177;288;225;53;131;874
094399081362;1;147;205;113;81;176;722
097547491009;1;86;110;296;99;153;744
070125932291;1;241;141;177;113;145;817
008600906930;1;201;237;203;90;169;900
099213765888;1;184;232;102;97;157;772
027456446969;1;145;246;139;107;105;742
042791953384;1;283;257;210;118;112;980
061811398597;1;135;189;197;113;123;757
089946968618;1;91;106;238;99;72;606
053679115511;1;282;178;209;50;117;836
034805474310;1;146;206;143;119;60;674
017202249200;1;146;143;197;100;131;717
067284442912;1;138;288;223;53;61;763
046497274006;1;246;192;123;74;50;685
098620067182;1;120;248;136;72;103;679
001390316174;1;174;266;188;106;131;865
094605456544;1;120;126;259;101;85;691
022332728681;1;128;202;200;111;152;793
059264168702;1;251;96;252;119;54;772
026494993115;1;115;101;175;89;69;549
098868913081;1;99;216;92;116;112;635
010335341953;1;279;90;247;108;143;867
056022020653;1;96;83;92;62;116;449
098197938173;1;136;187;264;85;112;784
021056027532;1;116;150;128;55;125;574
018589639566;1;172;126;159;86;144;687
031097361429;1;93;271;172;110;71;717
081550176979;1;199;157;285;97;103;841
039413622652;1;163;265;300;72;69;869
082661841331;1;128;106;284;58;70;646
097115009584;1;282;142;275;118;61;878
058488467995;1;212;190;105;65;177;749
074791554591;1;217;263;261;99;62;902
015979170816;1;211;207;132;95;72;717
064781912583;1;284;103;130;109;167;793
050194155348;1;163;203;226;64;140;796
069129512075;1;124;148;150;84;114;620
043322355234;1;246;203;125;63;151;788
027009089485;1;235;284;104;115;172;910
060113416326;1;261;140;154;108;111;774
059112492394;1;138;258;261;106;68;831
090674676518;1;168;181;134;108;148;739
055388646641;1;122;107;97;99;118;543
007006103208;1;208;172;227;115;177;899
042717385776;1;193;208;247;85;128;861
086974799648;1;245;244;240;76;69;874
039136473472;1;257;181;180;91;105;814
061673858647;1;225;248;212;107;165;957
020376467891;1;165;99;93;96;79;532
098606423683;1;263;169;223;90;163;908
086477588850;1;157;197;285;113;68;820
004630975042;1;222;205;296;99;64;886
016437996523;1;93;204;201;115;136;749
021265281526;1;212;103;108;50;99;572
056154703038;1;178;126;222;52;144;722
040179898775;1;98;107;260;92;95;652
078713824515;1;149;85;287;76;168;765
074769584198;1;230;124;253;99;59;765
085064237836;1;155;202;168;65;142;732
024652482288;1;235;110;138;51;85;619
051755877795;1;179;169;190;54;62;654
041036219399;1;94;146;183;65;71;559
076251747257;1;189;165;224;69;51;698
036671402896;1;196;173;92;61;158;680
040684992822;1;240;229;276;78;78;901
093876773249;1;83;246;250;118;52;749
073983821156;1;226;273;211;84;150;944
030312466651;1;84;232;285;81;82;764
076291565585;1;156;119;119;82;153;629
035961291829;1;276;192;90;120;93;771
069368109585;1;89;125;204;113;176;707
098310576954;1;115;121;130;85;83;534
050339403491;1;209;145;207;57;167;785
055781077350;1;174;83;112;92;91;552
009516938317;1;291;150;180;81;81;783
081289711712;1;99;88;289;83;52;611
056650637998;1;239;241;228;116;81;905
001798149212;1;145;149;152;81;167;694
044604302707;1;96;218;181;111;62;668
061817853950;1;256;135;279;104;88;862
079212458618;1;95;236;295;59;103;788
028106365087;1;230;265;147;118;64;824
082410248052;1;103;203;117;56;137;616
029174906791;1;275;100;240;85;55;755
099639113937;1;118;118;238;62;161;697
072038563316;1;241;208;148;54;67;718
012541674237;1;109;160;263;82;58;672
012932616421;1;225;98;187;63;115;688
002270339955;1;228;102;176;65;148;719
016664074132;1;137;236;185;51;114;723
035687624028;1;85;94;139;106;178;602
056847102003;1;129;270;188;113;60;760
041927595374;1;155;277;207;53;168;860
019861466698;1;114;146;297;58;166;781
039503979238;1;144;107;276;50;50;627
041342696169;1;250;203;124;87;142;806
044139332262;1;268;176;197;65;156;862
028969454433;1;232;248;250;108;66;904
083394680140;1;169;204;97;116;116;702
082842010003;1;152;257;186;111;51;757
023942749337;1;179;90;165;52;169;655
060036433650;1;266;259;286;51;155;1017
033926354228;1;173;122;117;59;136;607
069208103498;1;232;254;101;69;50;706
023883232750;1;197;220;124;91;105;737
054350782497;1;248;199;120;101;128;796
074356322371;1;210;198;255;94;159;916
047180954954;1;87;250;247;74;117;775
098090768406;1;130;167;243;60;166;766
075766189268;1;270;124;162;61;153;770
068976496953;1;117;138;142;61;143;601
024863722972;1;206;185;111;70;140;712
035105922100;1;230;285;275;105;131;1026
068707311187;1;97;88;185;110;166;646
085039594779;1;240;218;223;117;142;940
091770338273;1;131;243;105;99;108;686
050331897538;1;256;150;127;116;68;717
042872401309;1;198;252;184;59;58;751
078422486335;1;238;184;281;77;145;925
030278307781;1;247;287;129;52;111;826
050624791216;1;245;227;282;116;92;962
027091469434;1;103;144;251;116;58;672
085759791964;1;285;199;157;104;71;816
038004942727;1;133;81;117;95;114;540
072620776048;1;269;224;190;96;101;880
001829536680;1;155;266;260;110;55;846
011917348895;1;258;156;256;100;118;888
094914173852;1;149;190;184;115;176;814
057508627077;1;101;271;267;103;67;809
086928020417;1;155;266;219;90;56;786
035885668626;1;142;287;223;83;106;841
082824622136;1;274;238;206;67;74;859
049176023446;1;286;169;123;78;147;803
061240559013;1;109;267;204;91;148;819
091784973585;1;197;187;296;54;168;902
044502799983;1;92;125;186;96;66;565
011714230279;1;201;135;134;115;135;720
002070781857;1;146;117;223;117;156;759
080359864905;1;172;145;252;52;148;769
077112967151;1;215;169;242;69;74;769
079411926221;1;163;158;170;111;135;737
048351572410;1;180;194;193;57;129;753
062683794384;1;267;164;101;115;52;699
038997458641;1;102;87;179;114;60;542
012759682843;1;281;226;113;74;96;790
071988349729;1;230;128;100;86;178;722
033444968396;1;283;262;99;74;173;891
034184338371;1;204;201;285;105;144;939
007957169958;1;199;246;158;88;53;744
030555784866;1;250;176;290;103;116;935
078304728164;1;241;98;245;64;79;727
061368048492;1;239;213;224;114;161;951
081086995943;1;212;238;292;91;116;949
014991637871;1;188;109;96;83;96;572
080557088428;1;291;148;293;116;107;955
003679275722;1;188;172;298;118;99;875
091735150933;1;245;285;239;87;162;1018
014772039609;1;274;253;224;57;148;956
001323590462;1;91;271;203;103;95;763
079518493725;1;116;176;133;71;144;640
001038115799;1;186;177;254;65;143;825
098187641509;1;139;168;280;52;138;777
061771391393;1;153;88;250;58;114;663
037802071366;1;279;134;158;98;101;770
026723374235;1;202;127;93;82;178;682
015369201101;1;218;128;272;118;132;868
072967657336;1;263;220;110;83;94;770
034317836887;1;179;132;285;78;175;849
051303922033;1;152;212;123;79;92;658
049965857820;1;225;160;283;77;114;859
083402452917;1;148;110;200;60;86;604
076490796404;1;255;165;231;67;175;893
024235375497;1;226;264;195;100;93;878
088805045986;1;136;153;236;66;178;769
086958161965;1;229;244;245;78;102;898
057622807039;1;220;106;111;103;58;598
017338758692;1;198;212;218;94;115;837
076785837301;1;149;182;227;74;66;698
078289486830;1;150;89;265;68;69;641
073773358731;1;235;89;102;55;73;554
038377111894;1;272;154;122;116;119;783
085940635597;1;98;158;217;102;97;672
080348926414;1;129;150;134;50;71;534
019181183914;1;153;216;215;104;59;747
057530222216;1;285;80;159;87;62;673
098946810118;1;290;243;99;75;152;859
007931847659;1;161;158;217;56;140;732
063879972285;1;269;192;233;110;135;939
075162274810;1;264;208;291;71;166;1000
013904724379;1;150;116;260;97;151;774
068747694466;1;141;171;234;53;69;668
048164620595;1;184;218;224;67;144;837
081474006135;1;265;109;211;96;124;805
076979622709;1;85;100;133;96;137;551
053131383942;1;97;249;188;95;105;734
080277047986;1;270;160;197;50;51;728
074084890102;1;236;250;133;53;115;787
069047846490;1;170;193;196;78;72;709
048398673375;1;127;152;153;75;109;616
074117607933;1;93;159;141;79;135;607
092032284856;1;102;147;233;101;83;666
031770112838;1;237;155;213;101;76;782
059292690806;1;234;186;290;64;105;879
058680505774;1;91;267;106;70;90;624
012208342380;1;231;137;186;107;137;798
096600157813;1;129;219;155;104;132;739
060149214730;1;267;248;173;95;78;861
090158647671;1;90;210;121;119;53;593
022286642165;1;170;182;257;84;85;778
025219638084;1;193;144;230;106;139;812
037052208811;1;185;136;125;79;145;670
029287752440;1;238;119;156;87;127;727
030623440646;1;271;231;200;69;124;895
031359964763;1;157;141;101;65;142;606
081817613337;1;206;115;104;118;174;717
089724084765;1;189;239;115;111;80;734
046266526469;1;110;133;286;70;135;734
018733883907;1;116;269;106;117;173;781
007979816688;1;227;186;277;73;122;885
012318985549;1;201;84;244;94;177;800
033990085135;1;118;278;231;56;127;810
086386459946;1;110;249;209;61;121;750
070248690914;1;163;273;211;88;61;796
018986593946;1;152;271;157;92;104;776
035490433712;1;252;146;219;84;170;871
097977239188;1;157;121;163;66;69;576
027557270015;1;120;237;137;116;139;749
031610742452;1;254;188;119;61;164;786
035663566620;1;179;99;136;53;54;521
097834877990;1;104;282;258;104;103;851
085995467480;1;174;241;294;65;130;904
019273472432;1;291;155;119;102;96;763
000809939539;1;83;248;244;62;111;748
082592900734;1;111;152;111;95;63;532
047590405134;1;177;111;95;103;114;600
014179912429;1;161;265;174;63;58;721
075933877373;1;91;217;295;97;152;852
013636129681;1;224;95;261;63;71;714
063370221734;1;131;228;237;102;54;752
057617529086;1;97;250;154;51;98;650
062302101308;1;151;262;116;72;76;677
018761194113;1;250;108;237;75;79;749
065707184044;1;225;261;195;95;150;926
096249649371;1;141;202;220;61;171;795
061500516505;1;246;253;169;103;145;916
012726923458;1;213;151;272;69;130;835
044198074016;1;82;111;112;100;172;577
016923051422;1;173;270;155;53;90;741
096786546072;1;264;147;285;98;136;930
096572231758;1;272;286;254;50;156;1018
092539965772;1;194;169;209;84;175;831
023590732945;1;179;254;156;51;138;778
037259536771;1;122;179;110;87;144;642
068416561227;1;127;194;215;100;140;776
082763494895;1;110;103;205;65;82;565
041625388729;1;88;107;293;115;116;719
041964263510;1;268;243;284;76;74;945
081971950753;1;161;237;159;109;169;835
045945440557;1;274;215;163;72;126;850
056044966815;1;188;111;193;103;123;718
077437878746;1;278;232;137;111;58;816
080198207940;1;258;213;119;94;85;769
065881657321;1;168;159;171;80;127;705
010529687845;1;287;204;158;90;50;789
017867834416;1;216;147;205;58;71;697
058277304317;1;208;144;215;83;134;784
069666761957;1;228;177;244;67;149;865
001505003138;1;219;140;90;51;121;621
014186512144;1;216;214;288;95;104;917
045219163733;1;290;224;286;114;73;987
081233300779;1;229;109;239;88;108;773
016341036741;1;96;131;170;52;98;547
041755621308;1;258;260;162;70;160;910
044030662709;1;101;282;242;83;131;839
083068593661;1;175;203;221;91;88;778
081257341374;1;202;267;110;76;110;765
011681669090;1;96;123;238;101;94;652
044449073463;1;137;222;271;117;145;892
015122338796;1;196;85;205;92;109;687
093881155585;1;162;230;95;70;136;693
032979917181;1;80;285;129;63;53;610
035763477153;1;247;253;136;71;132;839
070504617520;1;84;105;194;92;161;636
016923417366;1;214;264;218;114;62;872
048310817444;1;188;126;163;77;63;617
043994614236;1;89;177;296;101;165;828
007639167860;1;220;192;207;54;173;846
067249396944;1;218;217;131;112;167;845
027564763103;1;253;239;239;114;91;936
010813705464;1;255;201;281;110;60;907
019385874163;1;223;112;254;113;86;788
008896614319;1;286;151;151;89;162;839
063984024703;1;121;80;133;84;66;484
058695786867;1;242;154;195;107;176;874
068459155032;1;114;191;281;54;96;736
056196031383;1;99;277;203;56;145;780
013601963962;1;201;263;205;111;135;915
036455109899;1;132;279;214;77;133;835
099679530340;1;97;270;154;64;110;695
044620472683;1;278;139;129;78;90;714
041887432538;1;123;212;280;80;96;791
019932829759;1;268;213;140;80;76;777
014299761969;1;109;148;270;81;169;777
051213057556;1;182;98;125;56;167;628
031318572814;1;274;284;273;79;91;1001
077742131663;1;213;215;187;91;54;760
006701768175;1;237;193;206;103;175;914
089146162064;1;267;246;119;86;65;783
015420901265;1;205;213;261;92;168;939
029276478128;1;188;206;216;53;141;804
090005435427;1;95;275;264;101;116;851
020337853214;1;89;85;111;78;88;451
032821310523;1;126;212;199;116;110;763
089040678819;1;82;101;223;65;143;614
038139693926;1;217;250;138;111;114;830
042208831940;1;103;112;243;112;136;706
010923699652;1;151;288;215;51;83;788
029635224571;1;133;99;298;118;167;815
000760964956;1;256;92;258;55;166;827
060892131852;1;254;177;128;70;156;785
023666351797;1;155;129;227;54;61;626
044814974450;1;111;207;199;75;140;732
051575596132;1;256;235;291;109;53;944
008146793828;1;239;287;90;67;118;801
066494205136;1;115;82;137;118;97;549
046798776789;1;100;194;156;98;76;624
000744539537;1;166;248;173;117;162;866
001527411682;1;283;96;171;119;50;719
000317656962;1;148;206;258;57;145;814
009682273542;1;203;115;146;96;81;641
018147319411;1;270;283;93;111;157;914
099333332839;1;185;172;91;104;134;686
065007677825;1;92;119;289;108;161;769
058359849427;1;246;131;286;119;173;955
058082867476;1;239;154;102;95;177;767
042921664559;1;236;161;218;79;52;746
032539876708;1;279;180;249;93;166;967
072204388048;1;228;283;189;114;100;914
059577177549;1;156;116;223;110;125;730
044739477989;1;122;170;177;62;126;657
037907108539;1;85;243;153;60;121;662
043544132936;1;265;202;174;105;103;849
072379460497;1;177;148;161;120;177;783
034754523991;1;268;285;294;80;164;1091
048009943257;1;263;179;260;111;162;975
079786671994;1;108;236;241;62;175;822
011015004962;1;288;156;184;58;166;852
082383602842;1;198;100;108;83;140;629
065430995369;1;233;280;106;59;155;833
005567110375;1;161;102;285;116;93;757
054360254477;1;95;134;254;66;123;672
023404780684;1;281;202;94;56;90;723
022145043113;1;145;238;248;102;114;847
005217013512;1;229;102;296;79;75;781
081919072869;1;109;187;291;50;165;802
026404930060;1;225;123;108;84;76;616
003690507052;1;192;171;185;107;98;753
069410378698;1;238;100;232;84;117;771
081466864795;1;248;127;256;60;178;869
029158633059;1;281;281;258;70;75;965
022099961891;1;181;146;298;95;153;873
063007915623;1;257;221;283;102;115;978
069353345848;1;103;210;131;115;170;729
008376907561;1;203;217;144;79;143;786
019262794506;1;253;135;296;103;96;883
032901128251;1;118;226;265;120;122;851
031677325564;1;109;235;272;58;87;761
053366060555;1;270;242;239;97;135;983
001768509430;1;233;175;144;119;54;725
005081196763;1;124;138;126;94;142;624
057190631510;1;248;90;100;78;119;635
014582592054;1;252;90;159;86;139;726
023748144483;1;134;188;239;53;120;734
041894067423;1;250;111;193;92;158;804
020179250201;1;237;101;133;120;116;707
049013523692;1;97;285;283;69;76;810
050364758735;1;278;143;234;51;100;806
053155824367;1;201;227;128;120;85;761
097769035974;1;274;231;235;120;60;920
064415118603;1;269;80;207;91;98;745
049014219875;1;175;94;167;66;164;666
000519800162;1;82;193;181;99;97;652
040945542699;1;104;182;214;81;64;645
093583755790;1;125;199;220;84;157;785
053863223334;1;134;131;278;100;60;703
021277596414;1;81;271;255;86;120;813
049595192984;1;230;229;201;96;99;855
012915030231;1;237;288;226;65;145;961
064154347614;1;212;185;101;83;178;759
038489136077;1;80;247;149;118;85;679
025618089849;1;151;99;131;95;170;646
070367616987;1;135;230;185;104;88;742
003225605099;1;286;160;258;55;52;811
067726957540;1;139;275;251;91;135;891
007930174902;1;199;266;178;82;69;794
008829106164;1;110;268;294;58;53;783
010580917826;1;95;162;114;52;81;504
058279891955;1;231;258;239;74;119;921
026304566778;1;245;105;247;50;145;792
046498447586;1;175;194;278;78;161;886
087466095701;1;161;227;137;113;176;814
027622983047;1;186;211;201;57;129;784
062908822810;1;139;202;108;96;129;674
025292198105;1;139;169;105;85;158;656
054355314363;1;121;110;123;54;81;489
012135509516;1;256;181;177;50;74;738
037947567172;1;187;87;216;93;82;665
060102318096;1;224;132;276;54;176;862
082166365694;1;139;225;285;85;114;848
080219212876;1;216;118;98;114;57;603
068619837840;1;105;122;100;95;127;549
097568390532;1;176;102;113;65;59;515
093077790529;1;231;115;187;52;88;673
029742861749;1;80;214;195;115;97;701
090836462857;1;239;235;115;104;168;861
084023920115;1;268;156;100;95;86;705
022333040990;1;284;82;199;83;133;781
020088061370;1;134;243;184;67;142;770
088743522643;1;225;168;295;99;139;926
095138430386;1;180;83;137;75;110;585
060387464078;1;185;222;185;103;148;843
044481282675;1;179;221;162;93;178;833
043125566830;1;105;281;225;63;114;788
005406969934;1;272;193;114;60;81;720
002674306984;1;114;112;277;59;61;623
084091069952;1;210;127;298;85;85;805
056314291879;1;213;219;177;64;78;751
046987600155;1;270;220;252;63;58;863
084126237914;1;105;113;280;90;157;745
052964710848;1;249;98;111;61;169;688
084338159650;1;227;187;149;117;113;793
065100917928;1;165;114;147;65;65;556
049348486962;1;158;127;227;88;160;760
028818008180;1;280;210;168;70;150;878
038922482576;1;162;93;231;52;151;689
025742902569;1;157;282;198;104;125;866
062160931243;1;289;154;296;111;59;909
072625186767;1;131;251;95;72;63;612
036601910492;1;237;274;141;63;150;865
061973133098;1;193;110;191;86;83;663
034076211486;1;187;219;184;119;102;811
041449604685;1;198;246;235;110;50;839
071873869962;1;196;261;247;53;141;898
084629817274;1;252;218;190;105;114;879
029131209952;1;148;90;205;102;137;682
061757682800;1;142;133;107;70;60;512
054273994555;1;225;115;174;95;109;718
086802433999;1;174;270;294;110;119;967
099284217352;1;273;226;179;109;121;908
080175926856;1;151;280;217;96;128;872
077129222820;1;178;288;293;97;87;943
052711930617;1;223;146;198;116;170;853
043568967767;1;93;255;231;72;168;819
016890676946;1;274;270;235;85;125;989
005402166268;1;225;257;300;69;146;997
020528705729;1;247;101;227;78;151;804
016784539948;1;182;267;156;92;145;842
027576320947;1;239;202;275;60;172;948
011928659018;1;134;272;151;72;128;757
014323251897;1;231;82;118;54;106;591
087096829730;1;93;96;119;85;162;555
004778937969;1;261;279;131;61;107;839
086794570012;1;125;154;117;104;68;568
003543453691;1;249;286;223;67;89;914
075666455459;1;89;167;215;71;60;602
014649957794;1;220;102;130;110;135;697
066302597357;1;98;93;252;63;106;612
072017035563;1;121;185;108;78;54;546
026688715330;1;156;247;209;108;162;882
084684480131;1;142;282;98;64;157;743
006626492461;1;237;103;234;110;73;757
051956755604;1;144;104;187;79;165;679
007046605608;1;110;228;137;90;57;622
026878413057;1;279;271;96;92;126;864
079815985363;1;253;261;173;93;123;903
033949888580;1;211;199;164;93;79;746
065269072198;1;134;253;116;91;112;706
029457563091;1;89;168;128;108;152;645
003461058513;1;158;233;256;72;166;885
026265360656;1;155;286;108;65;101;715
077049530717;1;217;172;258;112;51;810
032622526216;1;144;157;299;64;84;748
083879873046;1;116;117;255;83;147;718
087884484306;1;155;116;140;61;106;578
044966407524;1;84;120;132;74;100;510
047144781640;1;91;107;168;51;79;496
054827352864;1;149;236;161;57;62;665
039435582404;1;184;145;114;101;95;639
070560035707;1;153;88;172;58;84;555
073548067388;1;230;252;252;69;169;972
020644846027;1;275;110;152;116;120;773
036238455340;1;174;233;168;64;54;693
030656299066;1;170;194;291;118;152;925
032926811795;1;131;278;257;76;118;860
011896609579;1;112;134;206;63;128;643
092615574187;1;245;253;240;63;95;896
006773150453;1;127;126;264;65;146;728
025312276028;1;157;213;226;73;172;841
095563764082;1;155;285;297;98;168;1003
052252795488;1;283;260;179;83;171;976
032734961410;1;204;254;152;63;161;834
061067866053;1;124;192;233;65;169;783
093939911984;1;129;118;159;83;63;552
061146473223;1;113;83;134;65;161;556
087176901034;1;227;181;105;102;159;774
050479175465;1;159;102;232;75;173;741
070107971955;1;254;123;242;84;64;767
085842137521;1;127;155;238;55;52;627
042614433959;1;149;269;144;75;85;722
074987971764;1;214;177;225;52;95;763
071384352861;1;212;281;298;80;125;996
002147400658;1;169;127;101;86;158;641
073425197587;1;177;286;246;71;132;912
095518551229;1;141;284;213;97;69;804
069600246156;1;207;150;172;88;144;761
013162360804;1;208;84;169;55;84;600
061571483848;1;203;82;214;53;55;607
085372124944;1;286;173;212;100;138;909
022255556093;1;188;97;173;94;55;607
023268277955;1;287;201;139;54;157;838
026476052945;1;184;83;239;95;152;753
063148066717;1;179;246;145;70;55;695
059151758867;1;107;262;293;55;153;870
013416021380;1;236;237;158;92;77;800
028904592121;1;280;157;109;56;171;773
042184634895;1;233;153;149;100;164;799
073795988084;1;256;282;224;96;93;951
062007320072;1;232;132;211;110;177;862
079170736030;1;271;190;151;115;60;787
077820291889;1;276;215;143;96;127;857
018619801844;1;122;90;272;78;85;647
012548385596;1;223;210;146;92;137;808
094963686535;1;260;202;206;62;144;874
023308855293;1;165;134;198;61;101;659
083462258384;1;126;238;207;50;148;769
015728834480;1;80;279;247;55;103;764
069594294612;1;271;243;166;104;171;955
047769827189;1;174;102;140;71;75;562
015716352431;1;126;201;273;73;79;752
051480915419;1;122;149;229;54;105;659
004999670419;1;139;121;183;62;70;575
001548057724;1;162;92;242;58;51;605
032644953218;1;202;179;170;116;98;765
098843900817;1;259;268;127;53;162;869
028677345536;1;131;100;188;69;109;597
056253943504;1;259;269;134;72;110;844
078422027489;1;184;220;177;80;116;777
058278968631;1;235;278;220;116;106;955
016092547069;1;101;237;196;68;100;702
073317087105;1;268;132;172;106;79;757
099692668874;1;281;98;165;72;64;680
008840014623;1;158;99;180;79;63;579
015895536833;1;123;275;190;99;177;864
074510956018;1;228;89;144;111;135;707
075229812235;1;135;192;290;107;167;891
084345606122;1;109;185;136;79;149;658
080825188830;1;165;277;124;101;145;812
025039838136;1;197;106;169;60;153;685
002655326361;1;181;155;135;60;161;692
056001615746;1;195;193;117;111;128;744
047578918923;1;144;182;107;75;110;618
017515996749;1;100;87;292;101;145;725
047955470692;1;107;182;291;94;136;810
075145676607;1;255;181;284;51;137;908
056887959790;1;187;145;262;58;84;736
076646360319;1;205;180;135;50;125;695
094041274302;1;117;209;290;98;102;816
057078080372;1;263;178;142;100;133;816
049299017700;1;246;197;285;114;79;921
020554807458;1;263;87;167;102;155;774
093000459483;1;265;271;187;96;91;910
076067460234;1;153;157;229;81;135;755
029790180668;1;146;135;227;100;60;668
054267527846;1;146;136;144;61;124;611
097558631099;1;140;214;251;72;134;811
058983417602;1;161;209;241;113;96;820
030663483282;1;222;123;203;93;147;788
091043698867;1;200;137;168;80;173;758
047738941365;1;90;191;152;99;176;708
045602246256;1;177;283;252;110;70;892
078995683859;1;136;243;107;100;174;760
078230224417;1;92;222;295;93;115;817
091774019365;1;101;87;113;117;171;589
094100806338;1;188;166;242;68;155;819
058127993359;1;143;136;115;85;135;614
053218822477;1;284;240;228;60;69;881
089351945467;1;276;144;209;85;159;873
081388578352;1;237;101;148;98;81;665
087966566606;1;146;218;102;115;178;759
028647731955;1;292;226;196;65;76;855
084996681176;1;223;247;222;97;173;962
003369248457;1;235;123;257;52;169;836
030186933557;1;226;167;283;79;156;911
054619738527;1;240;144;182;57;130;753
020231250794;1;117;108;297;78;89;689
099767944912;1;105;206;197;72;59;639
084413243453;1;162;109;218;58;168;715
090589352977;1;268;170;265;116;121;940
074677434823;1;292;228;276;57;67;920
089054470572;1;225;110;235;86;174;830
042169604455;1;237;112;142;76;57;624
032392261557;1;222;186;167;105;121;801
087494963472;1;107;246;210;91;174;828
095463043875;1;121;203;100;84;151;659
024167496230;1;246;247;228;116;70;907
080836173877;1;256;248;181;65;67;817
043497651694;1;98;97;258;109;108;670
072120333483;1;216;171;116;95;168;766
088498961848;1;103;130;243;66;75;617
015928431465;1;161;105;141;103;75;585
065188185584;1;174;153;193;53;161;734
031253461943;1;224;194;142;81;134;775
034377234178;1;288;269;224;67;101;949
018217706912;1;273;270;245;75;147;1010
025066530791;1;81;131;199;109;122;642
068240981261;1;186;250;245;87;71;839
096836209621;1;201;91;234;110;59;695
005489235496;1;191;174;261;74;163;863
048666315136;1;105;217;273;101;120;816
007020525759;1;253;184;162;109;163;871
015346747003;1;283;83;227;95;82;770
067208660415;1;135;192;161;104;108;700
036193270422;1;221;248;103;80;116;768
042727171565;1;98;212;264;88;178;840
092015849765;1;264;284;156;107;164;975
070089720675;1;163;177;145;105;119;709
045968666617;1;92;126;94;81;81;474
068956845975;1;253;236;121;120;98;828
066297507753;1;146;235;180;109;116;786
083688454300;1;136;179;110;53;164;642
014347591343;1;228;181;171;103;101;784
029306488800;1;196;243;142;75;54;710
084561352426;1;186;205;231;88;84;794
072938560022;1;87;216;92;72;91;558
068899730730;1;183;275;238;102;59;857
051604927120;1;282;95;163;79;112;731
091545280382;1;126;256;171;113;80;746
022631658905;1;224;125;162;104;155;770
008952387653;1;107;189;90;76;85;547
026817292307;1;117;275;193;90;97;772
079487917353;1;210;241;144;116;147;858
017894571179;1;175;175;137;98;56;641
070147100250;1;215;213;286;100;153;967
094060414482;1;104;164;234;120;63;685
091608934928;1;132;131;192;54;129;638
013502788375;1;119;272;165;70;172;798
097233684661;1;227;237;238;106;139;947
086998999722;1;212;149;263;116;175;915
010176993442;1;112;198;238;82;54;684
027885335689;1;178;254;210;100;177;919
048402308628;1;246;157;242;72;155;872
024456830940;1;193;105;145;87;133;663
009774497119;1;292;242;142;111;83;870
003406389472;1;283;272;137;93;76;861
059565868646;1;271;154;270;97;69;861
088356113627;1;232;110;180;80;118;720
043820401617;1;113;176;221;70;116;696
027693002283;1;200;131;132;73;167;703
098356613776;1;88;275;182;115;96;756
043093409107;1;208;122;113;111;70;624
042192646275;1;290;195;96;120;171;872
065457691324;1;192;239;253;50;72;806
077578369128;1;210;133;216;81;104;744
088464321673;1;130;276;94;112;132;744
011595017174;1;198;175;275;55;134;837
044395141253;1;106;281;250;75;81;793
026613036469;1;169;133;146;73;166;687
026182036195;1;196;105;268;56;83;708
061087579511;1;257;176;276;118;114;941
034834318248;1;269;181;177;92;119;838
086918122559;1;136;280;280;57;98;851
088069381344;1;118;85;296;86;92;677
019039713288;1;209;181;274;72;162;898
054156274078;1;82;239;285;80;108;794
077627615321;1;223;205;226;58;91;803
054625633428;1;196;81;200;117;89;683
072022243960;1;167;240;151;63;54;675
042941886992;1;220;130;125;94;82;651
068715949198;1;134;197;203;78;110;722
049859556204;1;284;137;292;91;170;974
089573544721;1;149;287;117;85;126;764
047889691616;1;133;250;165;119;102;769
044356021411;1;288;123;211;93;118;833
061620242135;1;103;166;138;95;112;614
066281745322;1;180;235;104;103;113;735
022837993727;1;242;240;259;101;77;919
048393037998;1;99;273;261;75;80;788
086565076328;1;180;233;241;83;105;842
061815814917;1;247;232;210;111;160;960
045017435813;1;118;191;295;60;174;838
062421542268;1;192;198;220;76;118;804
031771826818;1;129;259;241;82;130;841
071343124826;1;262;229;139;78;55;763
034130626940;1;103;90;236;76;135;640
083305941271;1;147;239;142;95;159;782
066914120078;1;198;213;183;119;120;833
057760307805;1;169;220;272;112;99;872
076327534649;1;123;213;205;57;71;669
085855860240;1;99;85;166;86;143;579
069943645550;1;194;193;100;108;156;751
023134331746;1;202;90;139;66;69;566
086903115287;1;201;245;148;91;166;851
077449188192;1;242;269;267;100;136;1014
054226473294;1;122;188;201;86;130;727
056530437382;1;162;95;122;93;146;618
096750517229;1;212;102;295;93;97;799
097306172827;1;232;191;187;53;84;747
030204233577;1;249;222;300;105;132;1008
052753113176;1;259;103;174;60;54;650
036959279954;1;253;145;267;63;167;895
069820843814;1;255;175;152;74;78;734
027418981070;1;282;253;234;53;78;900
024853700475;1;169;247;278;92;116;902
061625497363;1;216;98;162;105;85;666
079165823099;1;188;160;238;87;166;839
018779893985;1;118;101;234;83;50;586
043794162442;1;250;242;235;75;113;915
093395310111;1;130;196;104;97;87;614
098768638348;1;134;206;201;54;70;665
080767132180;1;84;166;292;120;139;801
067113338786;1;98;115;239;91;161;704
094047884571;1;152;109;172;66;58;557
068818620187;1;146;220;97;118;161;742
069902859817;1;165;228;284;94;172;943
086228088840;1;248;134;289;78;148;897
047886429836;1;130;159;254;115;103;761
049068361078;1;205;181;267;65;150;868
078310040180;1;185;138;187;70;81;661
030024073353;1;108;116;285;67;76;652
067994054306;1;167;143;231;69;95;705
003191793678;1;218;266;297;66;157;1004
051381343254;1;81;82;180;119;161;623
098396375251;1;290;199;205;72;62;828
026153541812;1;220;208;285;91;146;950
007243257852;1;287;207;291;90;165;1040
031692741365;1;131;142;265;109;69;716
068631957031;1;146;116;199;107;92;660
075142658754;1;147;90;252;66;97;652
042075896802;1;195;225;124;91;97;732
082943452483;1;282;261;282;116;166;1107
088231640931;1;105;146;96;53;147;547
046699426572;1;211;100;236;93;68;708
088437723597;1;237;195;125;101;143;801
043814770113;1;161;102;130;77;87;557
067093078206;1;267;162;256;113;137;935
046128432419;1;235;174;293;59;71;832
024213327438;1;206;159;93;57;73;588
028778053552;1;253;100;113;97;130;693
033127988539;1;96;261;262;100;173;892
061774346297;1;178;85;213;107;139;722
072142865292;1;225;231;108;70;146;780
053185274408;1;96;226;140;102;150;714
040599969306;1;217;229;263;75;60;844
056974422562;1;267;235;249;103;144;998
084394075739;1;158;255;172;52;66;703
055177562378;1;163;195;90;107;62;617
063281904686;1;289;139;191;101;148;868
006809394755;1;276;232;90;85;163;846
059731159526;1;186;182;292;83;155;898
034809403873;1;254;282;246;78;95;955
004110585153;1;109;224;225;106;92;756
045493265523;1;114;131;173;79;171;668
053941753446;1;112;160;225;51;122;670
036509497108;1;222;114;193;84;53;666
046291709587;1;139;230;161;118;118;766
039667068164;1;285;159;167;63;172;846
093229927922;1;232;165;165;79;83;724
051300249323;1;152;276;95;119;111;753
045161149371;1;278;190;284;66;50;868
002021826965;1;208;282;117;94;138;839
089975174838;1;109;190;258;99;69;725
009702826114;1;136;104;241;100;165;746
060766747896;1;208;202;262;51;159;882
088910020964;1;217;156;291;51;158;873
022905743643;1;87;245;220;68;54;674
036743139678;1;260;103;227;53;161;804
063178831737;1;102;128;187;81;171;669
041269243776;1;215;157;288;61;108;829
024095113155;1;246;129;215;50;176;816
079293751128;1;240;111;238;109;133;831
031677378178;1;292;143;206;72;114;827
017442900753;1;211;206;266;106;153;942
082686043161;1;98;201;224;89;123;735
019431370484;1;242;262;279;104;156;1043
052196191802;1;146;103;272;79;73;673
023926825758;1;197;167;208;96;170;838
002668665359;1;280;238;221;111;117;967
022276549132;1;111;216;106;107;166;706
064413165575;1;204;115;109;111;158;697
049725494927;1;144;173;228;64;155;764
047448873455;1;225;167;178;87;131;788
093977145264;1;189;146;115;77;140;667
057025248588;1;156;267;245;69;131;868
063316583264;1;85;235;200;61;150;731
052378045966;1;265;243;193;65;106;872
036015785393;1;192;143;94;92;77;598
069833806381;1;170;245;161;100;134;810
017918167697;1;89;243;216;86;105;739
019588094174;1;270;232;181;72;72;827
057061830817;1;267;197;193;120;92;869
097116923380;1;292;91;224;61;89;757
053449019972;1;122;264;249;115;95;845
096880959761;1;212;90;220;83;57;662
036115567450;1;244;209;147;79;97;776
083285054593;1;103;125;147;98;110;583
032801963423;1;157;247;159;99;128;790
033896291973;1;193;162;150;92;95;692
062711615823;1;183;252;190;120;110;855
055738821768;1;118;202;92;103;65;580
077076838132;1;220;237;105;110;64;736
035267756430;1;248;241;250;104;91;934
060038073031;1;202;100;194;98;175;769
024614285524;1;292;126;203;58;79;758
032294822664;1;104;282;159;68;126;739
009880071663;1;175;129;124;65;94;587
025963392285;1;214;125;90;112;97;638
025837985797;1;184;247;185;51;112;779
055493812880;1;111;172;185;73;70;611
072043722706;1;225;110;222;119;87;763
041907850537;1;250;181;105;52;57;645
044236300544;1;172;138;294;69;152;825
064759122077;1;291;212;200;57;103;863
011959123097;1;107;209;266;88;58;728
010995981845;1;196;158;269;114;174;911
030296245980;1;80;148;133;112;65;538
026442754421;1;212;254;278;100;161;1005
063428527977;1;200;257;246;106;172;981
012187134486;1;131;208;289;96;172;896
096653568213;1;163;121;189;111;61;645
085100823207;1;110;246;269;78;97;800
038066561148;1;161;92;281;63;160;757
092071056388;1;256;99;293;101;176;925
079318536771;1;99;274;120;107;166;766
055631624276;1;203;239;185;100;116;843
008496618990;1;90;127;274;118;174;783
019928141748;1;132;242;151;51;165;741
095359542218;1;260;218;124;105;94;801
009220607910;1;242;137;246;79;105;809
045219470927;1;188;183;254;114;89;828
043195008131;1;270;191;270;104;115;950
062200031585;1;179;272;292;106;135;984
023570717288;1;269;249;163;84;128;893
080507609960;1;276;81;177;102;99;735
087011582325;1;142;155;282;108;118;805
001091814752;1;176;101;98;88;127;590
088204979197;1;213;279;197;99;80;868
017081645298;1;224;252;162;62;116;816
031344908378;1;255;216;170;67;127;835
093167602774;1;169;210;202;120;131;832
028922751160;1;181;87;226;72;108;674
049401674783;1;171;172;188;52;161;744
040851204493;1;117;123;120;74;91;525
046338581575;1;107;282;160;76;93;718
091706210348;1;246;80;202;64;56;648
012556337539;1;154;270;153;62;84;723
095542065877;1;109;142;184;110;129;674
034334000592;1;97;164;207;120;173;761
071396064348;1;222;204;119;119;156;820
023578268198;1;260;248;265;90;164;1027
067750710291;1;270;288;280;93;161;1092
086002444650;1;280;116;252;118;162;928
020107584490;1;240;114;110;100;128;692
062290429812;1;289;165;181;71;113;819
092168518438;1;268;191;295;81;80;915
095438111162;1;147;115;278;83;84;707
099827329381;1;260;238;159;106;164;927
063877385695;1;235;241;238;79;163;956
082682598330;1;94;176;173;115;90;648
043235146447;1;84;221;180;53;152;690
004048178566;1;271;132;300;80;158;941
070198687403;1;118;241;97;70;156;682
073661831640;1;263;87;138;81;92;661
062295730204;1;129;208;200;102;138;777
085568045363;1;139;136;115;80;71;541
029146988006;1;230;215;119;78;118;760
067750369293;1;207;99;186;68;149;709
037256943311;1;110;101;272;57;52;592
098336691241;1;198;246;246;74;154;918
094122423605;1;171;266;280;100;94;911
052393531434;1;251;210;243;61;91;856
055604332361;1;144;278;183;67;105;777
003696281787;1;274;211;293;73;148;999
095791195754;1;135;230;271;110;63;809
097571286809;1;276;234;218;101;81;910
072626759520;1;179;114;284;111;158;846
024723436739;1;246;235;182;98;66;827
071231952540;1;200;254;163;66;108;791
066119300286;1;203;90;237;87;85;702
080575940028;1;253;185;137;52;96;723
083899160128;1;142;249;95;66;128;680
066932289408;1;109;120;156;79;158;622
045907074404;1;214;237;191;85;145;872
021908388667;1;122;153;110;77;84;546
033202147983;1;89;159;218;88;178;732
078859132823;1;167;175;164;89;82;677
033970765388;1;155;145;128;73;77;578
091195179432;1;112;138;174;85;174;683
067788351328;1;155;187;113;100;94;649
011271566060;1;282;97;165;109;127;780
040368403415;1;152;148;227;73;176;776
021080158994;1;236;177;180;63;142;798
059047319815;1;226;257;100;108;70;761
034255150364;1;123;156;173;62;178;692
076958617324;1;140;222;172;119;58;711
017222508838;1;175;186;147;102;176;786
097414601337;1;240;275;164;79;115;873
066819178544;1;200;240;103;54;112;709
030980925536;1;254;138;195;109;71;767
026100874021;1;96;166;187;95;115;659
014614550278;1;207;280;238;85;171;981
035962560915;1;136;80;143;72;137;568
017706111798;1;154;158;284;94;178;868
069275221104;1;222;253;231;105;135;946
058644472711;1;186;80;295;85;161;807
043465956894;1;162;274;136;50;118;740
027581539982;1;116;86;236;102;85;625
043968389393;1;107;162;204;107;146;726
073608476426;1;255;110;188;94;148;795
021332030329;1;87;112;257;84;97;637
016065328684;1;159;280;141;83;72;735
090408732212;1;80;155;158;105;106;604
077105147003;1;261;132;244;54;61;752
089782571211;1;186;160;222;87;76;731
076954309254;1;85;256;237;77;125;780
040373760670;1;149;94;205;88;174;710
025491821458;1;129;241;236;80;109;795
001743751195;1;137;177;242;86;74;716
075357962980;1;156;96;202;81;84;619
025505827877;1;257;147;161;90;76;731
023136260457;1;227;93;168;74;56;618
007961617086;1;84;263;167;116;97;727
023279199404;1;211;121;111;58;150;651
082041661448;1;156;237;205;88;55;741
051982193057;1;228;231;281;81;121;942
031161246603;1;209;111;149;70;54;593
090026315605;1;282;225;286;82;69;944
054089473119;1;105;91;213;85;163;657
030972191239;1;178;144;289;108;135;854
038360746959;1;262;183;121;57;57;680
020771266247;1;202;132;211;105;101;751
025201439646;1;221;105;258;57;65;706
049283410620;1;202;239;224;105;130;900
009823019192;1;253;252;224;102;134;965
076013919087;1;133;196;236;84;166;815
043375844289;1;252;146;246;61;104;809
013760225047;1;177;112;271;93;75;728
019776065643;1;180;220;172;79;102;753
019533124282;1;159;80;110;86;110;545
001210032839;1;277;154;210;100;147;888
050190019385;1;155;180;224;119;81;759
043672762319;1;203;249;203;98;81;834
048359326557;1;129;200;159;82;135;705
047036164134;1;148;213;205;113;122;801
086399350585;1;151;180;288;63;110;792
076774153903;1;284;122;108;80;95;689
099862788465;1;207;110;99;85;133;634
051779080171;1;163;141;202;59;74;639
040532262070;1;211;224;124;86;76;721
058038718412;1;124;85;177;106;166;658
019676889352;1;137;204;269;101;168;879
092257937382;1;274;227;266;68;59;894
021382676211;1;178;242;232;64;80;796
016067415191;1;284;144;296;117;111;952
097905244921;1;98;276;300;70;133;877
070715231175;1;125;208;298;63;56;750
076103947756;1;140;249;272;100;77;838
032106205529;1;81;95;176;78;158;588
059425746009;1;221;158;159;53;160;751
059844675707;1;81;105;94;75;154;509
036022785039;1;150;264;287;63;86;850
033417804142;1;129;100;113;111;162;615
062438182151;1;285;132;109;117;66;709
030132803173;1;285;282;96;56;113;832
073555696846;1;194;169;272;66;130;831
053577149025;1;268;267;166;97;64;862
004713125441;1;206;111;210;93;114;734
a;1;130;214;291;57;150;842
082371892457;1;161;129;284;65;88;727
021090850366;1;154;221;274;115;114;878
079461752006;1;196;107;191;91;74;659
044508613380;1;254;235;116;115;51;771
041553332232;1;163;250;282;103;91;889
096321718295;1;283;140;176;99;144;842
031523883519;1;247;158;131;74;111;721
075445722138;1;151;260;133;61;58;663
019347500451;1;164;200;259;57;119;799
039802729581;1;130;155;260;101;122;768
044852721907;1;179;239;158;90;62;728
027120176169;1;117;215;294;55;162;843
055164436126;1;91;141;124;99;123;578
092189211515;1;233;109;91;116;50;599
069885232500;1;289;129;208;54;141;821
034509727299;1;228;283;206;120;126;963
096333231047;1;203;134;153;68;106;664
010511576489;1;147;148;193;96;175;759
058923151007;1;149;169;136;79;141;674
033678474471;1;148;141;91;51;84;515
022616731906;1;205;220;227;113;66;831
073190653489;1;211;166;171;87;90;725
020110709382;1;269;118;204;69;67;727
003623185396;1;133;243;210;108;173;867
008737816325;1;234;165;283;50;69;801
014351267700;1;149;226;271;87;102;835
047929396989;1;189;253;102;105;100;749
070147859077;1;140;157;199;53;56;605
012933012651;1;175;162;185;81;162;765
084880210647;1;166;115;110;53;55;499
074885130652;1;142;166;251;98;94;751
092468746671;1;193;232;150;101;153;829
093338797954;1;210;80;140;51;127;608
019549174927;1;251;138;189;63;80;721
028906628292;1;222;203;257;83;105;870
034645169236;1;228;152;163;117;65;725
026367448094;1;96;210;254;82;162;804
074932965884;1;236;224;134;117;102;813
004839708600;1;122;156;296;102;112;788
030988064788;1;174;206;153;96;142;771
017544382083;1;145;83;151;58;86;523
081475776765;1;197;243;135;71;131;777
020001688530;1;237;131;165;110;110;753
082531992181;1;135;160;186;78;70;629
099661055053;1;84;234;120;68;144;650
024351685060;1;115;235;232;116;135;833
004584808545;1;260;284;210;70;148;972
076271723586;1;218;136;116;71;125;666
062410153753;1;227;199;141;83;73;723
090653720764;1;274;141;154;89;133;791
085252786308;1;120;269;237;73;66;765
031249413167;1;148;252;229;107;106;842
019588715987;1;90;81;278;89;61;599
043898059225;1;249;201;99;51;64;664
035818753078;1;88;171;163;84;137;643
083719263048;1;212;92;248;117;53;722
008271336416;1;225;171;279;86;107;868
013348695505;1;178;280;172;118;130;878
079179004434;1;286;131;234;116;75;842
042821896821;1;147;251;114;51;55;618
066140473407;1;176;157;218;71;178;800
036022970505;1;245;253;227;50;123;898
021504461060;1;205;170;128;112;93;708
097255689483;1;82;261;186;111;124;764
040808881165;1;104;227;123;102;123;679
029734967722;1;142;174;131;78;148;673
095832761996;1;195;197;90;67;83;632
056239454515;1;276;131;212;99;81;799
059828765361;1;276;239;232;94;157;998
068080632113;1;238;242;181;73;67;801
086142119931;1;87;187;184;67;52;577
089939376668;1;243;116;228;82;120;789
039940998682;1;182;285;202;89;121;879
068165997371;1;139;278;100;82;149;748
086393886035;1;86;89;113;62;178;528
052279985496;1;181;155;297;115;128;876
083303357201;1;119;240;156;98;95;708
064966363484;1;145;288;285;104;175;997
009638849383;1;109;134;276;90;116;725
034426092896;1;214;285;97;52;166;814
061174959116;1;176;242;279;97;107;901
060350439842;1;156;84;170;56;96;562
021969098793;1;153;227;227;98;94;799
067569677015;1;82;187;158;89;116;632
045118141972;1;246;88;250;77;178;839
039046189595;1;267;111;276;75;90;819
034128931391;1;268;244;266;92;114;984
023222381425;1;155;272;281;119;144;971
019510825525;1;119;82;164;92;146;603
063527595353;1;200;198;267;87;98;850
083395606814;1;264;158;183;53;126;784
082356557961;1;233;116;202;117;109;777
085795600039;1;172;181;227;60;173;813
051248963211;1;88;255;101;112;120;676
033765365417;1;84;214;295;67;168;828
073106404849;1;256;193;242;90;56;837
002383527828;1;218;223;119;57;66;683
000593149192;1;181;284;187;78;124;854
022939341775;1;165;223;297;66;117;868
037520956017;1;243;251;262;75;135;966
030239966075;1;87;209;174;111;142;723
011846221216;1;84;240;288;71;59;742
024221878014;1;265;229;233;99;76;902
010114745158;1;174;228;245;98;52;797
053283840889;1;168;215;129;96;54;662
082395984227;1;171;209;236;107;105;828
003737374668;1;261;166;177;88;71;763
024096218352;1;123;186;127;58;121;615
012665463857;1;235;98;285;96;133;847
054822369316;1;122;239;218;65;159;803
059167088217;1;203;218;242;91;147;901
019914830775;1;240;274;236;108;93;951
069387981468;1;271;82;169;115;174;811
018630106546;1;230;108;168;96;71;673
042840155082;1;175;124;180;71;84;634
091179749927;1;135;244;158;106;151;794
028560265865;1;137;283;208;94;107;829
042545196978;1;101;134;225;71;76;607
080526138293;1;134;132;105;97;112;580
014000083203;1;108;136;272;64;86;666
075921548517;1;185;150;113;65;140;653
096069248005;1;98;269;115;98;90;670
032041879958;1;108;250;224;77;84;743
003343704913;1;289;280;220;118;80;987
029732761718;1;290;207;194;76;141;908
072418863832;1;81;189;293;70;157;790
073258309019;1;186;182;188;54;162;772
072756883297;1;130;96;151;74;138;589
095671693035;1;85;244;274;96;55;754
047515824296;1;286;148;198;100;173;905
056718092459;1;230;207;137;95;95;764
056434836656;1;223;176;97;89;62;647
010268029606;1;98;166;262;59;101;686
014147387620;1;147;90;282;88;122;729
078426602870;1;222;223;236;116;115;912
078620047125;1;98;285;152;55;145;735
018769594846;1;87;154;106;100;137;584
075626255661;1;271;83;249;90;176;869
087410963208;1;229;158;150;67;126;730
014644752990;1;282;177;265;68;173;965
060013691500;1;238;276;232;74;141;961
028505363525;1;107;181;166;54;95;603
040252282809;1;284;85;200;110;89;768
001017791027;1;141;115;285;69;148;758
060264380092;1;278;202;106;119;59;764
081534799485;1;111;243;99;99;147;699
029661124526;1;89;179;163;61;176;668
021993365147;1;127;216;213;117;56;729
019694815060;1;128;101;132;114;119;594
002596520005;1;266;83;215;64;97;725
000534581207;1;241;211;149;71;107;779
003159050339;1;178;281;231;75;123;888
014396182240;1;181;288;147;67;90;773
093053600002;1;213;215;269;59;112;868
055034444638;1;140;268;230;104;107;849
027282376797;1;269;264;158;109;104;904
001473133376;1;286;252;231;54;121;944
004906044101;1;177;270;122;79;172;820
029550212566;1;241;112;287;105;107;852
001858844423;1;80;139;245;50;50;564
092023551385;1;223;104;280;75;84;766
089782229324;1;259;217;260;53;148;937
022448384286;1;86;249;187;85;97;704
005182119319;1;272;269;285;62;60;948
060740560037;1;93;105;227;94;109;628
031330958387;1;173;205;158;87;83;706
096054905671;1;251;154;144;62;85;696
031303138471;1;243;118;292;83;92;828
022371215920;1;214;163;190;93;102;762
080611754391;1;196;120;207;101;54;678
069511500326;1;277;213;228;90;51;859
031735722326;1;130;239;157;94;134;754
003609433472;1;169;140;228;75;71;683
050835981706;1;133;93;97;87;93;503
016512592695;1;283;210;158;90;117;858
050735717147;1;170;214;241;100;133;858
043061799291;1;223;151;208;53;78;713
040809175121;1;197;222;132;63;139;753
092076806228;1;197;208;269;74;52;800
019846348430;1;250;254;156;77;148;885
010457292966;1;167;108;296;90;52;713
071653648381;1;196;230;159;65;154;804
099545214319;1;102;94;106;57;87;446
030092526919;1;80;205;211;95;85;676
048373125655;1;280;199;299;117;158;1053
031700857711;1;210;224;154;114;118;820
020269476059;1;92;211;112;74;97;586
025919553506;1;99;116;220;58;61;554
086862981009;1;99;143;208;84;93;627
030695096015;1;97;285;155;63;149;749
064845598466;1;116;154;198;61;129;658
014000379175;1;146;248;195;113;82;784
087647270831;1;160;120;195;107;66;648
059353943682;1;94;84;272;61;75;586
049126321437;1;256;279;171;53;74;833
016119088747;1;168;268;122;102;61;721
048527545347;1;92;241;100;54;50;537
081410587361;1;213;198;103;90;108;712
070207171162;1;81;164;239;98;80;662
029427329605;1;221;146;165;114;136;782
039972453924;1;257;274;270;98;169;1068
080766893873;1;130;134;157;113;105;639
054412605180;1;290;189;153;75;60;767
009796096085;1;260;102;168;101;149;780
052257687008;1;86;89;176;104;120;575
041307605711;1;174;256;197;82;104;813
083154708939;1;157;260;140;102;164;823
069576231842;1;188;171;202;112;135;808
074165170084;1;116;226;283;54;91;770
051134344920;1;217;186;175;101;67;746
052863408144;1;102;264;189;72;131;758
056988855913;1;163;146;271;103;136;819
054298137480;1;117;288;195;89;175;864
023802164405;1;90;237;162;92;89;670
040164899331;1;276;216;101;73;176;842
001369883707;1;111;102;276;55;141;685
079564597060;1;288;162;289;104;131;974
023942549190;1;125;221;132;99;166;743
051361595031;1;163;264;235;100;76;838
000683342574;1;249;126;162;70;105;712
047991897043;1;207;132;228;112;146;825
081097514306;1;254;116;134;69;109;682
064606875109;1;96;244;143;60;57;600
018649900801;1;283;147;287;118;165;1000
054243628210;1;96;215;278;54;131;774
040646204518;1;204;124;97;53;157;635
035650923127;1;224;104;131;84;128;671
009891458368;1;133;238;139;67;68;645
049654054588;1;121;138;277;97;153;786
029877434150;1;162;213;291;63;146;875
009757443864;1;137;266;198;75;119;795
065515386495;1;267;132;281;109;132;921
030490359072;1;151;189;263;117;54;774
041186974834;1;136;139;176;63;141;655
022886665379;1;231;220;252;98;125;926
045854070075;1;212;163;250;100;92;817
043996857759;1;212;179;108;56;160;715
056793631508;1;282;274;172;87;149;964
059016080604;1;282;257;137;51;62;789
095541872711;1;238;137;290;117;138;920
035673023321;1;249;166;151;94;167;827
088119319241;1;118;145;294;61;133;751
035258276663;1;246;128;99;53;170;696
028079441562;1;169;213;238;93;60;773
041136587607;1;224;243;207;106;126;906
068853894092;1;284;279;135;68;178;944
035413140179;1;227;240;262;106;103;938
013613725398;1;203;92;133;83;148;659
075074718329;1;96;262;279;58;76;771
003569973150;1;217;222;239;120;104;902
088168261120;1;95;203;227;109;152;786
080325651571;1;156;265;243;76;82;822
031320843269;1;104;247;108;63;134;656
070157655219;1;254;257;232;119;56;918
035290644710;1;85;130;228;54;95;592
076872030020;1;140;147;201;76;144;708
049150485838;1;286;177;148;69;57;737
047036858656;1;276;108;175;72;149;780
007167700088;1;151;226;101;110;91;679
062160000761;1;280;216;162;102;53;813
062119669072;1;251;276;237;61;148;973
044392622988;1;227;259;163;50;84;783
076975239387;1;84;141;102;102;53;482
002450712827;1;181;219;283;98;135;916
082605337577;1;277;177;245;84;164;947
080292534207;1;275;224;104;120;135;858
042118880521;1;122;192;148;63;73;598
032517453326;1;203;278;146;113;142;882
016627489072;1;184;137;166;98;89;674
029526499429;1;112;117;132;56;150;567
006964735953;1;218;134;152;78;141;723
016006393551;1;233;262;224;102;149;970
002511403500;1;145;140;206;70;111;672
090308984165;1;278;213;120;61;69;741
006017504480;1;252;178;141;80;79;730
043240554151;1;249;269;282;77;153;1030
074690485071;1;238;283;143;75;125;864
093612108850;1;263;81;285;110;102;841
059995465101;1;263;83;127;93;172;738
079056039916;1;196;130;286;107;172;891
086776773136;1;285;99;262;70;142;858
016107087669;1;116;109;204;110;55;594
091189688801;1;231;137;205;84;121;778
089426737552;1;288;209;169;69;103;838
039284619194;1;140;169;187;53;58;607
029312244396;1;192;198;123;94;158;765
011518208537;1;248;170;218;117;141;894
083434507103;1;172;163;109;105;138;687
092242082747;1;159;288;168;68;117;800
099743566369;1;208;94;90;81;67;540
091671856118;1;130;210;106;103;151;700
055799457613;1;202;205;175;105;78;765
046874593249;1;228;264;182;85;122;881
030749014853;1;97;185;163;65;108;618
046897191265;1;198;178;166;109;58;709
061483354130;1;96;166;203;98;125;688
043698242039;1;292;199;152;58;169;870
003970755221;1;260;287;252;87;128;1014
092457823243;1;187;237;279;51;150;904
080873893995;1;190;143;234;99;106;772
088900759118;1;234;240;211;73;72;830
012861075194;1;103;87;274;74;174;712
021108334594;1;191;214;264;89;159;917
020229794983;1;274;200;189;117;61;841
067177972594;1;178;83;255;60;171;747
013237135266;1;244;134;176;95;136;785
057201464275;1;185;261;136;55;64;701
055436962153;1;106;137;127;109;100;579
020026184692;1;255;148;246;120;157;926
043491575734;1;89;137;300;103;118;747
093257254646;1;275;242;174;76;162;929
064825611601;1;285;85;133;112;51;666
087143078795;1;236;120;244;115;82;797
011016787568;1;94;238;246;77;89;744
094326657094;1;265;287;131;77;98;858
017215433674;1;214;228;114;113;117;786
004196596930;1;132;116;111;66;135;560
014740447062;1;151;213;206;79;143;792
092323095724;1;116;153;216;106;169;760
043652535465;1;131;179;109;84;86;589
065196423030;1;292;288;285;88;94;1047
002028772343;1;106;140;283;52;126;707
098159309347;1;269;195;223;100;167;954
050041749472;1;209;278;283;94;152;1016
004501895417;1;101;261;184;54;165;765
086762504032;1;170;216;265;71;128;850
094354199584;1;119;219;195;110;123;766
018465549228;1;156;229;255;56;136;832
068669853330;1;154;257;156;62;169;798
082848537147;1;181;228;241;109;61;820
085761673870;1;150;260;223;70;178;881
090863090273;1;200;206;279;74;157;916
063177798295;1;189;186;234;64;167;840
025414390647;1;159;248;103;80;166;756
003459761738;1;262;128;235;64;99;788
073078459132;1;271;240;111;79;171;872
074434069217;1;201;229;192;75;158;855
004329566917;1;244;95;295;69;62;765
018371957950;1;98;237;280;58;69;742
023492596679;1;261;223;138;85;124;831
019274361099;1;188;194;221;106;105;814
079986295235;1;225;240;177;103;103;848
026878674708;1;85;211;292;84;61;733
041906707317;1;282;140;164;81;147;814
026931861306;1;217;254;129;55;112;767
066464713130;1;180;186;106;55;132;659
070277175618;1;242;169;164;119;97;791
047775164237;1;220;248;217;104;157;946
021190781952;1;211;118;286;97;95;807
056507597560;1;98;99;172;69;50;488
096460201394;1;156;245;98;97;109;705
063691931758;1;121;112;290;120;87;730
053196689655;1;197;288;225;86;160;956
020213010791;1;283;89;94;108;164;738
046149338834;1;257;286;248;64;148;1003
022408075054;1;188;115;137;110;53;603
009131197693;1;170;105;273;118;165;831
000973102455;1;156;273;202;117;55;803
062712847659;1;258;90;131;100;126;705
000683763937;1;269;202;106;107;134;818
028055830199;1;239;278;99;113;157;886
027466511888;1;190;210;90;97;161;748
022749062738;1;103;137;286;101;69;696
055491176650;1;218;113;197;85;69;682
026084976372;1;226;226;299;70;83;904
063730832900;1;206;204;165;76;60;711
087966654979;1;126;102;238;113;176;755
049801737491;1;276;241;171;96;158;942
066443023762;1;255;265;246;115;118;999
098331753289;1;135;200;150;103;128;716
023345559811;1;234;275;134;57;110;810
060276556018;1;239;142;165;80;175;801
088411753449;1;234;111;95;79;61;580
078550173721;1;100;238;174;61;129;702
010068066694;1;165;201;237;84;83;770
067201914305;1;114;230;256;73;108;781
075176560289;1;191;265;141;73;66;736
038498167737;1;290;104;225;73;69;761
028860356149;1;153;256;132;79;63;683
028382748467;1;285;106;149;103;60;703
021382848213;1;274;139;156;106;163;838
083985070795;1;258;153;298;54;126;889
062816951341;1;83;121;235;74;64;577
059353950178;1;210;104;90;105;156;665
019508325476;1;253;180;102;110;74;719
091246367155;1;90;256;278;118;52;794
063102007441;1;254;189;177;77;58;755
089400665440;1;136;95;195;82;164;672
048914859730;1;104;177;120;120;144;665
027716917737;1;111;215;105;104;113;648
059267431932;1;121;223;247;72;122;785
078264945770;1;206;225;185;103;113;832
024079958260;1;227;208;153;66;103;757
001145824755;1;169;219;281;79;76;824
098589983192;1;123;88;134;71;99;515
019219235500;1;129;126;283;52;132;722
012515746248;1;266;252;94;103;136;851
005987211286;1;104;152;109;117;156;638
063744048250;1;109;238;276;62;101;786
014428290924;1;288;138;222;117;104;869
097857846062;1;254;222;163;117;92;848
099197870003;1;154;151;160;53;95;613
066588432562;1;96;143;105;118;153;615
066068134935;1;276;212;107;100;69;764
086736473076;1;89;143;134;85;56;507
070758630641;1;202;205;106;92;152;757
047630526339;1;215;108;252;90;123;788
064325763098;1;166;258;102;84;119;729
072894510184;1;212;266;121;50;57;706
030121841210;1;140;146;160;88;110;644
057456703115;1;263;178;281;107;168;997
009210697604;1;214;85;274;85;79;737
065149079239;1;199;166;112;108;56;641
005046947234;1;113;87;235;109;161;705
069622065184;1;154;93;171;112;138;668
079520925124;1;81;252;183;108;107;731
069484041518;1;184;276;283;74;159;976
051082568545;1;90;253;112;62;123;640
013848678153;1;271;207;204;51;54;787
023376667875;1;105;196;124;90;109;624
014490718055;1;158;206;215;91;119;789
076536510374;1;90;192;248;51;178;759
055606993801;1;91;280;261;60;80;772
063830443549;1;219;247;116;88;92;762
065685571103;1;229;158;274;105;141;907
080648647129;1;107;131;294;75;137;744
043932966664;1;153;230;189;84;161;817
041192457405;1;288;285;182;107;163;1025
087610830256;1;113;127;227;56;80;603
050574229472;1;81;216;187;78;94;656
089768322049;1;146;270;113;86;126;741
079051164316;1;160;135;125;93;144;657
051395527049;1;205;134;209;115;57;720
001873494553;1;161;208;199;84;177;829
045341005426;1;152;280;190;88;113;823
099437877487;1;145;162;183;92;50;632
023119204840;1;128;284;180;111;160;863
056750213308;1;166;232;296;62;113;869
062926703369;1;158;253;299;119;86;915
031593451340;1;283;196;132;112;137;860
083342313954;1;90;213;269;92;107;771
033811541566;1;285;136;104;116;63;704
081994654128;1;80;215;163;119;52;629
027820453893;1;144;166;278;70;123;781
082871920482;1;259;89;282;50;52;732
088610321824;1;275;94;109;98;161;737
059593583016;1;270;249;245;95;154;1013
003786891641;1;228;82;102;95;54;561
032009512131;1;225;97;263;94;82;761
002236843326;1;206;127;227;104;169;833
024447216893;1;250;146;100;63;110;669
066751152944;1;184;137;215;64;171;771
005376691412;1;217;204;127;109;89;746
057825293743;1;84;151;97;112;113;557
019274660694;1;193;243;172;101;54;763
026374836740;1;233;140;126;104;59;662
011869005657;1;185;132;162;76;81;636
046060991749;1;102;176;179;108;62;627
032370924402;1;210;142;234;63;175;824
029833202387;1;219;167;178;51;176;791
095663823205;1;282;144;230;103;96;855
006276498112;1;113;268;120;68;86;655
033660295117;1;186;267;177;98;85;813
047587203694;1;287;154;118;111;104;774
013173779093;1;158;169;271;87;129;814
078189525482;1;244;134;232;64;98;772
084302149824;1;277;143;116;79;162;777
016678054113;1;137;285;217;110;85;834
090159402426;1;268;263;228;107;73;939
013160108432;1;285;175;273;88;90;911
022471909564;1;245;268;261;117;106;997
061293151300;1;85;156;179;57;79;556
019876977027;1;247;115;171;104;62;699
082717505244;1;286;114;155;106;127;788
002615966294;1;262;229;270;103;59;923
003790324365;1;245;211;139;64;54;713
086459421353;1;85;249;246;120;128;828
003907001959;1;189;236;122;66;74;687
053521875450;1;113;193;120;112;175;713
018894159671;1;228;282;293;55;158;1016
026017880605;1;173;156;234;65;104;732
029058896876;1;269;163;192;73;137;834
062025225682;1;291;171;288;59;118;927
010245257682;1;264;111;125;103;138;741
085595343251;1;92;198;247;100;86;723
030129879784;1;217;97;136;113;136;699
058042252868;1;218;91;216;69;132;726
078259789142;1;228;137;179;94;89;727
019112180362;1;198;176;193;81;58;706
071980029680;1;259;244;290;75;164;1032
011607417151;1;288;136;128;85;81;718
034418774676;1;154;92;103;101;67;517
099030241416;1;234;96;258;96;131;815
005550649696;1;245;270;178;116;168;977
066580647526;1;175;135;250;100;62;722
026598473640;1;127;190;158;77;105;657
035821251955;1;286;142;270;86;98;882
002580396781;1;214;268;165;96;174;917
044118172713;1;118;124;109;67;120;538
033368782896;1;153;82;256;97;108;696
010662760638;1;101;138;275;120;72;706
016076595830;1;158;183;184;80;176;781
018254448986;1;88;220;118;55;65;546
041283047691;1;166;227;187;63;173;816
037847841448;1;266;288;106;62;176;898
092259804013;1;146;95;239;89;93;662
092083387211;1;148;152;295;70;124;789
005387658455;1;139;161;116;51;99;566
057500142254;1;181;161;131;62;63;598
085637020148;1;136;175;175;76;178;740
066005283776;1;171;217;210;119;54;771
065419431270;1;129;270;200;65;107;771
093523075121;1;235;212;210;56;92;805
011287563685;1;94;236;104;72;56;562
044390320351;1;234;242;153;106;127;862
060121495272;1;285;270;119;91;171;936
032631506113;1;112;127;168;73;168;648
038030115315;1;218;193;197;102;94;804
026911778798;1;226;230;133;52;91;732
060077769910;1;202;265;195;79;148;889
089402444800;1;188;182;225;112;134;841
061122953327;1;259;197;114;93;175;838
090250359173;1;288;209;239;63;169;968
060781131962;1;242;139;125;54;58;618
002883580629;1;192;142;161;98;174;767
060701672493;1;254;90;293;73;147;857
055251649359;1;112;156;113;85;171;637
002594183415;1;222;217;204;54;59;756
012606920700;1;88;83;105;70;106;452
014881924698;1;212;173;237;82;82;786
039863758994;1;83;160;197;67;173;680
039660861459;1;93;83;126;79;165;546
042243312325;1;104;168;292;100;73;737
088481253126;1;167;201;113;75;154;710
089851372931;1;273;178;249;68;56;824
075859096072;1;239;168;102;72;104;685
034811417184;1;264;268;271;98;80;981
069199741688;1;191;87;267;67;79;691
001955992734;1;104;122;174;119;141;660
052230340407;1;214;83;99;91;144;631
090391464611;1;156;287;185;106;157;891
065892523817;1;243;273;106;108;116;846
062014949989;1;257;177;256;63;178;931
084294224038;1;227;194;272;77;138;908
067632118871;1;110;154;223;50;122;659
002507651118;1;222;240;219;105;121;907
042208918055;1;290;201;131;81;104;807
051025472823;1;181;274;114;83;127;779
021969568043;1;193;228;128;119;89;757
026735629562;1;165;281;167;70;50;733
035614263580;1;277;254;240;112;175;1058
052559277829;1;219;116;113;95;112;655
008771291599;1;175;113;250;56;57;651
028113269932;1;101;110;116;96;115;538
073470725874;1;84;279;197;63;70;693
008415809144;1;241;249;215;95;54;854
050444039830;1;84;140;97;119;97;537
039213636770;1;189;87;286;76;159;797
027650134866;1;127;193;266;77;109;772
084321063145;1;143;269;208;60;128;808
077375017742;1;230;243;122;65;64;724
006746799318;1;115;219;204;120;164;822
038889347707;1;139;202;291;92;162;886
025934389861;1;196;144;259;71;124;794
048963338226;1;138;148;236;73;119;714
069986489437;1;130;154;270;101;112;767
024688277425;1;285;88;268;52;84;777
000961248187;1;268;220;152;112;126;878
025772970663;1;270;223;91;72;52;708
032678083781;1;130;104;256;80;90;660
053019473149;1;291;173;212;104;62;842
035903172293;1;167;211;160;89;111;738
095742525360;1;129;88;193;70;132;612
020482426256;1;149;234;220;83;75;761
026880360304;1;171;266;207;89;165;898
019681391455;1;261;191;202;80;97;831
089405548045;1;99;169;232;69;112;681
077385951671;1;283;173;239;95;84;874
024438057642;1;229;117;154;86;139;725
056513431757;1;164;121;164;92;62;603
038933502693;1;203;250;262;112;144;971
094612496224;1;192;160;110;94;100;656
060316525840;1;99;144;184;59;101;587
051007177412;1;158;93;217;87;150;705
073512070153;1;131;244;247;100;55;777
044854413824;1;91;238;138;101;68;636
060384658719;1;118;217;199;108;129;771
043668517783;1;155;187;110;73;79;604
071240520322;1;180;265;179;60;55;739
096412782857;1;175;110;287;83;115;770
069707745145;1;284;262;289;55;98;988
099440832800;1;277;174;264;120;85;920
003953694073;1;194;110;257;71;115;747
060526793983;1;258;120;213;118;87;796
010977330555;1;250;280;113;55;71;769
023888530082;1;178;155;232;78;105;748
061507136388;1;247;237;192;64;111;851
033506389387;1;136;189;232;80;127;764
028430101408;1;196;261;255;54;163;929
025202677781;1;261;214;194;51;84;804
057836774644;1;105;93;232;71;156;657
021216166585;1;253;165;148;58;172;796
084892844236;1;110;192;134;111;75;622
063124483249;1;257;104;120;52;161;694
009505327974;1;202;179;115;58;102;656
064781843619;1;114;201;285;106;154;860
096755782896;1;133;91;110;65;80;479
039394682819;1;226;274;284;83;138;1005
052940148744;1;219;255;199;114;103;890
056375680151;1;127;229;135;106;132;729
026463670618;1;233;135;149;96;70;683
071789185812;1;260;246;245;63;167;981
013581667771;1;190;107;123;74;166;660
088648340648;1;178;217;294;106;130;925
010854722299;1;148;85;289;53;93;668
002932153750;1;218;184;139;58;80;679
013118543938;1;252;206;143;60;105;766
014097652157;1;177;270;123;78;138;786
026359243597;1;134;97;251;117;97;696
079614214579;1;195;287;232;60;126;900
003570113246;1;210;97;132;70;53;562
030728479964;1;90;189;128;107;110;624
064664757759;1;128;135;230;103;165;761
014086531630;1;288;222;280;93;90;973
032280095250;1;274;126;269;58;105;832
095395607874;1;280;181;143;69;96;769
012600234757;1;116;276;201;77;76;746
034281884917;1;222;242;261;82;67;874
041249618928;1;205;99;233;87;70;694
089126631281;1;175;90;122;102;70;559
001604159384;1;192;100;198;84;93;667
052159249129;1;289;194;270;65;69;887
096094667544;1;275;257;246;68;64;910
035640245494;1;139;140;226;119;99;723
041803310816;1;84;276;116;119;171;766
019197027249;1;154;109;155;109;111;638
011734137408;1;126;101;202;108;95;632
009226207937;1;272;162;113;78;167;792
006113228765;1;209;155;115;63;176;718
099396522823;1;177;194;174;88;103;736
042088588815;1;196;156;107;77;93;629
004049492146;1;196;107;104;83;137;627
080063458675;1;180;246;250;85;152;913
062856721293;1;260;224;276;83;172;1015
048528065454;1;263;187;173;113;144;880
098442681638;1;268;250;223;60;115;916
017602878303;1;181;117;116;119;125;658
080371548892;1;228;122;170;90;157;767
060985813284;1;108;243;97;105;106;659
050625620268;1;209;107;190;111;52;669
099858105995;1;292;171;274;53;176;966
024075404931;1;137;215;146;100;141;739
050581526024;1;188;152;156;56;67;619
061638644597;1;146;287;277;99;85;894
034577666336;1;102;181;228;106;115;732
012083360211;1;283;228;233;56;89;889
052383393050;1;151;84;188;80;55;558
079638759638;1;226;134;90;95;124;669
080137124442;1;231;119;123;80;86;639
095243761531;1;197;145;297;120;142;901
052781595934;1;190;225;129;109;78;731
016992156005;1;90;270;241;71;87;759
047017290914;1;253;237;112;81;166;849
011464628322;1;200;86;298;109;151;844
043517915677;1;287;273;125;51;153;889
068477035033;1;173;160;104;79;94;610
012178633230;1;248;217;135;85;105;790
073540927734;1;257;142;134;79;175;787
012857809807;1;166;245;260;60;53;784
008022521463;1;134;190;298;91;134;847
090806842677;1;204;214;120;110;167;815
089643144186;1;189;249;233;120;133;924
000536242276;1;159;196;168;92;141;756
007220944814;1;288;82;149;52;119;690
065833365203;1;134;210;237;108;123;812
046547629551;1;189;208;229;108;140;874
026110465584;1;251;204;298;94;156;1003
091494427240;1;219;129;260;73;127;808
054127694353;1;229;99;251;52;74;705
044655914576;1;106;146;164;90;94;600
041658611932;1;158;121;143;112;154;688
048239406885;1;109;152;283;60;165;769
004640189621;1;162;201;227;87;55;732
065854727034;1;133;171;156;85;146;691
000077185835;1;176;283;105;82;148;794
019091817926;1;201;147;248;91;175;862
014781154770;1;119;173;214;54;144;704
056090090768;1;285;172;219;60;124;860
095093486120;1;173;193;245;68;165;844
042825466646;1;111;230;133;67;88;629
046106961215;1;204;126;151;96;147;724
028603504020;1;186;160;254;117;162;879
043846960940;1;93;201;112;104;113;623
008046616234;1;145;158;249;98;145;795
084116510292;1;199;185;186;54;51;675
026109429958;1;156;196;120;85;65;622
091882994131;1;134;204;174;52;112;676
048590260474;1;216;184;151;89;119;759
077541792697;1;103;269;179;66;85;702
049742853590;1;248;122;252;57;156;835
033453153506;1;131;240;291;120;174;956
049032108183;1;104;90;145;96;177;612
076246495088;1;236;181;158;92;118;785
043856651893;1;154;159;93;79;141;626
019383708265;1;111;249;93;72;94;619
057627996993;1;155;94;185;103;59;596
010111120198;1;199;245;248;65;123;880
096972893339;1;177;283;222;106;62;850
045490132887;1;101;277;112;119;99;708
055497477610;1;242;95;111;84;85;617
061831337092;1;244;224;169;58;150;845
061458974449;1;170;177;104;100;128;679
035462614449;1;155;228;264;72;51;770
039711826464;1;243;173;208;90;108;822
004943249534;1;187;91;112;99;114;603
036009083685;1;161;271;264;60;144;900
009723202358;1;215;98;161;110;71;655
090938154408;1;274;234;116;104;116;844
023036019029;1;272;99;211;99;100;781
004763502112;1;232;239;215;106;54;846
090841641388;1;162;246;299;91;176;974
042689289629;1;291;188;268;112;105;964
020730296838;1;160;286;107;83;71;707
046702534155;1;170;265;232;82;85;834
008496324830;1;231;238;251;77;81;878
002636396181;1;172;212;173;50;124;731
088152508651;1;104;235;250;62;167;818
020349667113;1;141;241;227;118;51;778
037486114254;1;236;117;179;85;125;742
024965058043;1;177;194;190;86;115;762
092824325037;1;81;214;141;119;119;674
051125635876;1;84;209;217;99;170;779
043411290368;1;243;252;100;117;89;801
084294147403;1;219;117;167;110;172;785
089263670593;1;149;222;281;103;146;901
081218252078;1;253;104;208;87;117;769
030637572192;1;262;178;98;55;142;735
043882874733;1;226;283;221;60;116;906
076995005544;1;96;245;300;119;173;933
037584188409;1;144;211;262;101;73;791
021452672306;1;82;172;105;115;130;604
065233593543;1;95;218;133;112;153;711
094975953461;1;218;97;145;83;115;658
005068277963;1;266;99;142;82;155;744
025571840307;1;226;244;277;54;54;855
077644734588;1;193;98;122;58;76;547
053499543367;1;207;107;160;82;67;623
000119901870;1;170;238;289;78;170;945
004685846533;1;172;181;256;94;86;789
098390943422;1;230;274;198;98;129;929
010393971805;1;120;182;283;54;111;750
050725484907;1;179;209;104;83;144;719
069103388817;1;225;261;237;58;85;866
081002463689;1;118;182;273;100;85;758
043948213932;1;248;227;297;98;164;1034
085355621164;1;244;189;90;94;130;747
083127710590;1;133;115;266;68;128;710
013594190484;1;113;122;110;93;172;610
029252821278;1;182;164;105;62;143;656
099084449916;1;232;258;278;110;112;990
017584748754;1;243;115;209;99;178;844
083205805662;1;202;252;228;61;57;800
048721641765;1;189;121;124;119;121;674
031592466690;1;223;110;252;93;76;754
027650520729;1;88;126;113;90;73;490
062394130824;1;282;179;287;56;110;914
059474838553;1;266;109;189;76;126;766
008080601688;1;148;223;175;108;90;744
020032538610;1;236;120;179;53;69;657
005486804660;1;84;158;295;78;121;736
075981113154;1;248;140;244;84;152;868
040583748530;1;233;267;167;86;117;870
027271266857;1;145;91;230;55;63;584
042243824410;1;201;126;233;54;161;775
087707340756;1;181;115;132;91;57;576
021777125839;1;242;180;227;52;131;832
073746577784;1;118;210;161;85;104;678
048020295402;1;237;272;200;104;88;901
054622308724;1;81;168;281;90;164;784
035129901729;1;136;214;110;52;101;613
075902074619;1;156;155;154;91;173;729
013501926703;1;261;177;149;93;134;814
083452706053;1;272;214;162;63;78;789
021157247680;1;118;131;187;80;50;566
020255234639;1;224;226;165;92;59;766
044559289904;1;244;129;201;107;92;773
016553839146;1;165;244;254;77;153;893
032750342792;1;138;267;250;54;58;767
002952382051;1;241;187;112;74;72;686
052092291262;1;265;110;265;113;104;857
059491586442;1;103;148;189;94;137;671
054830997434;1;192;169;199;107;115;782
067115947786;1;106;190;132;56;104;588
063895756462;1;148;164;161;79;149;701
074176228777;1;155;230;195;118;122;820
020374761170;1;89;154;119;69;147;578
081261868107;1;106;195;248;108;74;731
014793344846;1;81;209;249;71;55;665
051724577543;1;123;166;171;105;84;649
057882263843;1;135;120;261;51;170;737
094110094405;1;291;114;249;84;159;897
098278219948;1;159;270;252;61;134;876
086689915168;1;210;102;142;58;82;594
086949323065;1;242;120;130;72;163;727
053375553840;1;236;266;197;84;65;848
093278194425;1;205;197;156;104;85;747
087761606683;1;276;236;135;67;105;819
044021669272;1;105;205;178;69;54;611
012549246998;1;142;249;142;64;120;717
089684074453;1;166;106;275;76;147;770
022074128478;1;117;119;171;108;55;570
014591826751;1;262;252;115;116;105;850
016422200145;1;85;107;95;77;81;445
056055278181;1;160;251;213;101;73;798
019443331454;1;231;96;284;51;69;731
044506326268;1;265;283;179;117;117;961
005713854172;1;247;248;253;78;124;950
083442063429;1;148;245;214;65;149;821
079082510706;1;221;235;94;73;63;686
023156942095;1;90;93;228;86;94;591
027956669453;1;158;144;241;80;73;696
082337281266;1;251;122;160;120;62;715
018747170127;1;226;247;270;53;176;972
063212485745;1;251;185;235;120;109;900
092928906288;1;140;185;206;71;113;715
055500804304;1;193;107;213;62;173;748
079411452084;1;267;234;297;115;72;985
006936480881;1;165;176;124;69;52;586
079447640989;1;275;249;262;91;159;1036
077043445607;1;126;219;91;83;122;641
052987815573;1;253;263;193;75;108;892
071451311639;1;252;166;186;91;123;818
092981951974;1;212;259;199;102;137;909
073000992376;1;281;271;276;93;61;982
016476220152;1;127;171;242;81;64;685
040526234445;1;127;137;168;115;66;613
033828533415;1;258;230;160;72;154;874
036409269857;1;155;120;211;120;116;722
067916353162;1;289;112;277;53;147;878
085551690869;1;284;89;208;105;175;861
041536280401;1;221;112;217;58;131;739
054822607810;1;82;83;182;56;92;495
038939985422;1;215;106;253;58;167;799
084439484883;1;128;153;139;118;58;596
092865458429;1;213;107;228;117;138;803
031537355552;1;92;88;139;85;163;567
003807951590;1;177;85;226;61;145;694
040935482463;1;217;258;122;77;67;741
091491544948;1;281;233;188;63;175;940
024414850404;1;211;179;225;88;151;854
002559981269;1;131;122;275;63;78;669
012874952949;1;192;94;267;69;131;753
014974213258;1;254;149;223;107;88;821
087396051951;1;167;176;161;64;58;626
057647867704;1;163;125;261;85;103;737
052837971088;1;224;224;238;119;63;868
074603681289;1;241;270;158;79;78;826
065073920512;1;89;110;292;86;50;627
021542400842;1;126;273;93;95;132;719
043419650529;1;240;150;193;109;117;809
035471960244;1;128;224;93;54;137;636
051497272529;1;101;221;124;118;55;619
082437732430;1;118;227;117;50;163;675
029778585293;1;124;189;272;109;166;860
092717140999;1;109;81;271;94;51;606
007585818047;1;195;215;230;96;55;791
052367162746;1;83;221;275;112;175;866
013719449665;1;128;124;292;64;108;716
044530061347;1;260;111;290;99;161;921
087029788437;1;132;134;165;51;139;621
035438764077;1;94;164;128;87;148;621
053610896598;1;268;260;274;51;133;986
033599654988;1;277;238;148;81;79;823
017342117329;1;246;213;204;117;152;932
071497011989;1;176;274;239;102;122;913
093804819991;1;189;260;137;86;90;762
093934357805;1;207;225;280;119;64;895
019240872677;1;286;244;159;112;98;899
015133825316;1;288;103;207;63;126;787
088223285230;1;178;81;169;57;58;543
059701831929;1;276;134;162;102;74;748
064154757214;1;187;82;176;67;101;613
005779469835;1;273;207;267;110;55;912
078625416881;1;243;211;264;75;129;922
076597374043;1;248;94;281;106;102;831
033916945378;1;226;212;147;80;97;762
059419847220;1;291;161;238;78;144;912
031465764947;1;86;155;148;120;76;585
029619358809;1;189;230;172;108;71;770
062047582116;1;250;240;214;63;175;942
045417438321;1;131;141;204;77;51;604
081593483234;1;126;282;188;79;80;755
079026522320;1;80;260;179;83;55;657
041577242783;1;246;242;182;102;102;874
004104239470;1;271;201;168;58;165;863
097621605599;1;139;122;113;70;125;569
023148236440;1;147;262;211;81;96;797
025865139193;1;290;167;110;83;78;728
021696516005;1;223;251;276;107;178;1035
052569222855;1;252;125;105;114;152;748
016133503817;1;286;144;233;81;70;814
061291443547;1;245;108;165;113;136;767
084932579114;1;287;180;99;117;117;800
033589606890;1;111;120;119;58;88;496
035404078600;1;220;134;173;59;53;639
060119873908;1;162;198;224;109;66;759
007705497685;1;117;186;135;81;162;681
054565837761;1;138;234;277;108;119;876
023516917338;1;250;184;253;91;112;890
057810181700;1;82;117;255;51;143;648
042047840537;1;205;185;143;108;72;713
000417117139;1;221;199;116;56;177;769
046327238659;1;99;221;164;58;82;624
051674980706;1;227;91;206;91;112;727
074741844090;1;218;162;194;105;156;835
091160053368;1;162;96;267;55;134;714
003179277190;1;206;101;144;68;173;692
036666189606;1;193;167;260;78;61;759
040719271303;1;283;163;240;87;165;938
084729236059;1;142;83;149;98;86;558
087075193119;1;183;271;116;85;130;785
077415457585;1;238;236;179;53;178;884
060402856669;1;232;147;146;104;148;777
010139193072;1;180;118;104;105;93;600
011180383167;1;121;162;91;105;61;540
006653255396;1;158;170;230;86;54;698
063735643842;1;133;174;117;118;114;656
036593635782;1;270;229;264;74;96;933
099304661643;1;114;135;214;84;76;623
059033797004;1;192;127;141;80;156;696
056963539563;1;284;86;216;95;133;814
090965346039;1;223;156;176;53;139;747
011219385431;1;91;198;111;50;80;530
079427215126;1;291;84;203;87;103;768
088910342031;1;190;148;279;75;141;833
037816263035;1;248;112;271;51;142;824
007464602584;1;156;157;204;92;123;732
038843108010;1;221;263;105;106;162;857
041212881492;1;137;233;172;99;124;765
065571016867;1;192;158;227;54;90;721
022241126949;1;173;238;227;93;80;811
012857585481;1;102;131;289;63;82;667
075087527818;1;185;223;150;86;128;772
005639704353;1;189;86;132;93;175;675
082125872912;1;138;249;172;106;115;780
071110161756;1;138;274;205;60;169;846
076464396426;1;238;265;205;53;163;924
016681200609;1;167;85;128;115;116;611
095119587217;1;198;128;245;62;147;780
092784229217;1;291;204;245;52;112;904
080466961290;1;92;100;142;71;134;539
016437198855;1;109;148;174;111;161;703
082263896767;1;252;279;219;69;107;926
016143222693;1;163;277;119;60;80;699
024649435417;1;85;146;297;108;67;703
000343330104;1;132;212;259;103;116;822
010026583212;1;223;213;226;108;57;827
098108175850;1;188;237;221;84;65;795
051533792166;1;148;227;184;55;108;722
004548266206;1;106;139;125;112;108;590
045617849175;1;196;178;191;70;167;802
012928168492;1;131;261;272;81;164;909
086557219948;1;254;241;121;70;112;798
059123383126;1;192;115;160;56;149;672
078815489786;1;138;182;123;92;80;615
060189898339;1;150;82;263;52;96;643
004953987855;1;145;275;191;117;101;829
041273652252;1;178;205;102;116;113;714
077213731346;1;176;127;91;84;177;655
092659868118;1;166;214;271;50;59;760
038414112361;1;136;262;276;87;148;909
028620644366;1;241;110;137;60;138;686
075904376241;1;269;218;263;59;125;934
076098357141;1;261;178;145;114;85;783
087143151095;1;126;244;150;96;91;707
038747577421;1;168;108;109;56;75;516
079924155312;1;128;240;263;64;92;787
052370230665;1;152;139;276;80;176;823
096401743566;1;96;87;276;111;148;718
003693314170;1;251;128;229;69;56;733
002402855690;1;153;126;257;77;152;765
025116124936;1;122;158;145;79;125;629
014932399757;1;198;132;96;104;96;626
004467769825;1;192;231;198;94;115;830
012815107232;1;143;82;178;106;71;580
049194859851;1;238;276;129;56;139;838
051431823068;1;137;214;274;72;79;776
071514385092;1;96;219;127;99;111;652
007365064278;1;202;150;257;91;80;780
098881458208;1;234;224;230;102;95;885
030466224185;1;265;135;123;75;101;699
015061235784;1;87;212;226;69;74;668
089078172464;1;163;248;271;64;124;870
005554625476;1;214;94;268;88;106;770
085416191867;1;181;248;147;80;109;765
002664358116;1;143;167;110;90;80;590
056931041214;1;272;115;248;87;88;810
063627173172;1;224;103;238;78;57;700
007009031451;1;86;264;104;87;137;678
087000404976;1;134;271;147;64;174;790
045985404974;1;196;130;113;91;164;694
077692780415;1;80;281;161;90;103;715
048655895671;1;288;214;137;91;106;836
020606468857;1;270;96;291;85;135;877
006224063297;1;148;202;100;62;78;590
011489871587;1;81;208;180;105;158;732
019508593060;1;219;201;204;53;56;733
016559839249;1;265;94;144;67;166;736
067867363404;1;135;97;157;77;164;630
055374569392;1;267;253;149;77;72;818
027142958084;1;105;159;134;86;146;630
065318748555;1;131;199;129;91;175;725
058674136665;1;153;192;275;69;70;759
038873513211;1;104;168;154;84;55;565
097526429411;1;86;103;92;79;56;416
027111473102;1;111;203;165;75;70;624
059143008060;1;240;184;91;113;124;752
009272903727;1;154;232;223;60;155;824
037146432985;1;226;99;264;76;164;829
000967912631;1;137;272;209;51;52;721
073430989115;1;231;142;210;51;66;700
089563041690;1;179;235;233;113;142;902
012360203283;1;199;207;130;61;121;718
003991735383;1;161;223;286;110;144;924
035440866493;1;166;149;250;94;87;746
056209488934;1;84;287;213;113;113;810
073899893773;1;289;166;136;102;149;842
078476179531;1;196;94;269;65;129;753
089530643486;1;260;203;174;109;111;857
016151573066;1;198;99;300;63;99;759
043158381257;1;134;283;138;81;143;779
019897591575;1;118;244;172;103;126;763
072661291734;1;88;135;247;110;57;637
025343640371;1;212;179;274;88;59;812
025677392799;1;282;220;203;101;118;924
078606691095;1;261;207;117;115;63;763
062937640730;1;262;158;204;84;162;870
097495450133;1;129;219;231;76;166;821
010806824478;1;113;250;151;79;105;698
098699547119;1;123;195;232;54;166;770
076812743123;1;90;122;247;101;170;730
099341163985;1;145;238;211;54;69;717
030155867817;1;101;122;257;75;81;636
078921572995;1;182;203;130;67;141;723
005450191755;1;194;275;221;81;50;821
097324622020;1;292;107;289;92;101;881
019906960289;1;275;101;241;80;168;865
022736539892;1;239;164;238;51;157;849
088537348440;1;264;125;251;74;142;856
078094324317;1;195;286;241;65;56;843
044310835153;1;257;127;260;72;176;892
063582955126;1;235;223;290;100;102;950
051773117890;1;265;181;104;53;98;701
049664418458;1;241;185;171;120;135;852
028046114459;1;202;225;147;60;89;723
083667415486;1;271;214;244;114;132;975
080817172790;1;166;130;166;66;117;645
083496979240;1;155;260;227;105;99;846
067548601346;1;257;125;220;78;130;810
053958037917;1;198;121;254;94;87;754
007912890244;1;103;288;214;116;54;775
019114960677;1;214;182;209;63;68;736
052313276457;1;147;251;128;94;174;794
056318947598;1;176;170;155;89;82;672
063097476766;1;84;233;91;84;90;582
023423110602;1;179;267;280;78;69;873
085699337438;1;109;123;117;87;121;557
044319156009;1;84;84;183;52;136;539
043787465386;1;273;162;295;57;154;941
057573257867;1;158;141;154;65;133;651
023156163980;1;267;110;257;111;91;836
067603696006;1;243;141;206;116;142;848
021593642833;1;103;144;254;83;51;635
035119156827;1;203;259;282;68;73;885
063344917424;1;117;249;290;66;122;844
093527563370;1;207;132;208;83;112;742
052359469208;1;249;159;279;120;176;983
001992827006;1;166;205;98;119;96;684
033940501534;1;240;131;117;79;89;656
030089984345;1;114;145;259;75;151;744
094653307721;1;96;219;267;114;51;747
096388148053;1;130;120;225;101;171;747
066647371769;1;266;173;221;53;69;782
095317223719;1;278;194;213;71;177;933
096499820840;1;194;120;285;105;130;834
059249806537;1;98;202;268;50;95;713
013119305147;1;272;270;145;102;128;917
073445566878;1;213;234;117;101;52;717
031441510822;1;130;248;128;67;81;654
014560273176;1;240;261;121;64;163;849
094343745848;1;221;148;207;84;112;772
057473248117;1;86;261;187;76;54;664
075592382524;1;283;217;299;55;59;913
009201854114;1;284;247;247;106;140;1024
019553526228;1;111;188;156;104;172;731
025465152857;1;273;132;139;51;114;709
039190466404;1;95;172;98;56;114;535
019484390532;1;189;285;266;93;104;937
090769403768;1;287;118;142;62;89;698
030449090417;1;175;115;242;51;62;645
095701146817;1;131;89;298;81;87;686
001607505765;1;190;112;286;105;132;825
079587240792;1;109;247;108;106;70;640
048380743394;1;282;191;158;86;172;889
002441353068;1;203;147;183;57;60;650
064880749981;1;192;152;140;66;164;714
035013512072;1;142;227;286;116;147;918
069364922225;1;244;129;236;79;99;787
058707172225;1;269;276;282;110;90;1027
084867776052;1;129;147;216;77;88;657
095404586446;1;283;97;274;68;62;784
039556376952;1;94;217;281;99;72;763
092212217262;1;241;207;273;90;158;969
080485121616;1;121;155;222;73;162;733
087245294133;1;281;161;287;54;69;852
069959360577;1;112;239;129;112;177;769
068687483246;1;275;173;209;51;123;831
017137056763;1;245;220;181;72;139;857
057502231787;1;248;197;291;52;155;943
075199671520;1;204;257;147;70;163;841
058734137292;1;89;267;146;91;125;718
050202312820;1;216;274;147;86;153;876
036552559195;1;81;204;95;104;73;557
032446087030;1;180;166;135;83;85;649
055671960160;1;114;279;183;97;135;808
003863520143;1;289;172;116;116;139;832
021326848507;1;261;189;147;62;111;770
013107625392;1;256;94;217;87;106;760
094733543701;1;214;257;227;106;61;865
073112164437;1;223;175;130;80;137;745
072468068411;1;205;258;119;95;136;813
069502770235;1;284;84;133;107;53;661
011418512993;1;288;102;218;72;75;755
002241461747;1;150;280;236;98;95;859
041770810349;1;235;90;138;78;136;677
008173058957;1;130;120;94;116;109;569
071635961862;1;244;282;275;55;92;948
058790678860;1;173;255;198;66;154;846
003746293969;1;250;226;211;59;135;881
043680953140;1;251;248;295;62;143;999
069035623681;1;205;255;149;91;144;844
068920986857;1;279;218;193;89;127;906
052052584580;1;228;233;221;65;176;923
010897372395;1;161;218;128;57;76;640
099955444451;1;177;271;117;113;107;785
006988623121;1;90;225;193;57;97;662
057512335594;1;182;171;97;102;161;713
001058482739;1;275;247;279;88;78;967
096075059916;1;222;263;182;58;57;782
094692140216;1;231;132;265;100;164;892
091167165183;1;283;164;273;111;65;896
010739874578;1;229;140;198;109;106;782
088223456130;1;231;91;294;77;54;747
095579783051;1;213;80;214;104;75;686
082852647518;1;120;140;171;99;172;702
080833488390;1;84;231;232;75;125;747
094486211198;1;150;181;134;95;92;652
018776465629;1;202;88;199;81;136;706
064479730797;1;97;156;294;100;146;793
031269160498;1;214;111;162;57;142;686
011013812433;1;253;213;164;68;130;828
020833491584;1;222;231;243;77;165;938
085971149589;1;202;183;177;67;98;727
011321803256;1;263;154;105;52;158;732
046630211918;1;198;158;271;74;125;826
024249003332;1;157;222;224;107;68;778
006165871414;1;279;132;204;90;50;755
088708978016;1;84;281;156;67;65;653
095820359961;1;282;175;281;62;76;876
027430273949;1;92;131;276;88;112;699
045119497158;1;191;172;90;105;103;661
022091360592;1;264;108;179;67;159;777
071781292399;1;232;268;149;105;56;810
035549497082;1;218;84;206;85;131;724
062603201301;1;213;160;201;72;145;791
071476820506;1;164;253;134;84;126;761
067790675815;1;169;266;169;61;164;829
066059866193;1;108;91;155;78;81;513
042017296265;1;178;199;295;85;130;887
030754665164;1;156;219;167;99;96;737
061049487865;1;90;254;222;79;172;817
004744385502;1;189;225;118;87;52;671
061080416685;1;282;285;289;84;79;1019
062196081118;1;179;152;238;59;66;694
092040470267;1;218;150;258;81;145;852
032254893273;1;243;146;163;76;110;738
010149717856;1;163;191;165;92;173;784
092476698083;1;162;123;182;110;112;689
031067191532;1;203;132;212;115;103;765
005547131365;1;116;220;110;102;122;670
061281836549;1;208;201;135;67;156;767
019901746377;1;100;285;127;116;130;758
084568294142;1;180;283;123;120;53;759
022950341113;1;98;111;208;74;167;658
070831154030;1;107;135;170;103;52;567
060382340463;1;170;232;239;54;131;826
041585547222;1;258;125;103;87;171;744
046943514084;1;285;242;203;86;135;951
064232776162;1;279;253;155;109;94;890
051812690371;1;225;239;122;74;90;750
094416920992;1;113;103;194;107;111;628
041078368272;1;107;95;292;73;172;739
040524541878;1;205;186;230;59;143;823
069738781620;1;125;236;120;62;178;721
079299722010;1;98;95;158;100;127;578
092826780003;1;258;269;94;67;68;756
098597064158;1;98;182;121;62;125;588
081820300551;1;100;235;202;58;123;718
020793488286;1;272;110;155;102;178;817
064133534633;1;200;282;96;54;92;724
018871684732;1;85;141;147;91;101;565
081544496069;1;166;255;180;80;123;804
075802936560;1;158;101;166;100;86;611
045770271867;1;140;212;119;100;135;706
023945061444;1;235;135;214;120;156;860
044343641445;1;141;273;289;95;77;875
042834429953;1;278;147;249;93;89;856
014186480433;1;207;124;99;89;155;674
097060150658;1;223;260;92;56;65;696
002689152972;1;247;228;163;65;104;807
090003510721;1;127;211;142;81;113;674
079879003079;1;284;261;188;68;165;966
005637114517;1;145;140;183;66;66;600
085887663915;1;236;130;181;76;59;682
077133571751;1;233;285;184;71;129;902
050991164523;1;133;137;157;83;62;572
022541229376;1;129;191;130;74;162;686
028708817866;1;151;224;181;96;156;808
060670746295;1;159;252;137;52;97;697
011815045093;1;197;239;97;102;162;797
021394301781;1;135;244;109;61;157;706
089801291498;1;217;153;166;82;95;713
067797671006;1;188;158;175;109;72;702
010042839431;1;270;260;116;64;88;798
076622444672;1;164;269;113;71;66;683
047399370837;1;289;240;107;66;126;828
088217121258;1;285;273;119;114;168;959
006532181130;1;137;213;152;118;52;672
063158118219;1;262;229;217;59;139;906
041929961549;1;202;261;151;64;68;746
007657993452;1;269;195;277;90;136;967
083236841914;1;201;260;281;107;132;981
049687479074;1;138;180;105;54;162;639
062495501455;1;180;116;288;116;158;858
010567162350;1;214;83;200;103;89;689
043375550464;1;208;117;285;117;157;884
057605878265;1;221;180;150;54;95;700
059350323408;1;253;154;155;88;123;773
025375318823;1;142;135;213;72;123;685
099519874002;1;106;179;246;64;143;738
075912976238;1;227;189;141;82;110;749
060250819293;1;125;233;144;105;126;733
079178789532;1;190;198;126;95;112;721
083559000842;1;278;90;247;102;125;842
012164005149;1;162;257;156;91;61;727
073786816588;1;270;165;227;119;110;891
083752832839;1;292;102;298;120;56;868
047227875314;1;194;214;251;110;178;947
061607926908;1;271;244;166;62;169;912
054659921933;1;95;138;121;115;52;521
074922999394;1;246;274;276;68;113;977
096261891102;1;274;258;232;112;53;929
049102749397;1;172;169;140;104;90;675
002787952649;1;256;207;222;114;63;862
028263796414;1;174;263;288;112;110;947
072081970842;1;249;258;120;85;131;843
065250585242;1;151;142;190;107;66;656
021364085633;1;249;287;275;85;104;1000
067614060309;1;128;285;191;86;74;764
039666996943;1;87;170;135;52;78;522
096340642384;1;221;150;148;67;154;740
061579357991;1;273;193;122;72;118;778
068550472678;1;270;252;203;95;142;962
097748730062;1;241;150;173;61;136;761
000952095948;1;200;105;153;60;162;680
038619250308;1;89;118;263;60;53;583
052547214342;1;193;157;134;102;138;724
083270619484;1;89;235;226;81;111;742
063645587285;1;118;162;204;61;53;598
014345002574;1;124;193;229;100;50;696
031626575992;1;258;215;263;87;165;988
069626558170;1;237;118;253;103;175;886
037159500427;1;145;202;197;56;93;693
017159517407;1;268;223;128;99;172;890
025425415899;1;200;88;203;113;160;764
073676784118;1;249;212;117;115;83;776
053918974310;1;229;92;158;102;93;674
006252508568;1;180;288;240;67;75;850
077222117571;1;109;193;227;112;119;760
044685809855;1;90;122;231;56;52;551
094196926803;1;108;241;185;80;155;769
078867573774;1;170;87;208;97;95;657
069856819503;1;149;228;286;64;112;839
076110603861;1;208;129;180;65;96;678
087587941380;1;254;84;228;108;91;765
084144765120;1;278;109;277;111;173;948
016910599043;1;234;276;123;56;154;843
083116563552;1;262;87;141;94;112;696
053583999185;1;103;85;214;74;151;627
099748051138;1;227;219;239;73;160;918
037898108565;1;248;179;156;106;131;820
031480503061;1;227;278;284;88;128;1005
020729011781;1;126;285;251;57;79;798
079619940632;1;140;87;164;101;143;635
080231309762;1;105;144;294;57;161;761
071522593835;1;94;250;132;58;53;587
046216528390;1;204;94;239;104;136;777
036828551890;1;223;104;134;102;166;729
071598061648;1;184;173;184;74;163;778
025399836052;1;286;170;271;89;64;880
057909532629;1;215;259;187;82;84;827
095584746304;1;243;240;260;55;153;951
077549281118;1;127;194;246;59;83;709
026075654185;1;101;169;282;118;59;729
093504265891;1;132;91;192;78;89;582
085031337448;1;228;194;297;58;174;951
025006427512;1;163;174;114;105;89;645
025087923987;1;94;206;267;61;154;782
036846126539;1;211;286;263;58;109;927
071289549298;1;248;212;272;91;88;911
041424963112;1;154;172;93;119;94;632
075919031968;1;220;239;187;58;127;831
018572165633;1;153;281;243;80;111;868
043430460525;1;183;164;297;97;90;831
075412375371;1;266;96;174;120;150;806
005479692623;1;134;190;142;62;74;602
044216112690;1;258;258;121;118;65;820
034676003357;1;214;269;182;67;83;815
006199409585;1;115;278;276;70;92;831
018541400171;1;108;100;258;79;123;668
091384390032;1;192;202;242;70;163;869
071569859286;1;141;185;144;112;55;637
095051346699;1;256;99;246;79;169;849
071196472472;1;182;205;248;118;153;906
081032375220;1;194;185;177;110;64;730
005553540524;1;186;93;279;108;161;827
032275069013;1;139;198;275;103;97;812
028344935265;1;124;245;215;98;157;839
048787224971;1;178;129;131;65;125;628
043110743600;1;171;115;210;64;138;698
088312097283;1;136;98;228;64;74;600
069771607660;1;110;124;157;114;141;646
026446225495;1;159;144;282;69;152;806
017582518201;1;196;250;202;104;87;839
013332935528;1;213;242;176;93;121;845
056538214923;1;272;134;202;106;142;856
071021054971;1;151;93;203;65;158;670
035367240820;1;257;199;236;101;146;939
005291587286;1;146;281;215;67;122;831
009544357343;1;214;145;127;93;139;718
069739257526;1;276;263;212;74;66;891
082707322147;1;111;196;144;82;54;587
041918738944;1;101;89;207;93;177;667
042471278396;1;218;96;246;56;150;766
079087392223;1;122;187;100;105;89;603
057357353229;1;108;252;220;118;167;865
048428265228;1;166;194;289;69;91;809
063720795779;1;131;204;155;106;97;693
086064289858;1;105;191;260;117;136;809
073218430016;1;239;162;209;117;111;838
068760057209;1;193;194;266;111;116;880
088716595610;1;161;252;148;96;51;708
055387442880;1;145;240;210;69;144;808
007107816631;1;275;121;245;88;120;849
014670421381;1;265;82;288;73;56;764
004377627662;1;103;120;118;64;104;509
073164347454;1;248;105;280;94;153;880
055190083541;1;179;263;168;66;159;835
023604797595;1;130;191;259;51;68;699
026802599712;1;255;205;254;59;145;918
002753747852;1;110;219;170;120;96;715
084538907735;1;132;263;262;55;117;829
039044278094;1;194;142;233;54;84;707
020505542966;1;178;154;146;82;142;702
023184543101;1;233;87;121;54;89;584
037003785738;1;80;134;267;96;83;660
076737799812;1;185;257;189;96;134;861
016533415777;1;242;135;136;86;62;661
010968610232;1;263;189;244;64;154;914
065683780489;1;229;112;164;87;143;735
035039771418;1;196;150;171;52;149;718
062120349745;1;176;259;265;64;82;846
030724422309;1;178;220;262;87;144;891
022703797864;1;164;236;154;68;135;757
045542714583;1;81;126;191;103;150;651
044291387051;1;137;126;125;72;66;526
094376935642;1;149;287;160;95;101;792
093154136619;1;255;173;215;82;125;850
085815225864;1;215;216;157;62;147;797
017076324266;1;127;267;217;62;67;740
071487137589;1;88;183;188;83;133;675
058143686494;1;87;259;276;58;63;743
081928681583;1;115;192;106;76;124;613
076068709596;1;283;255;179;115;175;1007
061588506020;1;94;133;175;97;89;588
031788450342;1;230;182;129;53;65;659
022651046607;1;171;102;279;84;58;694
088975157479;1;129;220;241;65;62;717
058682529697;1;145;167;224;64;174;774
025762648206;1;104;198;217;52;85;656
010329002748;1;83;260;137;57;162;699
026515099387;1;277;181;272;108;59;897
047889843014;1;215;193;209;64;161;842
042430226899;1;268;161;159;55;158;801
053565783056;1;137;274;235;98;155;899
006021054076;1;136;164;199;74;82;655
035942524261;1;190;110;128;64;94;586
013597816107;1;112;168;220;80;64;644
037042968610;1;288;126;257;81;151;903
032090464188;1;108;208;106;97;144;663
057300098406;1;220;222;275;102;96;915
038266547057;1;263;253;119;67;94;796
045507566628;1;126;111;233;80;112;662
097685673551;1;260;103;170;65;112;710
022310881383;1;288;165;238;53;157;901
068088875641;1;218;241;185;88;71;803
019668328550;1;222;138;124;64;157;705
030455396873;1;166;184;237;118;143;848
046388685642;1;202;125;232;50;98;707
007021006569;1;232;181;216;66;140;835
073641256250;1;124;198;97;71;164;654
099022780833;1;277;254;300;96;95;1022
070413078356;1;95;247;108;97;105;652
022882744191;1;289;254;286;52;169;1050
054207206308;1;285;149;256;95;157;942
034323534711;1;181;156;247;61;58;703
046038557104;1;136;260;207;87;63;753
096059129870;1;204;97;184;88;142;715
037172590461;1;129;249;237;84;156;855
077835745462;1;159;143;199;54;138;693
088143422890;1;210;228;204;106;172;920
042556610158;1;138;118;262;94;157;769
000391877737;1;138;163;271;70;75;717
096160842420;1;111;180;128;63;150;632
078656026581;1;131;145;269;107;153;805
009575070286;1;286;264;108;63;73;794
038737804388;1;274;226;258;100;131;989
042348565953;1;241;133;161;114;174;823
025049908665;1;268;163;211;91;142;875
031884741297;1;276;94;272;79;123;844
003466592176;1;170;257;96;67;150;740
043647139993;1;236;257;227;68;138;926
013619736226;1;148;273;184;118;88;811
082619809768;1;272;176;215;114;172;949
030462547340;1;267;287;203;87;90;934
010006797162;1;152;133;228;91;82;686
045544386847;1;210;177;90;98;107;682
065442381008;1;163;242;208;68;101;782
050381230836;1;139;113;273;94;143;762
009085694397;1;99;277;237;102;115;830
069532358874;1;170;217;274;106;165;932
052560565276;1;154;108;114;92;150;618
042621154584;1;203;104;128;55;88;578
069025839415;1;151;101;294;112;58;716
007553716878;1;185;200;222;51;135;793
094847819094;1;206;110;281;70;87;754
032308140875;1;288;221;206;100;156;971
040684596571;1;166;265;294;106;139;970
018462939165;1;114;172;255;73;55;669
087059268041;1;89;275;109;84;122;679
075676361363;1;201;125;217;86;86;715
070096422207;1;244;104;185;109;110;752
002934515522;1;249;285;278;99;70;981
094420193669;1;123;113;182;70;173;661
093593571996;1;249;276;92;100;128;845
056200450888;1;272;263;195;79;175;984
012381014188;1;230;156;108;94;103;691
040239729028;1;269;164;282;118;144;977
091016485654;1;203;282;126;88;169;868
007378652715;1;292;129;210;63;133;827
009356110885;1;172;129;226;118;95;740
057531305089;1;152;255;180;53;81;721
018403108754;1;147;212;95;114;99;667
063421866783;1;197;244;204;71;174;890
007136732880;1;286;279;258;58;121;1002
047295943447;1;141;247;127;88;65;668
067802731302;1;147;286;284;51;152;920
045051033623;1;99;132;221;66;110;628
048926144619;1;165;219;150;70;72;676
098862632543;1;94;248;280;101;86;809
074236761420;1;223;211;171;59;90;754
099590083161;1;122;257;298;120;118;915
072626230791;1;83;243;132;91;110;659
012636716066;1;259;129;240;103;171;902
088369905748;1;198;94;286;103;119;800
097496857674;1;132;111;297;114;73;727
096608606765;1;281;186;90;112;135;804
076588026364;1;182;171;271;110;91;825
096898133754;1;237;168;220;100;148;873
073409777977;1;103;241;93;68;119;624
016642511748;1;185;141;268;95;104;793
099297894228;1;279;223;172;92;82;848
024325108662;1;188;101;145;84;59;577
013658008989;1;199;191;129;79;168;766
025560555388;1;136;265;136;79;88;704
034850318866;1;204;280;162;53;77;776
043444493323;1;160;237;253;110;73;833
007222929068;1;84;90;263;112;110;659
097961226283;1;212;163;130;63;108;676
079745774273;1;155;274;137;87;62;715
070876411254;1;288;280;94;66;55;783
070907316872;1;107;87;294;70;113;671
076770251945;1;157;236;177;83;68;721
021449781008;1;87;240;131;95;99;652
018162930018;1;90;222;287;93;135;827
008482577886;1;92;90;296;73;101;652
080163294648;1;226;279;298;62;138;1003
059479805463;1;118;242;185;99;94;738
023054461785;1;167;126;100;82;108;583
020191033836;1;214;159;152;115;178;818
065748317032;1;99;178;296;94;68;735
016286732847;1;229;188;190;88;166;861
073706148279;1;213;172;249;88;102;824
072064494292;1;287;115;204;114;144;864
073709540583;1;285;150;132;109;140;816
095236610903;1;120;119;162;63;164;628
077294649485;1;143;136;299;73;108;759
079234852718;1;211;94;215;58;55;633
066176907518;1;96;272;278;98;59;803
059440294584;1;135;268;248;114;110;875
080189888439;1;220;260;207;58;95;840
026344906468;1;145;233;294;110;161;943
032861833730;1;188;258;237;68;176;927
063412383088;1;96;122;192;112;146;668
007643122920;1;152;229;233;100;89;803
056222902039;1;256;137;115;80;158;746
085371263646;1;190;114;105;59;94;562
014206727773;1;284;275;136;59;76;830
099359775080;1;280;270;160;76;112;898
022536230793;1;101;169;202;69;92;633
091709047996;1;83;288;294;61;104;830
054020518048;1;82;195;295;78;157;807
095832396956;1;178;141;121;76;121;637
039215325638;1;126;227;179;87;105;724
096687339583;1;181;102;182;60;147;672
014427870242;1;186;151;168;79;108;692
055053379839;1;243;239;147;116;76;821
051420039053;1;229;179;289;76;155;928
076764150144;1;168;90;136;92;177;663
057694931368;1;269;175;213;70;99;826
073177658285;1;254;138;294;83;51;820
018186198938;1;177;115;182;72;71;617
047213189991;1;226;176;126;119;160;807
074990545397;1;104;283;284;108;147;926
077042572862;1;283;97;285;70;83;818
071223925232;1;163;252;176;61;163;815
027175727174;1;262;155;267;104;51;839
062316015501;1;253;137;259;82;63;794
024055630536;1;96;130;204;58;80;568
014288840587;1;85;236;117;58;102;598
099399357766;1;144;99;111;61;56;471
093201950398;1;108;268;255;113;176;920
024564216064;1;122;88;169;89;111;579
092314688564;1;147;108;280;88;90;713
018723630249;1;189;198;264;98;178;927
012657656074;1;123;261;94;82;163;723
038810651619;1;113;191;259;102;99;764
027882238057;1;190;96;102;60;140;588
013679395381;1;98;135;178;108;61;580
031159937537;1;272;158;300;83;145;958
043222276602;1;273;128;98;58;50;607
056779827013;1;258;162;148;73;57;698
085186806489;1;82;212;92;81;147;614
039127950285;1;85;110;153;88;137;573
078863949188;1;136;269;114;76;175;770
095866587812;1;177;174;173;65;109;698
054494803590;1;154;254;296;63;74;841
022616494698;1;89;151;208;65;164;677
013366610883;1;265;93;280;88;63;789
065242989573;1;109;241;100;114;166;730
068977698225;1;268;141;199;112;57;777
052116039798;1;109;147;119;67;155;597
054183327463;1;92;177;126;114;117;626
069367711294;1;249;90;219;104;177;839
077011906071;1;205;144;209;54;123;735
037949462960;1;159;286;274;110;154;983
022138744214;1;129;215;239;62;79;724
065012744160;1;113;153;256;96;122;740
081510141652;1;202;126;294;74;68;764
058375984063;1;107;179;259;61;168;774
093199595096;1;97;153;141;67;121;579
076561140807;1;168;164;188;107;88;715
048334954883;1;98;170;247;111;55;681
055723294873;1;225;102;188;106;166;787
075627147733;1;122;285;165;92;147;811
076951667205;1;262;283;255;97;96;993
093900355902;1;170;98;269;64;83;684
061887976113;1;170;140;110;57;178;655
042944185149;1;239;103;142;65;158;707
035131184382;1;282;201;240;112;129;964
001037387157;1;206;201;223;60;148;838
085512013359;1;260;283;125;120;138;926
049956244722;1;133;234;289;58;133;847
016736180776;1;86;206;169;86;102;649
050058824949;1;182;176;242;63;99;762
096887081230;1;205;272;253;71;68;869
053592976099;1;152;117;218;116;158;761
098557167082;1;108;235;289;95;124;851
063388846827;1;157;161;105;91;121;635
023127021266;1;190;101;122;84;150;647
046503864988;1;103;260;213;64;75;715
010577672006;1;184;225;184;79;155;827
097803091292;1;104;252;178;102;176;812
071177246720;1;254;260;161;61;68;804
047976227980;1;277;176;198;63;137;851
027576187229;1;111;284;91;54;51;591
006320261764;1;225;287;240;116;87;955
022859746866;1;136;216;90;53;135;630
004396169853;1;213;97;100;89;146;645
036039767779;1;173;123;127;65;168;656
077750224645;1;287;226;218;87;98;916
074305210997;1;144;224;282;114;120;884
013204965946;1;143;211;203;83;59;699
033588073464;1;239;85;93;74;125;616
036918343439;1;178;154;176;55;158;721
064161059385;1;204;84;145;93;97;623
094290075860;1;228;93;276;83;93;773
032904720650;1;255;169;218;75;112;829
006137036744;1;247;92;293;109;59;800
042113359637;1;213;115;245;86;152;811
061354555450;1;267;162;123;108;156;816
066159135496;1;205;164;267;61;114;811
005653368907;1;172;154;144;108;56;634
030615194402;1;116;88;130;105;117;556
042200817940;1;147;92;107;90;77;513
013386999763;1;248;154;220;63;114;799
090865294448;1;183;172;194;88;167;804
076427587084;1;129;169;249;100;83;730
061677130000;1;83;262;165;55;86;651
081763765478;1;282;122;288;60;60;812
053112704016;1;132;196;183;110;123;744
036982286475;1;94;257;107;64;76;598
024886569728;1;181;162;257;60;80;740
082957962524;1;83;246;233;92;66;720
070402540987;1;201;84;252;57;151;745
059446287051;1;276;142;257;77;123;875
098694750307;1;288;182;211;56;84;821
050720070802;1;262;149;182;65;75;733
041755045250;1;116;172;216;93;71;668
078662915285;1;231;124;142;97;57;651
067268009168;1;116;237;156;67;104;680
002456604731;1;133;147;146;70;103;599
084652719780;1;154;285;134;92;174;839
045861213823;1;194;155;189;93;66;697
070280427171;1;289;243;225;120;113;990
039710161588;1;104;150;268;74;110;706
080168968163;1;131;191;183;59;119;683
048511622654;1;95;168;98;103;62;526
081573749645;1;204;187;285;86;146;908
071294681549;1;90;189;224;93;120;716
079356677022;1;174;266;287;56;170;953
052663200955;1;273;238;284;99;59;953
036707956868;1;93;273;94;91;76;627
064264498796;1;105;146;291;116;166;824
044597500658;1;147;262;124;112;93;738
078651930395;1;231;170;225;117;93;836
038107210277;1;91;100;244;68;72;575
060431185907;1;153;116;196;68;51;584
036051822425;1;219;266;148;67;81;781
043613666069;1;279;262;96;92;142;871
064745804745;1;251;140;249;72;152;864
007596162368;1;214;155;195;68;57;689
013262702816;1;90;166;97;79;73;505
074644985157;1;189;217;201;117;65;789
092970757737;1;240;100;132;101;90;663
030259792245;1;86;240;272;92;157;847
049535332685;1;153;94;258;78;112;695
040161213887;1;242;114;135;117;128;736
073299176160;1;184;201;264;69;102;820
013699896678;1;258;115;218;102;103;796
002624186066;1;256;164;100;98;56;674
050524917480;1;101;240;239;116;154;850
067217628571;1;157;172;248;67;62;706
098487647261;1;275;273;118;60;61;787
088067511028;1;91;276;283;100;85;835
047502042998;1;170;228;290;78;152;918
095091738466;1;124;226;218;100;170;838
015995784141;1;128;156;196;85;147;712
029624472495;1;188;181;154;92;115;730
058618349950;1;291;92;98;109;66;656
041103558396;1;210;236;212;58;80;796
064677913407;1;208;178;104;108;68;666
068875017975;1;136;186;253;73;142;790
079837914150;1;111;164;281;97;72;725
074517583103;1;269;119;157;104;159;808
060644905427;1;245;197;95;89;56;682
013981678488;1;219;234;224;93;143;913
099209643615;1;207;107;173;97;86;670
003635094768;1;111;240;116;86;81;634
023198308979;1;177;125;288;116;160;866
013290486529;1;104;84;257;60;89;594
090671519295;1;216;232;111;96;89;744
045733979215;1;134;85;175;90;51;535
094153692472;1;212;176;239;60;128;815
059187809505;1;94;117;248;99;71;629
045294713649;1;290;171;136;52;107;756
072417617457;1;107;281;182;82;178;830
047285592748;1;123;98;261;98;171;751
059298356021;1;224;261;238;55;169;947
046094706143;1;103;199;243;62;168;775
080135794634;1;192;139;218;103;104;756
043042643288;1;181;162;289;76;133;841
030496512006;1;80;81;122;107;124;514
083512590947;1;117;90;205;118;57;587
041187510029;1;292;208;233;103;176;1012
087629117252;1;125;127;124;116;166;658
048620965886;1;237;134;263;65;75;774
047287037485;1;232;275;284;115;149;1055
058368607165;1;109;196;231;52;130;718
011897570553;1;170;187;276;104;118;855
028413057273;1;191;230;125;76;159;781
096494734859;1;193;202;297;103;139;934
063843946244;1;114;109;253;110;54;640
017603309085;1;186;140;218;72;111;727
019574025726;1;251;97;95;83;130;656
018452106842;1;90;270;298;84;100;842
053966696275;1;222;172;187;59;52;692
085325493978;1;91;160;266;88;54;659
006266643925;1;253;259;222;111;145;990
053392671963;1;107;222;263;85;67;744
033439266928;1;285;161;264;79;80;869
014035635345;1;109;185;273;89;65;721
052597919804;1;183;107;252;61;115;718
086832767636;1;169;207;265;73;113;827
069132749475;1;114;214;275;93;77;773
059405029923;1;221;268;263;105;63;920
035445581399;1;214;254;227;114;80;889
020130582035;1;269;130;236;62;69;766
018340410411;1;249;139;239;75;121;823
008056273769;1;188;144;157;117;116;722
077457775415;1;117;287;142;107;50;703
064279607222;1;163;264;193;59;66;745
055053206926;1;178;98;289;60;59;684
074558553974;1;134;243;196;107;88;768
043573864883;1;141;231;266;61;139;838
036108648304;1;171;201;194;66;89;721
058310637285;1;181;111;125;70;107;594
039728975972;1;145;117;257;113;83;715
076705399758;1;169;157;189;82;52;649
073615495758;1;285;181;175;81;106;828
009720532780;1;168;174;217;52;108;719
068854374537;1;190;200;211;90;157;848
076812023100;1;216;100;252;105;91;764
040981007306;1;122;239;194;92;110;757
045894425010;1;223;200;222;100;161;906
005178139063;1;118;199;100;101;77;595
043896476244;1;232;150;215;87;89;773
024069299974;1;259;122;276;87;78;822
034145059717;1;174;168;117;78;116;653
077121697966;1;213;125;148;119;113;718
027224069857;1;83;261;99;98;88;629
093038521112;1;292;186;235;62;104;879
079884726927;1;190;141;252;96;119;798
092083664699;1;269;133;116;71;88;677
058718737368;1;119;238;271;59;132;819
042178163368;1;81;164;190;61;166;662
045105573615;1;156;108;263;82;104;713
081939119536;1;249;239;290;69;91;938
093066922289;1;175;111;233;106;72;697
032246461925;1;259;232;106;77;147;821
012007327923;1;108;127;249;60;138;682
008090985659;1;89;104;106;85;94;478
086289509620;1;230;231;142;95;140;838
012451095411;1;169;128;191;117;116;721
058683284492;1;264;184;120;60;56;684
095835976850;1;112;155;169;100;155;691
065388345824;1;191;275;152;78;177;873
013247738835;1;261;165;294;79;84;883
085949615640;1;101;99;222;56;150;628
042527542002;1;125;185;99;61;130;600
041849121864;1;87;205;215;61;177;745
076579876819;1;183;211;220;91;152;857
098090808737;1;242;155;169;119;118;803
038396548710;1;157;288;259;75;163;942
045739071340;1;93;221;224;79;102;719
046126612616;1;183;239;128;54;100;704
089420918918;1;164;175;265;120;84;808
024482580302;1;117;180;236;86;81;700
026968099067;1;126;208;274;70;99;777
022448656192;1;179;188;126;55;155;703
039002261088;1;114;145;225;65;104;653
074375891866;1;278;252;169;114;139;952
085063732083;1;141;278;294;109;65;887
012595750937;1;249;190;262;78;119;898
073241203665;1;188;283;229;110;146;956
027961720408;1;112;130;282;59;166;749
007233433977;1;191;119;94;81;142;627
057361359451;1;242;182;290;71;118;903
023457066860;1;195;226;217;100;110;848
059800021962;1;181;120;284;75;83;743
094136362662;1;86;209;185;99;157;736
083264036482;1;233;149;194;77;175;828
027129945953;1;240;275;145;109;166;935
040538243635;1;175;150;268;101;89;783
019989814548;1;260;123;184;94;146;807
080448199315;1;195;214;246;73;99;827
058142302219;1;100;80;122;102;61;465
062671965600;1;273;283;265;110;147;1078
018653748506;1;270;246;268;68;100;952
048081240989;1;216;183;286;72;124;881
034820237124;1;177;178;160;79;68;662
082026708903;1;216;81;209;105;67;678
004798167654;1;190;205;212;103;119;829
066859442756;1;277;276;121;99;175;948
072075458385;1;120;100;146;120;164;650
071697085016;1;173;191;159;119;129;771
046870137867;1;286;260;292;97;62;997
098854857335;1;227;250;271;105;177;1030
019239487500;1;124;174;190;50;132;670
090795863250;1;176;92;240;93;163;764
046755565176;1;263;189;116;91;61;720
066681615556;1;84;125;128;54;127;518
007368715012;1;86;194;280;73;113;746
045019713272;1;237;215;97;61;60;670
048737182374;1;152;181;167;56;71;627
071269380859;1;269;100;259;72;50;750
058098337638;1;267;144;287;115;108;921
010260253074;1;223;238;250;81;113;905
043759418439;1;258;160;217;68;134;837
063432361304;1;138;114;172;73;100;597
056626456763;1;207;247;135;98;60;747
093362755835;1;95;119;108;61;56;439
018305997100;1;179;183;267;99;144;872
037229348791;1;195;209;150;69;58;681
024596530187;1;149;288;245;71;135;888
083430155820;1;96;166;115;88;167;632
059028068396;1;224;84;233;53;111;705
042066426245;1;111;140;203;109;161;724
064161297017;1;111;190;173;116;77;667
060056342932;1;87;178;196;101;95;657
046275658657;1;246;202;270;68;176;962
042136548211;1;133;287;106;112;58;696
076219753142;1;91;92;240;53;145;621
027211682143;1;183;103;142;85;80;593
052647931743;1;187;188;141;52;151;719
026182424740;1;205;120;241;114;135;815
043403779642;1;164;273;247;95;96;875
010411947809;1;270;201;126;66;128;791
095176804246;1;214;224;222;79;135;874
051573089114;1;151;181;116;77;88;613
088854426310;1;222;82;204;55;96;659
085416042273;1;147;148;181;68;123;667
021722754674;1;171;280;204;119;54;828
066609373322;1;181;181;300;84;134;880
076652957845;1;175;271;218;67;65;796
082998609114;1;104;207;166;110;109;696
040291389154;1;178;218;190;100;156;842
011851812498;1;97;107;236;67;121;628
028740821603;1;206;249;240;82;124;901
038632340400;1;239;226;243;76;156;940
060269583161;1;271;201;159;84;112;827
088482512274;1;240;195;96;114;135;780
052823566206;1;86;261;228;106;68;749
023944037208;1;92;97;218;95;93;595
037631674360;1;260;149;296;118;121;944
079264979368;1;230;171;221;70;103;795
082335919675;1;173;121;209;97;102;702
059578869132;1;150;269;150;63;137;769
034494758046;1;159;85;187;90;137;658
046984302917;1;288;132;124;92;155;791
025726714518;1;163;152;167;83;161;726
024092260189;1;114;172;281;102;160;829
022656082476;1;214;234;157;56;154;815
069431224188;1;276;278;193;69;66;882
019923781305;1;165;207;180;104;174;830
024327330251;1;195;268;183;76;69;791
063383449705;1;159;262;226;72;57;776
086056721128;1;288;173;188;55;93;797
050092120798;1;113;150;181;100;159;703
022175695834;1;266;86;296;102;144;894
008189106442;1;84;185;116;52;149;586
097961472606;1;232;83;162;82;76;635
050015442488;1;108;135;295;67;50;655
042722655901;1;91;221;100;51;72;535
075012013392;1;144;215;190;69;126;744
025160669988;1;107;122;160;63;115;567
095828113421;1;99;230;245;51;109;734
041638950637;1;115;204;151;71;70;611
083737817782;1;165;178;248;107;91;789
075412141922;1;168;252;194;80;151;845
046415420414;1;114;231;160;120;57;682
065814249476;1;265;143;110;64;143;725
055868441431;1;148;143;111;84;172;658
029513462163;1;99;105;197;53;103;557
033537706367;1;265;208;222;79;132;906
056707053135;1;275;173;174;96;155;873
004502113361;1;226;81;108;100;141;656
095902599920;1;248;246;106;117;117;834
042319251234;1;234;169;265;84;138;890
077982704462;1;134;246;293;108;106;887
084111315973;1;154;202;280;61;87;784
012166351708;1;190;145;256;99;126;816
071528174428;1;80;156;97;82;166;581
031717916437;1;242;117;134;99;162;754
075687332099;1;229;150;173;89;88;729
041812382598;1;142;160;213;100;159;774
049853354213;1;269;133;108;95;143;748
007266281780;1;233;217;171;79;160;860
022952791948;1;233;233;182;113;122;883
045989271590;1;105;148;243;54;166;716
010351553797;1;94;248;254;55;69;720
087218981162;1;130;197;290;110;73;800
031058302572;1;212;171;200;100;85;768
077834816763;1;289;211;213;71;176;960
050416515325;1;146;236;261;68;76;787
065433291909;1;166;276;166;109;106;823
041045922453;1;176;207;150;56;96;685
004786893353;1;291;83;212;75;76;737
089063101367;1;272;148;187;79;164;850
055714235089;1;242;180;144;117;63;746
061467850322;1;242;111;249;112;167;881
042682085094;1;197;134;243;118;131;823
059734170566;1;125;113;250;60;93;641
007465146170;1;124;280;269;88;122;883
027526116422;1;211;273;276;66;170;996
048287934675;1;195;189;264;91;144;883
041551254911;1;243;245;277;109;81;955
021537183719;1;101;141;294;95;175;806
097618027045;1;190;209;295;103;113;910
077061028363;1;94;269;188;89;164;804
039388140078;1;258;201;298;90;168;1015
041996175218;1;84;241;251;89;135;800
051071503715;1;240;169;240;90;162;901
042546705011;1;175;130;274;64;108;751
036290182520;1;111;102;154;65;119;551
073647620887;1;184;244;238;64;127;857
006932644977;1;238;191;134;101;59;723
017542474192;1;96;81;143;69;98;487
008330305386;1;123;111;135;91;81;541
012003897279;1;254;267;131;117;93;862
054014394021;1;211;88;185;50;146;680
014310716078;1;238;161;99;85;91;674
034600951797;1;239;155;208;69;122;793
010200860606;1;177;98;106;88;74;543
010704021177;1;83;260;178;81;126;728
012017026187;1;132;191;150;63;101;637
050324129526;1;148;181;268;100;109;806
048720446938;1;146;95;274;86;172;773
026664929002;1;288;95;103;110;134;730
012055272963;1;218;128;149;66;144;705
073314695265;1;223;97;94;113;50;577
067772996521;1;191;232;181;83;119;806
069118372742;1;152;209;178;101;154;794
094589005477;1;123;202;239;81;82;727
083432100289;1;281;140;147;75;85;728
011829812272;1;250;258;102;112;173;895
009340258490;1;187;197;218;110;82;794
089586966084;1;259;164;113;106;90;732
058499766116;1;263;153;225;52;135;828
072313409169;1;92;139;209;115;147;702
071766411412;1;84;263;90;78;97;612
063730970142;1;276;107;127;108;135;753
044230589114;1;181;130;273;56;141;781
009763130504;1;161;153;227;110;170;821
038752440376;1;178;149;198;98;89;712
018172471513;1;269;239;245;109;155;1017
004471565274;1;229;271;242;120;72;934
044291647122;1;140;244;108;114;146;752
024699745056;1;118;142;151;94;68;573
064779402945;1;156;161;190;75;94;676
010713819232;1;178;265;245;99;98;885
086951554548;1;184;129;193;111;148;765
098574364166;1;114;115;219;118;162;728
035100199015;1;185;150;265;64;51;715
034100936664;1;245;255;252;110;83;945
076196829418;1;278;202;104;60;67;711
074898619520;1;205;196;163;57;121;742
077828747211;1;268;189;154;103;145;859
047538473235;1;190;178;238;73;165;844
059498626446;1;150;202;224;115;90;781
019338074241;1;123;200;130;75;54;582
066932570742;1;231;146;260;118;165;920
041452816717;1;284;227;219;94;63;887
072499541181;1;95;121;176;114;135;641
052651852402;1;136;167;141;61;121;626
080807484807;1;215;256;103;62;105;741
012927954052;1;217;185;211;77;143;833
031323452800;1;143;172;117;80;91;603
099869890809;1;121;138;121;100;170;650
034649147883;1;194;120;274;96;61;745
023536078127;1;141;112;163;106;132;654
026241807906;1;271;243;288;84;145;1031
042136516564;1;168;248;132;92;147;787
076111785842;1;204;99;116;84;168;671
016639288885;1;285;173;255;119;143;975
012367928375;1;153;259;255;81;68;816
034741660608;1;216;148;109;91;131;695
091425691754;1;186;93;220;96;51;646
029021164512;1;228;150;174;53;128;733
080586037188;1;171;182;233;75;128;789
014582782435;1;135;196;189;97;131;748
041132701966;1;90;155;296;94;132;767
062753791397;1;126;94;142;66;156;584
094702272621;1;205;278;122;81;128;814
012276388207;1;288;213;97;85;110;793
006074263184;1;221;238;135;72;110;776
008587488812;1;253;128;164;108;54;707
001493421375;1;225;194;254;115;58;846
001218715406;1;281;263;171;58;95;868
069928624909;1;204;185;262;83;166;900
012136036160;1;180;138;167;91;171;747
071763512706;1;213;147;191;71;98;720
053233207623;1;109;173;296;120;101;799
039601380402;1;226;119;166;53;162;726
066898999580;1;254;164;208;77;141;844
004733916216;1;253;287;275;59;125;999
094068764537;1;183;238;211;77;162;871
078344201762;1;129;143;240;77;93;682
033869013687;1;194;137;121;85;50;587
044838025257;1;147;114;239;81;110;691
094110012153;1;91;104;214;110;71;590
052763399518;1;221;214;263;95;154;947
097645321304;1;239;136;116;69;74;634
053888994962;1;83;88;247;96;171;685
039819235774;1;140;124;170;105;67;606
056803133612;1;229;153;150;103;173;808
050178270698;1;149;126;199;90;81;645
008929895312;1;88;165;296;70;133;752
048423817239;1;228;261;177;60;50;776
090646824556;1;209;176;97;51;172;705
075300987855;1;122;89;145;81;122;559
047499120664;1;153;276;147;78;175;829
068081700139;1;163;236;289;72;154;914
022777091274;1;228;113;291;66;53;751
038718504683;1;125;265;209;104;141;844
077965714241;1;245;287;135;69;55;791
042767844081;1;231;272;190;101;125;919
057545564567;1;256;194;131;99;85;765
094465346671;1;147;252;219;90;118;826
066590873464;1;221;96;97;66;110;590
054081308470;1;234;219;185;120;143;901
091657506893;1;269;138;230;116;135;888
091658671773;1;99;157;267;59;145;727
008819182558;1;176;267;221;90;122;876
098913875754;1;235;160;126;117;165;803
096160122912;1;281;133;200;96;176;886
061171328033;1;153;87;168;63;78;549
031148106286;1;140;219;125;73;177;734
048341580773;1;104;206;179;97;106;692
006887271624;1;186;238;238;111;102;875
083835143573;1;281;107;150;65;87;690
049256302088;1;193;217;125;68;50;653
097348603167;1;111;204;280;106;139;840
009864239985;1;276;234;151;103;69;833
099418691939;1;251;138;216;62;55;722
034163061188;1;159;188;274;76;124;821
092712674667;1;207;213;186;103;72;781
018273598952;1;231;256;116;98;129;830
011467598706;1;242;107;92;120;64;625
023269185023;1;213;161;265;59;175;873
089599242951;1;281;234;177;109;90;891
092546675765;1;133;224;282;92;81;812
069315469702;1;247;110;149;68;153;727
059160047025;1;144;220;288;86;62;800
069702155477;1;253;200;143;78;57;731
080812426103;1;265;152;125;54;154;750
095020766295;1;176;216;203;92;151;838
055487194059;1;204;176;146;88;81;695
087021605452;1;92;179;191;103;50;615
042402379525;1;83;248;110;56;133;630
011786150156;1;178;262;241;105;113;899
016048533818;1;152;143;231;108;173;807
060478677923;1;265;166;182;114;77;804
042800919881;1;261;229;122;71;115;798
004846783395;1;122;108;198;94;74;596
085069884821;1;261;131;171;87;134;784
037407815468;1;219;96;150;110;85;660
078791614140;1;107;212;235;97;148;799
006948044907;1;127;245;244;53;67;736
036419565770;1;262;258;177;104;161;962
029203456633;1;114;127;136;63;115;555
012023313650;1;270;246;103;95;62;776
087806120985;1;267;86;150;65;61;629
036700776859;1;150;86;139;120;107;602
096035510764;1;146;117;148;110;68;589
028790116972;1;243;197;230;113;108;891
073631830152;1;100;275;184;113;160;832
097357972365;1;253;288;188;120;142;991
077374714029;1;134;128;213;68;110;653
063421785556;1;84;146;159;55;84;528
094966499601;1;91;136;117;50;58;452
004002958007;1;124;191;273;82;51;721
092805934467;1;237;117;190;114;113;771
033523300495;1;238;207;131;119;174;869
093226334193;1;213;226;146;95;110;790
060625776695;1;223;232;294;86;65;900
001568835765;1;248;171;125;103;127;774
073888210402;1;264;184;282;105;66;901
002567185221;1;273;112;135;81;152;753
032269666744;1;257;207;227;82;164;937
062202473337;1;135;142;176;108;146;707
089313506693;1;281;274;282;103;175;1115
004868650057;1;150;209;259;73;176;867
014557737015;1;97;261;222;70;162;812
003251569146;1;94;228;99;109;133;663
094413536743;1;228;204;166;69;156;823
000621733333;1;195;207;125;61;119;707
021124750803;1;217;284;209;51;166;927
090059096735;1;169;248;90;56;149;712
071790304670;1;242;249;258;53;102;904
044584200178;1;124;254;238;109;111;836
097367620380;1;248;228;290;73;141;980
047182109430;1;256;283;237;76;107;959
048766851241;1;276;135;182;78;61;732
058267993742;1;154;275;114;63;76;682
072591438712;1;199;146;212;56;55;668
086548463524;1;100;279;182;97;83;741
062034535829;1;82;110;260;113;89;654
030504187401;1;181;263;294;83;102;923
073093100322;1;247;238;176;77;142;880
099597682901;1;95;94;245;57;159;650
099617936468;1;182;121;98;78;75;554
062879373880;1;106;186;142;90;93;617
092163839406;1;229;132;94;69;138;662
004542200215;1;193;188;216;105;72;774
024007763862;1;185;195;195;96;96;767
033430178519;1;102;131;189;107;154;683
059525364607;1;243;261;299;99;75;977
024463204453;1;120;143;287;54;70;674
086372715322;1;264;84;142;56;90;636
019514727653;1;278;111;210;71;55;725
058136166561;1;182;120;215;112;95;724
098347665659;1;160;256;143;117;101;777
001018052070;1;246;114;167;104;100;731
083249475271;1;280;280;216;116;118;1010
055159083963;1;178;134;265;105;58;740
015522115543;1;128;194;169;50;88;629
082387713571;1;204;272;202;51;82;811
061489139610;1;182;246;265;95;135;923
050900917558;1;145;218;288;98;147;896
084844275822;1;185;141;243;53;132;754
019205304487;1;178;286;221;62;52;799
034962723470;1;281;248;232;94;101;956
016079997247;1;116;153;242;99;135;745
054001298951;1;230;140;205;62;148;785
021791871448;1;159;121;124;67;168;639
063099039820;1;145;182;288;85;136;836
008290419037;1;278;261;92;72;175;878
056401631615;1;264;229;220;78;64;855
087938904580;1;183;210;107;91;104;695
064090679391;1;112;138;202;51;73;576
016445942747;1;255;181;90;76;107;709
007783053158;1;243;210;149;52;85;739
001382995272;1;199;150;142;113;56;660
049992653402;1;84;163;252;83;75;657
018823977343;1;254;103;254;91;89;791
037086078180;1;187;91;97;57;109;541
013226524442;1;223;130;96;118;153;720
079789941501;1;112;186;296;69;56;719
030540745427;1;204;246;253;102;105;910
000639898801;1;288;244;271;95;170;1068
072654750654;1;270;146;203;73;93;785
033474673746;1;248;103;272;99;152;874
091842834068;1;103;174;179;88;133;677
066696418181;1;269;168;172;78;73;760
065942806742;1;254;168;144;104;152;822
056484532219;1;161;174;216;90;63;704
076347066716;1;263;190;96;93;120;762
008809984673;1;115;264;297;72;148;896
043002072820;1;115;220;271;94;94;794
089957634462;1;123;172;281;71;93;740
052173587166;1;252;235;162;64;51;764
053758081250;1;88;141;175;51;62;517
079392841889;1;262;244;157;120;119;902
088780685684;1;96;225;110;92;75;598
052000875001;1;198;133;188;91;59;669
092267251068;1;152;170;260;120;178;880
058407475259;1;209;245;277;85;65;881
001871621103;1;155;149;208;53;162;727
094410905624;1;155;146;230;119;168;818
095245151014;1;280;206;228;112;93;919
077426196971;1;288;127;272;70;115;872
075807398385;1;98;156;272;114;81;721
060701949830;1;235;281;119;72;150;857
073464993997;1;134;207;199;112;164;816
056124847427;1;142;251;136;76;71;676
093196670306;1;205;249;116;82;160;812
080788344965;1;139;137;298;74;74;722
068370658420;1;169;93;171;116;127;676
095893017337;1;114;156;240;117;75;702
088357281407;1;166;152;297;119;152;886
067458839173;1;266;140;91;106;68;671
069620663421;1;240;280;108;109;171;908
056236213394;1;108;132;195;112;165;712
003723662287;1;214;254;252;103;153;976
032254998239;1;243;92;160;85;147;727
008367343024;1;292;132;117;78;135;754
022734026877;1;133;131;127;101;71;563
058697178881;1;142;277;131;55;73;678
075552889444;1;196;253;196;100;99;844
087428553796;1;272;214;197;119;127;929
091141889915;1;282;253;227;97;124;983
024315242595;1;139;281;248;51;149;868
093014470132;1;254;160;154;103;59;730
063599283417;1;240;235;141;65;68;749
082836118944;1;198;233;91;50;79;651
075623891783;1;157;243;154;91;164;809
074816169471;1;240;192;133;110;86;761
024189185088;1;201;169;193;59;138;760
018034025821;1;107;165;91;95;143;601
074097974594;1;93;123;292;86;123;717
051640956817;1;159;128;264;109;153;813
067437277071;1;165;227;92;82;142;708
058546615200;1;239;211;146;115;153;864
075298098513;1;111;217;230;70;64;692
034926595173;1;157;114;204;73;147;695
065306460534;1;117;283;298;83;127;908
061916849082;1;116;80;124;64;117;501
097013642216;1;182;141;119;102;59;603
018216882388;1;89;158;285;115;163;810
076263406933;1;237;206;159;77;169;848
006589425128;1;154;199;284;54;78;769
084087766828;1;222;229;178;62;145;836
032350482134;1;103;219;280;84;158;844
008468260018;1;288;243;167;105;92;895
062329497268;1;137;134;240;78;90;679
026528929361;1;245;103;253;82;56;739
067722459683;1;183;226;298;83;76;866
063131075242;1;123;187;177;93;93;673
026165119034;1;286;123;237;108;117;871
086018304228;1;220;133;159;78;171;761
016183254562;1;121;250;115;77;112;675
096698707705;1;230;177;146;52;122;727
014616560827;1;238;114;236;51;115;754
017070125220;1;229;178;207;81;112;807
060897020949;1;169;81;141;84;78;553
009492579794;1;186;117;191;55;95;644
013434053806;1;136;262;247;94;173;912
005543394587;1;237;282;120;97;85;821
088973426852;1;254;116;218;102;175;865
080915912605;1;280;255;260;82;56;933
026887887821;1;86;206;281;85;116;774
035690492206;1;231;255;126;99;164;875
056280848032;1;155;122;289;109;58;733
089745692136;1;257;80;290;89;146;862
088575357475;1;238;146;202;84;148;818
075592313647;1;255;287;232;60;86;920
030545286727;1;201;144;198;103;155;801
000468405418;1;262;234;240;76;101;913
033051267574;1;116;258;178;90;178;820
023802791018;1;106;214;287;75;164;846
099093008718;1;178;250;116;66;126;736
024647027551;1;202;91;138;57;157;645
088222918341;1;187;233;144;67;138;769
049735537570;1;231;279;127;106;151;894
018525735398;1;147;230;108;118;94;697
056551851892;1;164;168;133;67;178;710
044176812776;1;218;190;294;78;114;894
091141468755;1;80;204;193;118;102;697
089110611839;1;162;102;149;92;148;653
003989850208;1;155;225;110;62;173;725
074710468010;1;272;123;208;51;166;820
049800936145;1;170;96;297;61;60;684
081057407213;1;158;174;123;77;113;645
039787901668;1;148;221;237;99;90;795
091828248150;1;113;232;269;73;159;846
097441959934;1;130;272;181;88;113;784
041798255887;1;186;123;235;109;69;722
053870396784;1;252;158;257;99;121;887
010577456747;1;260;186;258;97;73;874
037954793602;1;103;217;275;52;166;813
054665563533;1;188;170;190;99;167;814
023784643244;1;227;146;168;103;97;741
055265076813;1;254;220;113;71;118;776
033753010770;1;271;151;218;52;124;816
009434888638;1;106;282;142;107;158;795
047783414095;1;142;108;128;116;64;558
065832504651;1;217;282;285;106;163;1053
033826088005;1;255;117;298;93;147;910
039642067307;1;145;147;175;106;166;739
002335357087;1;111;151;224;82;166;734
070587959610;1;163;112;210;108;96;689
097949581438;1;154;150;227;62;109;702
074878355702;1;178;195;96;94;157;720
098532629756;1;118;262;111;97;131;719
059475307690;1;148;121;222;90;64;645
091513725492;1;284;287;273;108;71;1023
054747031137;1;105;275;179;68;58;685
028583012945;1;195;103;198;67;139;702
048257166381;1;266;101;140;113;177;797
010249805946;1;115;89;202;104;54;564
081854704634;1;156;259;234;51;72;772
042035803865;1;119;247;127;113;113;719
065735474254;1;139;243;91;52;95;620
047830646318;1;269;229;114;111;89;812
023592894717;1;186;138;116;72;149;661
001702681106;1;288;208;93;114;123;826
009291260065;1;124;121;151;61;126;583
054031088542;1;254;211;243;52;81;841
047297676549;1;102;93;169;109;86;559
034560797321;1;290;93;209;108;75;775
088716690225;1;283;275;104;67;161;890
063802777097;1;228;85;144;69;149;675
015496075004;1;216;96;164;109;78;663
004390773853;1;142;276;250;109;77;854
058459431337;1;155;95;146;75;73;544
036294233486;1;162;127;199;70;53;611
040985602442;1;92;235;100;108;82;617
091381650300;1;206;271;116;84;154;831
021349698496;1;239;122;196;88;58;703
076988709201;1;258;268;121;89;177;913
087439582501;1;89;224;140;87;67;607
032830286051;1;176;176;255;57;103;767
095372644685;1;266;260;141;94;76;837
046887674855;1;171;227;218;60;51;727
068234650096;1;222;247;223;76;146;914
043461129993;1;208;237;206;116;140;907
097233655094;1;108;119;143;89;160;619
021952985790;1;225;259;295;63;70;912
038736045083;1;290;82;300;83;104;859
063625371678;1;275;265;199;74;91;904
001188264589;1;86;269;268;55;130;808
075679318516;1;272;161;168;70;83;754
082899605739;1;171;271;253;74;152;921
098716576093;1;168;277;143;110;153;851
014718230672;1;235;195;192;95;132;849
009525475236;1;279;200;297;96;59;931
025130228092;1;87;147;260;95;166;755
046014799424;1;188;248;159;84;136;815
010579735036;1;143;168;253;77;172;813
005809370520;1;215;187;230;101;98;831
012415679935;1;224;117;222;67;148;778
094366905375;1;226;244;208;104;99;881
064470189731;1;281;146;236;84;71;818
045422607796;1;163;146;91;70;113;583
032515002824;1;193;195;237;114;107;846
013589487883;1;110;223;122;54;165;674
096456446899;1;114;191;199;84;56;644
053571778287;1;90;144;178;70;155;637
059850088089;1;189;214;215;108;127;853
048647304741;1;238;256;293;51;69;907
037040237550;1;97;238;193;102;145;775
043241947688;1;166;82;282;87;173;790
055135117206;1;130;223;175;55;117;700
035119867649;1;126;94;193;88;54;555
060120758434;1;269;141;109;94;176;789
009480778747;1;169;118;298;99;149;833
065119015170;1;226;164;184;52;145;771
016651290475;1;109;275;146;119;137;786
054120270101;1;270;166;208;110;178;932
055416457829;1;96;115;280;90;149;730
072932849191;1;158;135;226;89;159;767
047403143556;1;281;195;95;99;91;761
073106294788;1;267;228;146;57;99;797
073108434929;1;83;185;192;68;168;696
065595623440;1;234;273;127;116;166;916
003151349545;1;183;245;231;74;106;839
075701470739;1;233;285;119;77;122;836
047950044745;1;184;267;169;89;170;879
055020603632;1;82;201;118;107;128;636
006091251087;1;80;120;297;114;164;775
006373114011;1;218;83;109;53;152;615
027464941273;1;194;114;262;54;51;675
068859777054;1;249;183;139;84;113;768
008857342459;1;118;95;164;69;78;524
049003986496;1;105;278;246;120;168;917
017462808242;1;201;111;235;120;51;718
095780559113;1;232;117;143;119;133;744
097063437302;1;265;276;295;72;82;990
075147535419;1;92;88;264;105;135;684
039861020935;1;263;242;110;77;146;838
054692162926;1;268;175;209;61;135;848
095497277212;1;256;210;211;52;50;779
021895340514;1;208;238;288;100;150;984
005303025593;1;168;210;149;84;150;761
086356434915;1;231;147;297;96;98;869
064416498476;1;272;217;154;67;73;783
026766891899;1;261;141;111;53;50;616
026343180117;1;125;276;168;71;83;723
081332210180;1;156;274;150;115;65;760
095902567568;1;136;228;253;97;127;841
014612868373;1;198;192;181;91;146;808
059939974449;1;140;156;197;57;168;718
010022918558;1;131;83;195;52;119;580
086235932685;1;212;245;150;75;172;854
080946082261;1;257;268;160;108;79;872
018408698633;1;225;147;165;62;143;742
040523245345;1;134;211;293;65;86;789
010309488421;1;142;88;256;104;174;764
066445924046;1;107;96;92;88;176;559
021959584987;1;94;102;211;73;161;641
067666410167;1;92;170;254;68;144;728
082450177376;1;200;141;234;98;167;840
059827002237;1;173;164;175;111;94;717
043867330392;1;246;95;113;84;107;645
022760710130;1;249;220;127;57;174;827
061250852404;1;286;251;201;119;143;1000
012828529425;1;182;277;113;93;136;801
069281257144;1;141;193;248;97;178;857
044735734642;1;273;199;218;116;84;890
082311810328;1;152;191;161;110;61;675
080219578562;1;197;288;225;73;139;922
073216304936;1;284;188;291;106;147;1016
086272099174;1;96;220;235;109;106;766
068902857673;1;128;147;179;95;118;667
048065688948;1;153;213;222;120;99;807
037998267611;1;168;121;114;83;115;601
034826536863;1;134;186;256;94;129;799
045209500512;1;161;174;231;87;86;739
003858829115;1;129;183;247;87;82;728
059657531822;1;112;247;214;114;77;764
037105721879;1;239;231;125;109;119;823
038789769765;1;192;268;144;90;91;785
079131356687;1;145;249;99;117;111;721
052947665932;1;207;106;265;89;154;821
050206520682;1;212;258;154;69;95;788
083891865746;1;151;81;199;92;166;689
046656012394;1;111;128;257;109;105;710
043775496498;1;96;206;114;106;110;632
060829056100;1;274;251;194;120;95;934
000148130839;1;209;165;266;106;63;809
085454090989;1;267;260;132;82;157;898
075989106691;1;147;121;246;62;82;658
059193942363;1;272;114;185;95;175;841
075562738872;1;244;156;121;107;153;781
004667105893;1;176;80;131;78;102;567
036890114027;1;159;193;97;120;112;681
098992262754;1;167;226;91;67;111;662
064384324418;1;190;202;155;52;81;680
046925475157;1;140;274;157;73;102;746
091677628224;1;165;255;220;61;143;844
032130684356;1;220;84;241;64;126;735
007013877617;1;292;116;135;79;70;692
099766042802;1;165;284;113;116;138;816
066233442434;1;286;221;100;115;168;890
054808046938;1;117;132;119;61;166;595
008267623086;1;121;84;240;58;143;646
097854672803;1;164;265;290;85;73;877
091140487764;1;123;151;252;62;175;763
052837491995;1;88;81;271;112;148;700
058239300891;1;93;203;290;53;98;737
056866787079;1;153;140;278;59;127;757
046988470459;1;111;217;251;90;59;728
054768027883;1;254;277;155;118;79;883
054603000897;1;246;201;234;118;89;888
020705549019;1;266;103;253;94;119;835
093868262276;1;150;148;191;50;141;680
090788973181;1;189;163;246;104;89;791
026720445398;1;130;199;199;105;131;764
045715493670;1;203;166;122;73;80;644
025864062755;1;154;177;211;107;55;704
080378544023;1;175;236;220;100;102;833
019794454533;1;101;114;147;51;113;526
006693108699;1;243;174;293;54;177;941
060164384400;1;93;268;163;54;62;640
021578332763;1;191;130;217;68;53;659
015653986279;1;222;242;234;99;78;875
025592832720;1;200;235;300;100;171;1006
052935601683;1;104;267;130;90;142;733
006463626318;1;160;263;237;88;87;835
037591949577;1;241;260;148;84;62;795
050919609646;1;94;242;289;85;152;862
041744793109;1;127;149;112;83;149;620
073574285296;1;226;95;297;105;159;882
060321501538;1;212;217;126;115;154;824
002512162529;1;186;156;116;81;54;593
035583711781;1;212;251;141;94;96;794
079843374980;1;263;138;203;63;141;808
066247981493;1;183;269;130;83;61;726
071665796873;1;185;82;146;69;117;599
050812234230;1;120;103;195;91;137;646
003616269337;1;196;149;193;68;79;685
006775241880;1;141;201;254;111;167;874
050589460322;1;246;132;209;103;63;753
044490372337;1;111;86;230;95;105;627
097353368346;1;278;126;243;62;115;824
085095022926;1;222;144;127;56;78;627
030631568752;1;121;114;177;99;166;677
032817710395;1;92;283;107;81;50;613
022404577312;1;170;122;163;92;166;713
098160469800;1;116;221;178;51;83;649
090756849465;1;187;254;257;105;133;936
074490294402;1;102;170;290;56;72;690
097997719236;1;91;262;267;63;178;861
096998232937;1;106;239;185;117;123;770
089453796641;1;238;187;98;54;92;669
084325595076;1;155;117;150;78;152;652
084372372737;1;119;130;92;50;65;456
044332333615;1;141;285;236;94;123;879
090732490639;1;109;84;267;50;106;616
044417908928;1;249;129;291;96;105;870
090376113038;1;170;258;183;97;155;863
079297584850;1;271;192;185;82;51;781
010540086800;1;171;259;152;120;155;857
002030271290;1;156;215;126;113;177;787
032213075913;1;101;166;233;112;139;751
067842427482;1;236;182;277;106;164;965
090806497839;1;125;147;269;99;73;713
024563523728;1;247;171;166;116;71;771
083087497893;1;272;178;162;99;151;862
015997644881;1;270;167;222;101;57;817
041940506522;1;196;260;228;77;113;874
097848321949;1;193;256;175;62;130;816
083246797118;1;199;157;257;110;151;874
069880964183;1;247;104;125;52;170;698
058822237418;1;108;247;289;91;93;828
043123048481;1;276;235;288;109;68;976
050468449535;1;111;147;177;106;102;643
089495538529;1;122;146;253;98;80;699
048613283985;1;228;154;112;89;108;691
089399243771;1;105;107;125;81;149;567
045677063106;1;141;101;298;100;134;774
060364069221;1;254;110;159;105;178;806
068456861655;1;83;86;125;111;132;537
038729455969;1;211;265;189;60;104;829
045446411459;1;118;85;90;79;118;490
027728396325;1;237;147;163;63;139;749
013056990697;1;205;146;229;54;52;686
046329487326;1;248;140;111;58;55;612
043782180258;1;256;227;179;89;74;825
056342690826;1;266;210;294;113;76;959
054100737963;1;286;178;225;68;86;843
078446700620;1;278;224;252;82;132;968
033968891368;1;128;246;298;100;98;870
099800831980;1;171;82;269;84;97;703
018790028943;1;139;240;300;88;130;897
070111523523;1;161;200;198;103;112;774
007336848932;1;180;230;166;83;124;783
011152831417;1;188;196;171;91;171;817
034069422593;1;170;204;124;91;70;659
044397815752;1;85;223;215;114;166;803
033983809764;1;203;182;173;83;136;777
060061458807;1;90;263;216;53;161;783
071842873084;1;144;133;276;58;97;708
019503878138;1;257;286;132;59;87;821
032064327082;1;94;115;278;96;157;740
075526395047;1;289;93;96;96;171;745
011380984499;1;130;224;93;73;149;669
069808598648;1;289;266;275;76;141;1047
096754465151;1;246;245;204;53;169;917
078397944158;1;194;85;105;103;89;576
070267909617;1;286;161;155;50;138;790
023176816571;1;131;252;122;99;150;754
056322075205;1;168;277;285;72;108;910
060792114016;1;260;270;282;87;129;1028
023383150728;1;203;172;178;64;52;669
032434472565;1;121;229;156;63;136;705
096220816042;1;272;217;153;53;161;856
060900224346;1;191;245;112;73;99;720
082191898680;1;127;273;172;59;119;750
010556821215;1;123;185;271;91;116;786
017921801708;1;172;90;113;96;173;644
055698069975;1;120;111;168;82;133;614
002661668354;1;111;166;195;77;150;699
070591485251;1;274;136;212;114;105;841
015254058279;1;92;233;227;58;104;714
078190155706;1;113;186;171;92;107;669
061349626491;1;228;135;104;86;177;730
006634854424;1;232;150;268;119;168;937
042848941182;1;90;214;288;64;174;830
000330679150;1;175;157;148;90;157;727
071247331463;1;211;163;284;88;57;803
023837072272;1;258;201;117;70;52;698
051029913182;1;89;88;265;82;135;659
068756139936;1;84;207;222;50;78;641
006363471905;1;237;287;195;98;59;876
092550243894;1;148;107;190;101;77;623
069914139215;1;223;130;149;91;100;693
055411527999;1;257;196;230;50;73;806
017477761409;1;228;241;217;51;109;846
016187645514;1;263;156;108;86;67;680
070677605907;1;95;148;247;114;138;742
095273766664;1;180;288;139;95;142;844
019112117251;1;82;258;257;113;79;789
048319330349;1;133;114;229;103;70;649
045563615453;1;238;196;105;92;95;726
047276704528;1;282;273;272;105;62;994
041502824054;1;144;163;258;106;145;816
052024692538;1;229;138;123;80;56;626
024407557166;1;198;140;140;72;150;700
093029693084;1;142;176;138;73;104;633
009086371429;1;230;227;250;77;81;865
029354747118;1;186;201;247;58;140;832
051029833209;1;93;241;95;73;99;601
038395255189;1;109;113;283;105;116;726
035978426682;1;278;223;282;54;122;959
026839194078;1;268;105;173;70;118;734
027731438690;1;84;198;145;59;131;617
061031929565;1;95;126;188;72;73;554
000342496216;1;172;125;176;119;170;762
084375470531;1;225;250;189;56;142;862
007440951022;1;210;250;212;108;130;910
044894142119;1;225;105;92;81;119;622
022303435854;1;285;250;105;108;93;841
027784370679;1;212;156;161;110;112;751
035495287461;1;251;183;252;70;175;931
031082563799;1;280;115;298;102;50;845
064957479441;1;273;277;234;94;78;956
011765705973;1;276;207;169;50;163;865
055467819219;1;219;220;161;76;55;731
001182704008;1;148;255;300;65;69;837
099198331167;1;85;203;244;62;177;771
037216427473;1;233;200;220;109;125;887
027344720089;1;174;88;153;50;165;630
033302163815;1;155;118;247;112;70;702
064225772780;1;261;140;130;55;90;676
028798201105;1;109;234;163;101;74;681
003947683562;1;254;103;271;59;164;851
056647774283;1;212;211;271;65;89;848
055027690413;1;127;210;97;118;81;633
095323339367;1;238;143;258;90;106;835
040547565079;1;174;277;270;81;58;860
064922704061;1;233;195;239;84;121;872
064814261774;1;151;184;265;82;146;828
093928302671;1;85;143;110;92;114;544
073218655002;1;190;178;113;73;85;639
051674854969;1;129;206;171;73;108;687
094721016550;1;256;158;145;65;61;685
026227936550;1;93;272;92;71;57;585
004106857697;1;80;214;288;112;106;800
079880507613;1;272;133;297;79;108;889
008207513904;1;119;116;110;88;114;547
074613188969;1;161;259;298;59;120;897
083690563413;1;208;261;113;93;90;765
092517023313;1;185;281;166;104;94;830
070619356015;1;103;203;293;112;159;870
075051414528;1;186;99;137;58;75;555
010087133721;1;93;163;256;64;132;708
016544654701;1;257;173;169;59;108;766
042151973806;1;176;168;249;53;51;697
039329884279;1;249;125;160;81;75;690
049713976835;1;270;252;134;56;61;773
034066768287;1;172;116;220;111;144;763
084416081150;1;230;255;238;94;156;973
026813932381;1;177;273;118;87;131;786
069702759338;1;123;141;226;88;55;633
042537699171;1;185;212;196;79;77;749
032211039745;1;277;97;228;56;71;729
067093781132;1;118;138;194;84;177;711
034724145994;1;202;238;218;117;146;921
067387026596;1;178;269;283;110;82;922
038460283726;1;259;165;261;77;155;917
008063282967;1;269;161;222;97;123;872
089313879364;1;131;152;118;119;165;685
074091371185;1;181;213;120;58;171;743
009594015662;1;101;209;272;64;60;706
066309048110;1;287;161;273;59;154;934
068497130756;1;175;284;203;92;84;838
052069179689;1;260;183;211;83;73;810
013139458883;1;242;185;110;66;86;689
021105169341;1;153;204;286;93;102;838
002998711076;1;220;105;269;66;57;717
027845652723;1;243;156;225;51;66;741
027696618640;1;228;190;164;86;141;809
012411089435;1;81;244;187;97;87;696
063330927471;1;130;250;272;55;109;816
063906026149;1;188;95;136;111;150;680
042361304994;1;269;84;100;70;57;580
032602590575;1;165;204;170;93;147;779
087058936553;1;152;114;171;71;91;599
072857074362;1;161;240;152;96;78;727
021792475023;1;242;120;215;114;121;812
042863559247;1;170;117;232;58;78;655
030038275433;1;214;228;95;88;120;745
004010641996;1;259;129;188;112;100;788
012522784168;1;157;275;242;116;161;951
053497769385;1;229;193;238;97;66;823
018033661327;1;169;108;120;99;96;592
011704620272;1;164;170;166;86;93;679
053889557786;1;169;261;265;53;87;835
015141445033;1;251;166;261;110;74;862
026986457534;1;174;215;212;108;177;886
003458306749;1;108;152;268;76;158;762
061164301579;1;291;120;196;120;114;841
090767035700;1;120;227;179;68;144;738
090040172973;1;161;244;153;89;65;712
083005238798;1;249;285;246;80;71;931
037722721187;1;226;156;142;107;89;720
054820428899;1;175;137;251;77;65;705
054820675462;1;94;90;101;115;56;456
077216492021;1;240;198;124;93;165;820
052457890472;1;288;235;143;65;74;805
034205919100;1;202;91;97;90;66;546
014820648536;1;200;110;173;91;79;653
073358878765;1;174;171;159;70;111;685
066292333855;1;154;225;210;97;89;775
095080683970;1;153;92;233;93;87;658
016156250641;1;266;217;167;110;68;828
004110881388;1;252;154;197;54;91;748
074184974720;1;204;267;232;116;68;887
083022216074;1;85;235;116;65;72;573
001942894830;1;92;228;221;109;166;816
077203680762;1;286;177;221;59;160;903
098269357374;1;162;97;194;78;84;615
080510485178;1;167;190;295;83;79;814
085854458266;1;117;257;296;81;82;833
016115820705;1;152;208;291;99;132;882
030022855927;1;122;239;91;82;53;587
078689234761;1;225;237;180;57;158;857
064194510235;1;224;277;105;52;133;791
042158892780;1;187;256;203;97;79;822
068758738967;1;250;112;137;99;62;660
002937289554;1;258;210;119;104;108;799
002676900211;1;136;262;134;94;176;802
096853144540;1;263;247;209;104;59;882
018718760116;1;285;175;114;57;72;703
036775688298;1;192;237;218;92;51;790
095820839645;1;287;276;283;55;136;1037
045373491694;1;276;88;117;64;57;602
000740625736;1;154;139;209;58;114;674
051346393645;1;102;111;226;115;77;631
081131965581;1;140;120;277;102;65;704
075335059277;1;230;135;166;70;101;702
024440416832;1;156;184;159;87;130;716
075744004908;1;114;182;275;112;63;746
004061497761;1;128;87;173;83;97;568
079325588137;1;101;256;269;116;134;876
034990656361;1;171;170;180;109;100;730
060908267402;1;208;231;243;105;58;845
029741215014;1;92;94;243;71;58;558
044958994110;1;89;211;225;111;138;774
069061595810;1;256;210;199;89;116;870
006619842149;1;170;286;104;68;159;787
070450552363;1;86;259;182;52;158;737
008607140900;1;147;252;281;79;126;885
090527537778;1;159;179;182;52;158;730
005268544611;1;227;96;278;74;82;757
070004045132;1;275;232;200;87;80;874
095231436684;1;138;257;157;53;176;781
035633888777;1;259;158;250;120;62;849
099136100404;1;191;210;233;69;62;765
030339862000;1;166;90;123;97;52;528
062473907579;1;134;268;149;64;81;696
046789152336;1;92;250;295;88;102;827
034582599396;1;211;206;269;61;123;870
060358512155;1;193;233;112;60;51;649
080034641480;1;233;177;185;112;79;786
063344368786;1;199;234;198;61;170;862
013591452971;1;128;212;243;104;122;809
089718766514;1;222;263;281;111;89;966
043135165516;1;89;86;251;116;54;596
099912972538;1;206;98;205;83;66;658
085186657857;1;86;209;93;110;81;579
038382098949;1;163;228;204;90;158;843
053753457569;1;289;86;201;120;54;750
077254496635;1;259;156;257;64;55;791
073343311737;1;144;197;177;116;70;704
022278579360;1;186;102;275;61;102;726
098316948395;1;88;277;233;95;131;824
072946442509;1;255;151;173;103;62;744
025723649237;1;120;146;232;90;111;699
063729132683;1;250;247;274;116;139;1026
059283494338;1;255;269;299;66;137;1026
024886594790;1;138;211;101;69;123;642
067062317039;1;247;247;220;115;153;982
093417858521;1;125;265;105;50;85;630
072088943918;1;158;90;109;93;145;595
018987377454;1;130;139;290;108;98;765
048592341343;1;158;177;252;110;66;763
009224573672;1;162;184;134;50;110;640
026975386237;1;122;189;96;87;117;611
098859357976;1;140;88;259;114;62;663
054138902376;1;211;122;282;111;84;810
023585623729;1;172;150;99;106;61;588
013516069419;1;259;156;203;52;175;845
094920873524;1;274;191;133;68;101;767
030820063249;1;250;209;110;55;54;678
079806074389;1;190;157;129;55;76;607
009646693868;1;108;149;197;51;113;618
024221565876;1;206;108;135;108;162;719
000208110312;1;219;275;252;55;170;971
044939996081;1;184;161;224;77;84;730
052771274865;1;178;162;281;89;82;792
081619752378;1;252;254;129;77;92;804
097702334443;1;258;257;289;96;166;1066
099677153437;1;118;185;239;63;176;781
029506062773;1;108;266;239;83;76;772
039947698661;1;143;251;293;99;142;928
029913059639;1;170;147;132;86;151;686
088833619929;1;223;175;274;102;150;924
071145792381;1;234;258;257;53;139;941
005081252603;1;270;92;112;99;142;715
084269824638;1;219;107;220;69;68;683
000300672944;1;141;118;145;92;79;575
051380431836;1;227;117;162;106;175;787
086878867513;1;148;129;263;82;109;731
064237449255;1;179;113;95;61;108;556
049202103056;1;120;140;263;92;175;790
063740921317;1;284;104;292;56;88;824
020493683938;1;251;137;284;91;64;827
096422954125;1;288;206;226;56;106;882
013426409715;1;80;189;127;58;88;542
073941873372;1;239;173;93;108;83;696
070030960289;1;174;220;131;65;111;701
096606118866;1;230;133;165;99;78;705
095514752310;1;239;187;212;104;171;913
073361613102;1;245;120;219;110;109;803
000746918759;1;268;213;144;96;157;878
076096895452;1;212;100;127;61;177;677
073500891455;1;136;219;234;86;155;830
058002253100;1;151;247;156;105;90;749
052508658205;1;101;228;265;61;162;817
019685269809;1;179;228;137;118;66;728
012238590398;1;209;98;95;101;153;656
060161061423;1;210;255;123;87;132;807
054775503334;1;139;105;224;103;109;680
032865341696;1;288;170;134;75;156;823
071104350340;1;205;196;104;86;58;649
077775077813;1;130;188;296;85;171;870
060119310007;1;112;98;165;111;64;550
047729257056;1;272;254;240;83;103;952
047638718158;1;157;218;225;50;137;787
065211638221;1;282;252;192;96;152;974
099356002539;1;104;163;135;90;61;553
073338453350;1;104;233;181;53;78;649
000802199035;1;123;181;191;107;50;652
072625847161;1;92;117;227;110;150;696
040869703440;1;126;130;152;86;98;592
091799208775;1;207;214;199;114;159;893
076538858928;1;138;89;102;113;141;583
058634241275;1;187;255;282;87;160;971
029583914806;1;289;99;292;97;79;856
053619740808;1;112;169;206;87;157;731
052581032362;1;246;120;203;65;104;738
095356897895;1;272;219;154;103;94;842
022864831599;1;284;233;278;75;116;986
069721900079;1;98;121;136;57;165;577
066924788741;1;172;84;161;114;139;670
001561612950;1;170;225;113;90;132;730
040857779553;1;178;225;104;68;142;717
040713228196;1;107;127;149;69;117;569
098811604586;1;287;243;277;88;80;975
009436909214;1;127;157;100;52;56;492
033434728498;1;92;91;168;106;101;558
065826442205;1;132;220;175;61;87;675
047433819062;1;118;177;215;79;174;763
031553681542;1;252;102;224;76;54;708
006754967504;1;142;134;243;93;128;740
061284032930;1;272;144;97;85;52;650
084501807022;1;225;167;117;71;98;678
044415772936;1;256;250;284;97;112;999
051317267844;1;192;90;277;63;121;743
086355312971;1;131;216;159;91;117;714
057490795688;1;245;88;155;70;97;655
058876346997;1;243;267;238;67;168;983
072854131785;1;94;251;162;101;120;728
021108173416;1;84;246;296;93;148;867
005844068628;1;201;284;214;98;77;874
065857268426;1;291;138;179;91;52;751
047883010169;1;136;234;200;111;76;757
030149519778;1;237;216;237;116;148;954
073047611377;1;223;177;189;64;86;739
092167035024;1;271;141;218;107;137;874
028061362410;1;110;206;168;111;123;718
067639783850;1;281;223;98;90;62;754
005494913676;1;190;122;270;65;163;810
011113693270;1;105;286;182;55;177;805
019606370431;1;259;235;273;100;173;1040
084302847213;1;186;204;199;58;70;717
027779501473;1;114;213;278;105;95;805
012816421835;1;188;284;184;52;132;840
099913556564;1;123;127;235;109;131;725
077612511612;1;243;250;148;115;166;922
068862823725;1;144;197;268;90;63;762
023591894413;1;85;196;122;98;85;586
076383959454;1;221;221;97;72;128;739
045399858291;1;127;106;261;103;98;695
049121311271;1;153;174;112;103;116;658
095209131351;1;106;218;201;82;115;722
009483836925;1;147;206;187;52;128;720
030558068904;1;169;81;122;101;139;612
022563000149;1;224;197;204;93;71;789
014208194099;1;248;172;156;74;164;814
011807482190;1;130;218;281;54;109;792
065104562541;1;218;96;178;102;52;646
001438297439;1;166;280;171;52;102;771
066719595692;1;290;109;238;69;58;764
078183144218;1;84;154;153;92;178;661
091295312323;1;186;150;172;58;53;619
051045712893;1;159;104;225;107;114;709
090090179940;1;118;165;277;62;84;706
035843695556;1;278;97;253;93;151;872
057376344811;1;223;214;101;51;82;671
022191403865;1;243;199;166;81;77;766
090304246782;1;236;130;216;87;130;799
049549581983;1;291;268;209;79;74;921
061660076863;1;243;160;183;104;77;767
081315659383;1;103;265;134;108;88;698
032194277952;1;107;173;158;79;131;648
099607506588;1;178;203;230;78;158;847
048308520430;1;202;102;91;111;82;588
036806994195;1;199;119;290;76;109;793
013094818150;1;91;144;182;58;156;631
045580801007;1;86;232;108;78;108;612
057611041068;1;134;194;103;77;93;601
014502208221;1;175;111;161;61;68;576
055296170020;1;260;199;286;84;159;988
070175014457;1;273;226;203;76;81;859
059253650108;1;288;173;143;110;166;880
047706221500;1;230;125;238;90;118;801
071696808699;1;266;283;105;70;106;830
082757992270;1;207;202;178;90;77;754
021215315056;1;164;185;93;115;96;653
044444917290;1;281;211;202;88;111;893
040790634653;1;245;227;102;62;146;782
080817591265;1;197;173;296;88;134;888
007615196496;1;186;148;157;97;167;755
041530963081;1;291;239;230;51;103;914
060593418221;1;99;174;152;90;124;639
032004156531;1;262;228;99;101;103;793
033629394198;1;190;282;245;73;150;940
094955898139;1;192;184;210;85;124;795
012345844307;1;281;247;195;87;142;952
007094784445;1;270;137;269;107;92;875
084501420308;1;98;104;90;103;157;552
084138691304;1;129;262;252;62;75;780
069017827629;1;144;199;252;63;151;809
052006212723;1;272;237;201;71;135;916
028286740397;1;160;171;225;103;149;808
071262330799;1;183;158;275;99;86;801
067463999106;1;136;211;186;97;56;686
017759971169;1;219;152;278;61;122;832
033179391771;1;280;87;164;96;111;738
085502896659;1;192;195;158;99;108;752
074884461579;1;184;165;120;75;102;646
008012891317;1;212;278;258;110;143;1001
055455334604;1;272;129;248;93;127;869
082958427056;1;87;121;122;66;82;478
069152933230;1;154;282;167;57;66;726
032190026281;1;155;152;216;57;163;743
064653893372;1;195;229;142;84;153;803
034274474102;1;200;168;297;64;82;811
034031263454;1;109;161;216;102;156;744
000394623880;1;172;261;181;112;174;900
055985960672;1;146;261;147;117;174;845
083229966472;1;218;143;242;116;53;772
017597277156;1;149;87;137;63;58;494
008823748710;1;87;176;285;110;73;731
092981654208;1;206;118;142;117;92;675
065328474952;1;223;192;133;86;80;714
013975166917;1;266;180;258;109;178;991
085349838647;1;117;214;286;61;123;801
003428032569;1;140;192;269;106;128;835
035240307351;1;218;81;251;99;122;771
066249282505;1;144;207;189;80;51;671
027372875934;1;171;271;300;107;176;1025
091017299551;1;237;143;142;54;165;741
073235315289;1;177;247;193;115;113;845
007324968092;1;89;177;121;62;112;561
040203060082;1;105;175;145;86;50;561
051779418993;1;277;178;191;64;98;808
032531958292;1;190;148;284;79;128;829
040200740971;1;105;81;130;58;50;424
045500875477;1;158;100;114;61;130;563
033223196729;1;228;142;217;65;101;753
045965957199;1;100;118;267;97;114;696
002408673416;1;90;144;140;89;135;598
048084969721;1;288;196;132;54;145;815
080426633657;1;285;142;155;65;62;709
060705238585;1;101;219;292;106;60;778
069905051579;1;170;259;182;80;154;845
041630449381;1;228;110;165;104;135;742
003241423130;1;190;166;283;66;87;792
017319088531;1;242;238;172;76;146;874
018861162845;1;217;217;260;91;72;857
046344314434;1;286;260;189;87;62;884
037419354656;1;292;269;132;55;118;866
085988918988;1;116;101;175;72;161;625
090322610455;1;92;254;287;96;78;807
023221264973;1;238;231;231;101;75;876
098053318459;1;176;150;152;98;154;730
068468568519;1;124;158;281;59;144;766
018891681931;1;236;269;216;74;106;901
089609491952;1;204;230;260;87;90;871
081280236724;1;165;186;230;91;104;776
017159837873;1;191;170;135;80;103;679
072016280397;1;262;134;195;53;124;768
023821480364;1;194;251;119;117;120;801
051167544301;1;168;225;104;89;121;707
019679643895;1;234;110;146;98;70;658
062373186968;1;235;190;274;100;160;959
069575667222;1;102;156;208;93;131;690
055240139297;1;150;253;132;65;69;669
063175393553;1;153;200;118;114;117;702
087920111051;1;244;160;256;78;167;905
093477822564;1;80;255;116;106;152;709
047590205076;1;136;209;151;76;134;706
051502725654;1;186;223;218;97;176;900
016130414695;1;219;267;154;86;146;872
004177895542;1;209;162;123;75;50;619
036454549711;1;181;147;273;82;73;756
033997516122;1;197;99;283;68;160;807
018502661272;1;125;180;147;119;100;671
070154916070;1;287;269;168;94;178;996
066800595445;1;237;199;219;102;157;914
062867158436;1;129;223;205;69;104;730
066505451364;1;261;118;194;109;172;854
072433598405;1;262;105;127;104;127;725
020143661097;1;201;234;262;101;68;866
008743287002;1;158;269;245;114;139;925
071445479492;1;207;202;123;59;88;679
023859945587;1;188;173;197;63;87;708
096066128955;1;126;87;135;92;92;532
041542927139;1;132;211;145;53;53;594
055203332550;1;223;274;298;80;68;943
032491010406;1;127;103;134;112;85;561
091430037747;1;144;213;191;57;101;706
021795487469;1;123;189;230;66;59;667
030736573869;1;227;110;230;72;74;713
021959370446;1;196;173;168;62;97;696
078230080098;1;83;164;201;54;151;653
028444654457;1;125;235;188;108;171;827
095056203999;1;154;165;212;93;169;793
041346111239;1;103;138;254;64;118;677
057553832867;1;87;88;260;117;152;704
061920317863;1;176;267;258;100;123;924
077130037921;1;105;212;99;119;162;697
070418566791;1;251;176;147;85;154;813
023800277007;1;208;270;230;52;50;810
012492767558;1;143;233;271;99;143;889
071691804147;1;229;189;200;112;98;828
084758573461;1;142;197;109;56;168;672
002979033127;1;215;167;215;52;85;734
065149270931;1;141;271;242;119;133;906
047929992272;1;136;251;107;70;56;620
029386905788;1;178;181;189;120;162;830
045948286269;1;104;118;249;98;87;656
059171647778;1;107;251;121;96;103;678
016291891990;1;206;137;177;116;65;701
076659547283;1;210;98;240;111;167;826
071090418815;1;144;182;268;91;164;849
000481055816;1;287;144;176;109;177;893
012794809721;1;205;122;101;60;113;601
055122519140;1;247;261;94;118;119;839
035740941118;1;195;178;182;77;53;685
035442993110;1;81;96;207;97;80;561
064494880495;1;231;237;233;84;50;835
066640787431;1;115;201;154;61;116;647
095923037620;1;178;191;159;88;71;687
014800330212;1;260;143;161;72;86;722
030920204653;1;233;201;272;81;81;868
075130208867;1;249;238;188;107;136;918
088697511461;1;251;140;264;72;95;822
011156482963;1;187;192;190;87;147;803
002379737100;1;278;288;279;85;92;1022
078189782479;1;83;187;252;99;145;766
086454266292;1;118;280;161;106;137;802
040281319407;1;102;270;132;100;152;756
040455983686;1;132;127;156;50;76;541
080519738374;1;289;282;210;88;51;920
028113179356;1;227;117;243;91;62;740
059780357393;1;220;97;248;52;84;701
059871684575;1;236;203;142;110;104;795
069272859027;1;128;137;255;116;144;780
021649945949;1;151;189;111;51;104;606
075077365447;1;250;82;170;51;108;661
080753881884;1;194;209;259;90;65;817
028635199801;1;237;191;149;54;93;724
095480038011;1;276;118;171;113;64;742
092255362318;1;183;202;280;73;87;825
098434421144;1;125;236;279;53;177;870
082285840037;1;202;156;227;53;162;800
046683297505;1;245;126;253;90;53;767
072036455456;1;114;153;264;73;161;765
032280313100;1;270;167;112;51;62;662
098898125734;1;288;91;202;59;143;783
002002741369;1;226;205;173;56;52;712
071741589406;1;275;115;127;71;90;678
005490342295;1;86;233;213;95;153;780
037921070698;1;254;283;179;106;166;988
068264087651;1;226;183;195;102;160;866
061459433804;1;208;257;184;61;161;871
048671592275;1;256;189;263;100;73;881
019740318022;1;219;187;101;93;87;687
004353193727;1;244;256;226;96;73;895
010435890254;1;165;241;123;67;51;647
064134544279;1;131;224;93;113;63;624
064051867874;1;290;204;282;92;147;1015
030895217635;1;274;247;280;115;93;1009
044510196931;1;157;208;187;116;61;729
007941124516;1;192;223;137;82;133;767
034697415228;1;210;170;253;118;60;811
013636459556;1;292;282;202;79;168;1023
077362606150;1;205;256;166;113;54;794
028901205442;1;85;127;92;120;129;553
037875708051;1;251;221;282;111;81;946
087333237552;1;257;109;172;120;140;798
023018156959;1;266;261;216;78;97;918
008838830582;1;119;185;239;67;69;679
087270923168;1;221;243;156;71;167;858
019285756886;1;271;173;163;109;164;880
011855023016;1;94;139;104;51;53;441
094311880482;1;153;122;219;85;133;712
092928337396;1;218;101;221;118;64;722
066168892677;1;233;114;198;104;115;764
068512501353;1;107;142;90;102;116;557
002116483568;1;150;233;201;73;82;739
096325208572;1;151;172;225;84;155;787
092399354248;1;147;221;289;119;126;902
004128994138;1;82;131;170;57;63;503
030532240176;1;103;222;121;117;126;689
016015410302;1;255;85;145;70;167;722
042703489722;1;172;112;102;94;102;582
019744388496;1;264;269;199;65;112;909
032573684237;1;180;140;230;100;105;755
007784478445;1;85;125;232;60;148;650
038655013448;1;240;175;147;94;69;725
075849669130;1;273;140;180;79;125;797
063756460720;1;188;110;214;115;121;748
046898481548;1;86;274;116;62;161;699
066254780235;1;244;198;188;59;140;829
082436803187;1;276;253;193;100;82;904
023219965905;1;153;115;292;91;62;713
062031846069;1;223;161;275;95;144;898
079645153814;1;180;212;216;79;150;837
062005841387;1;279;102;288;87;84;840
081275400529;1;241;246;218;102;74;881
018847741511;1;169;140;194;112;154;769
058421597995;1;229;181;255;109;87;861
090798164842;1;140;136;223;91;98;688
061478677979;1;262;272;268;68;87;957
046058071789;1;233;232;125;60;176;826
033287696126;1;181;269;188;88;137;863
023842986228;1;198;113;242;110;63;726
087580536580;1;201;139;90;72;149;651
085816239225;1;211;243;112;77;144;787
032723939468;1;209;286;176;95;111;877
045014763674;1;199;253;162;87;166;867
019156555723;1;162;153;93;78;71;557
069998858030;1;166;219;122;94;156;757
091695266486;1;185;178;177;77;73;690
081561207519;1;90;89;144;103;78;504
013585351632;1;276;104;217;73;107;777
014669237260;1;205;88;172;110;112;687
037283360723;1;274;239;291;67;62;933
099937813204;1;97;99;219;57;58;530
029573224607;1;86;139;226;112;122;685
022026051575;1;244;190;111;92;162;799
083171897793;1;86;213;257;106;64;726
050956617812;1;155;263;102;56;178;754
081209779272;1;204;98;256;79;122;759
075507955026;1;87;229;233;118;127;794
061525788722;1;146;152;216;80;78;672
023426708697;1;194;279;131;115;175;894
068345628798;1;230;268;156;111;142;907
090717966480;1;279;98;163;59;51;650
065021622572;1;131;219;232;96;161;839
073869226529;1;130;109;113;105;123;580
049205709046;1;165;98;232;78;98;671
055138144279;1;249;179;163;112;50;753
017716022427;1;84;204;279;55;109;731
086033135012;1;203;84;158;84;104;633
063155640923;1;241;271;264;84;164;1024
029232118531;1;230;115;219;107;50;721
014984400949;1;188;181;116;51;90;626
067552260284;1;276;86;201;57;146;766
079933658419;1;151;99;131;70;78;529
013983074706;1;260;188;257;116;128;949
095901581405;1;127;110;221;109;150;717
038728341505;1;157;100;172;79;50;558
029362630320;1;81;271;134;81;135;702
026447713018;1;213;135;225;54;143;770
047323410989;1;131;234;186;69;141;761
071741274535;1;181;265;131;80;128;785
093613165040;1;232;108;265;83;140;828
019020066154;1;235;247;115;57;165;819
015612625445;1;115;250;175;108;163;811
004255056573;1;292;108;131;115;51;697
085474909288;1;148;137;212;81;105;683
019026732823;1;185;178;205;96;137;801
078803026131;1;252;90;272;88;172;874
041810932869;1;94;276;280;99;134;883
001048375776;1;268;263;185;59;91;866
079910062794;1;109;118;170;50;87;534
041543105779;1;174;171;148;113;129;735
071816341713;1;245;84;233;72;82;716
038364523985;1;152;239;285;52;108;836
045738286397;1;203;161;299;91;141;895
091790069545;1;261;159;103;54;67;644
064872543663;1;196;273;101;112;83;765
041084982138;1;137;184;200;87;96;704
041290339394;1;190;172;285;81;146;874
069995176971;1;147;143;203;82;61;636
030687043940;1;164;252;178;67;138;799
064357232813;1;95;276;202;53;141;767
008556333762;1;238;270;113;57;134;812
047373811019;1;262;283;121;54;51;771
064936144005;1;272;258;230;69;92;921
045362246056;1;143;196;231;76;99;745
062289988941;1;178;113;178;98;82;649
068979282808;1;133;133;291;112;140;809
061278970122;1;197;109;187;55;159;707
034688252855;1;113;190;243;103;85;734
068643204357;1;208;276;139;52;124;799
016668771282;1;217;229;293;69;101;909
020208865424;1;98;167;251;67;103;686
073656616348;1;89;214;161;89;64;617
045972545509;1;101;113;150;113;176;653
000911134709;1;112;107;97;69;175;560
083739337166;1;229;262;280;70;61;902
000942149353;1;187;131;153;70;58;599
056758584251;1;204;183;226;96;79;788
055890221476;1;151;179;107;77;63;577
098558828558;1;166;204;194;105;74;743
082577388512;1;262;161;231;93;53;800
033831855840;1;207;246;122;118;141;834
011319123611;1;92;126;211;105;68;602
078779595978;1;174;158;100;75;141;648
014619310074;1;110;195;208;57;136;706
067110887357;1;160;231;255;65;155;866
021004000392;1;183;244;205;109;83;824
071177138090;1;92;180;241;96;63;672
065150740993;1;217;221;203;92;125;858
034788561744;1;276;169;128;55;94;722
072802404776;1;151;145;155;101;169;721
070050804883;1;213;211;164;69;136;793
088364209697;1;229;234;117;114;53;747
001939466068;1;157;250;146;100;127;780
033860963958;1;233;176;242;120;66;837
042474629133;1;274;236;187;50;96;843
093043127772;1;275;113;133;114;141;776
019351232527;1;226;185;249;83;120;863
054946797307;1;131;111;172;96;168;678
061370679292;1;111;150;276;115;91;743
006229044052;1;202;106;228;95;175;806
036437787051;1;184;157;152;63;156;712
017980162458;1;197;116;234;77;161;785
033217870443;1;225;143;165;96;96;725
008378888730;1;269;115;179;61;64;688
031989033691;1;145;109;153;55;137;599
055291041390;1;224;236;167;101;162;890
027182127107;1;245;158;188;66;113;770
039820812609;1;123;94;164;111;150;642
059596010055;1;236;238;268;113;115;970
056698596788;1;253;209;133;115;124;834
028575384528;1;279;234;196;54;177;940
039927651122;1;222;165;195;77;50;709
068638056626;1;183;165;118;57;177;700
009599148504;1;290;137;286;54;57;824
011021357021;1;214;286;211;50;90;851
086401735376;1;170;217;251;73;59;770
091540282906;1;149;160;267;96;159;831
068731530635;1;200;92;191;106;107;696
053682755610;1;188;193;186;107;153;827
045953753573;1;270;174;249;57;169;919
046290134066;1;108;196;290;108;161;863
025400799380;1;175;99;139;112;156;681
062030723339;1;287;218;181;120;157;963
031173682178;1;249;198;220;78;140;885
023298095016;1;257;255;100;99;141;852
031006058816;1;89;164;197;78;174;702
026903816533;1;94;280;130;81;98;683
021518859395;1;102;251;242;103;178;876
022264488006;1;209;159;249;113;166;896
073223805894;1;216;124;245;81;173;839
056168656466;1;138;253;193;71;78;733
052531533258;1;212;102;131;75;175;695
098954965622;1;188;87;94;86;111;566
037410028751;1;223;222;111;85;79;720
005180400051;1;140;81;137;117;84;559
091908414072;1;186;116;134;116;60;612
028932589865;1;277;204;155;120;127;883
096010211284;1;92;207;118;81;72;570
090178911208;1;223;236;158;85;142;844
050710974719;1;197;95;260;79;82;713
008368265048;1;156;119;276;91;62;704
064663488321;1;192;230;282;102;87;893
044517090410;1;110;220;181;71;95;677
072860106665;1;157;279;268;63;137;904
001165548259;1;173;82;228;51;77;611
032716851325;1;156;283;282;98;66;885
006525740995;1;93;134;98;56;121;502
012827215956;1;195;180;140;109;103;727
042959340994;1;264;101;182;55;68;670
042498257786;1;219;162;100;61;159;701
090136498493;1;213;257;258;69;91;888
069625585279;1;125;126;297;62;87;697
029809082304;1;85;193;165;101;166;710
002312405304;1;291;89;94;81;76;631
062916360864;1;235;161;251;103;171;921
096377856518;1;189;136;299;77;52;753
024830800777;1;227;109;251;102;152;841
043767760237;1;257;175;173;114;59;778
009130882697;1;110;113;208;93;58;582
060306695297;1;248;231;211;87;68;845
046318291151;1;258;224;276;120;150;1028
015129534744;1;247;98;102;113;120;680
099522949050;1;232;106;186;73;84;681
067706286376;1;203;245;166;115;173;902
012822561450;1;281;193;259;112;59;904
083405064777;1;81;269;233;87;162;832
054649586031;1;103;96;98;85;109;491
052637087886;1;279;121;193;64;60;717
084451372401;1;192;182;164;94;164;796
015169331918;1;280;141;262;104;176;963
093407900871;1;86;186;212;116;118;718
061914470515;1;223;282;177;52;176;910
085243384461;1;164;271;155;69;129;788
080038464111;1;233;138;197;74;126;768
092800795556;1;237;196;198;68;70;769
017134899073;1;288;198;292;66;64;908
075760085633;1;160;199;94;59;130;642
070928449750;1;193;265;109;71;82;720
096692364674;1;103;111;193;105;168;680
038219822365;1;130;242;295;105;61;833
001105992159;1;266;206;173;118;66;829
099003949262;1;96;270;127;72;105;670
039797562993;1;123;265;233;79;134;834
094747856137;1;280;158;187;69;71;765
054198605155;1;94;128;208;97;119;646
070982549383;1;120;190;132;69;147;658
002118954075;1;93;286;92;72;173;716
074804959799;1;282;285;260;119;90;1036
060766501119;1;204;283;249;57;124;917
031775356788;1;231;191;284;64;164;934
096182704486;1;142;235;257;57;51;742
028576880876;1;141;220;206;120;133;820
099784040368;1;225;279;265;115;100;984
009427073521;1;278;243;172;80;88;861
034330408496;1;136;135;204;59;148;682
086473647689;1;275;164;262;55;92;848
045210470474;1;163;99;183;90;156;691
037776627448;1;286;186;123;65;79;739
000051582651;1;121;276;144;50;146;737
060665882247;1;159;117;243;80;138;737
084074754310;1;209;229;275;119;129;961
044363826681;1;80;179;102;79;130;570
094379918109;1;155;234;145;109;151;794
037907145666;1;251;100;172;112;100;735
090598004418;1;232;157;147;66;66;668
048940624168;1;149;216;177;80;176;798
075970190650;1;191;216;298;72;121;898
038509537770;1;87;168;105;56;176;592
021222031553;1;83;254;169;96;129;731
041290022596;1;237;143;280;92;155;907
014676438606;1;280;217;276;102;87;962
096255332957;1;193;284;295;60;151;983
055982894146;1;179;210;136;69;82;676
002280883877;1;123;219;292;69;128;831
059591108659;1;242;191;142;104;96;775
038147982854;1;292;235;261;65;89;942
079075246109;1;239;162;130;99;97;727
003927103162;1;131;254;211;71;138;805
034106484605;1;202;170;117;65;139;693
035336633337;1;236;252;189;120;61;858
076497028654;1;194;207;168;88;105;762
038946825311;1;81;203;259;91;144;778
031783094743;1;107;256;286;64;167;880
027140213443;1;87;139;206;102;168;702
004944364610;1;237;255;148;101;145;886
034461340749;1;83;106;225;116;97;627
047420961418;1;230;232;157;81;162;862
077799553881;1;162;204;166;93;146;771
004182943781;1;174;252;221;79;83;809
052269368661;1;97;167;242;97;117;720
097592136193;1;169;237;115;119;93;733
032551268016;1;140;123;297;52;126;738
027070572746;1;225;112;151;71;123;682
015367181094;1;177;206;191;112;52;738
003079890955;1;184;229;95;68;84;660
015619674270;1;247;228;142;75;150;842
072743420309;1;208;194;157;106;79;744
092090264804;1;137;116;213;62;163;691
029112812273;1;181;233;148;71;56;689
021534274688;1;234;151;188;120;111;804
063849258427;1;254;229;245;119;95;942
085426591110;1;182;105;107;119;90;603
037770061426;1;210;150;276;77;161;874
059363800426;1;182;157;261;88;93;781
096887897851;1;206;246;285;100;50;887
001742456919;1;164;285;186;51;52;738
064147173340;1;274;244;168;57;54;797
088080667460;1;279;164;204;110;178;935
022872430347;1;275;191;138;102;117;823
086207253582;1;286;265;264;114;155;1084
004773844088;1;107;175;114;117;92;605
074170260310;1;207;246;139;102;144;838
019445871709;1;200;256;193;62;134;845
044835153948;1;145;145;198;79;60;627
034493554703;1;291;246;284;97;130;1048
084407800280;1;255;240;124;61;75;755
027706108350;1;238;261;161;105;127;892
055552669840;1;145;176;250;86;173;830
050239618091;1;172;130;280;113;109;804
030628984406;1;129;278;153;92;92;744
079964107199;1;213;271;235;116;99;934
054426307112;1;283;257;284;52;78;954
030500842559;1;230;104;94;69;101;598
092156243925;1;163;246;154;53;176;792
012099327279;1;113;144;188;84;172;701
019666724244;1;172;208;151;111;51;693
045523926822;1;210;169;214;79;142;814
038622037250;1;155;100;266;64;162;747
082094733542;1;221;98;258;60;172;809
077286737346;1;154;84;197;62;57;554
024928612967;1;245;285;246;115;161;1052
005999667637;1;168;287;157;59;150;821
046933468455;1;234;144;122;77;170;747
028158710119;1;256;98;159;109;151;773
097891823010;1;210;191;217;54;129;801
082601582451;1;266;158;153;114;147;838
020727613478;1;258;106;104;107;112;687
067341002751;1;250;85;172;54;77;638
099162152460;1;183;266;245;82;154;930
028572392244;1;90;240;97;80;121;628
035551974390;1;212;216;256;63;129;876
056400758413;1;165;213;245;61;130;814
012007789817;1;140;238;298;61;176;913
086604533145;1;226;144;231;67;164;832
099421359338;1;190;85;232;58;91;656
075165092527;1;112;96;164;57;119;548
026683171591;1;234;87;120;61;124;626
070794389802;1;219;248;245;58;53;823
076370716998;1;222;280;266;72;145;985
036968431468;1;120;190;241;112;157;820
094722965953;1;256;275;94;82;168;875
096981111280;1;190;158;293;66;159;866
072419475252;1;110;168;256;104;148;786
035102607853;1;116;211;188;92;107;714
032507044312;1;100;166;94;110;83;553
039743191116;1;184;257;98;100;163;802
075599828140;1;207;160;233;84;107;791
043583357234;1;179;264;254;77;92;866
013112271898;1;283;206;288;67;110;954
039673193940;1;200;202;140;97;147;786
018398138556;1;85;286;109;105;154;739
090201471016;1;94;83;199;60;122;558
050768953972;1;229;168;104;86;175;762
059316518813;1;135;267;238;111;128;879
050239924992;1;95;163;225;108;108;699
035346849779;1;285;87;103;98;170;743
070132734056;1;149;143;290;61;92;735
051238759925;1;263;80;225;79;152;799
088647127294;1;254;232;147;89;110;832
002811943894;1;251;182;98;102;62;695
060522245461;1;164;169;193;84;153;763
020835152488;1;170;126;276;51;62;685
054922172717;1;246;279;256;79;121;981
074098270054;1;134;214;178;58;160;744
049095937326;1;241;123;193;83;175;815
006073636635;1;226;147;137;113;117;740
006503610690;1;266;208;128;76;121;799
068695142026;1;199;206;280;61;172;918
031120619920;1;84;200;199;91;110;684
048611223913;1;152;279;243;74;61;809
074925072652;1;282;125;180;93;88;768
011633056062;1;178;130;282;61;169;820
067844980977;1;229;192;138;91;161;811
020839726416;1;262;89;236;89;117;793
025601991551;1;128;244;142;118;147;779
029369713581;1;239;240;91;118;66;754
078103830628;1;288;228;126;90;141;873
073035991084;1;179;210;170;65;76;700
025774941289;1;133;223;172;63;70;661
072253668029;1;290;247;178;65;69;849
021447246155;1;132;218;109;109;91;659
015743501862;1;260;156;279;97;137;929
013898438495;1;141;171;280;51;160;803
058825179637;1;254;215;284;71;172;996
093065866260;1;174;106;154;78;169;681
060263187407;1;233;279;287;64;103;966
081876609797;1;216;101;168;116;120;721
008502549795;1;235;288;144;101;150;918
071102629027;1;81;86;126;55;128;476
097922461484;1;160;255;185;59;120;779
014848395831;1;83;163;167;52;112;577
007916997492;1;175;94;117;58;112;556
069571752298;1;170;231;292;110;81;884
049431324073;1;102;186;188;95;163;734
000618029930;1;207;193;168;115;69;752
057515250309;1;230;143;181;82;103;739
073657634064;1;291;221;153;80;55;800
038162660657;1;91;188;167;51;167;664
049205338025;1;241;176;170;50;115;752
042961475165;1;241;175;163;117;57;753
039424610735;1;261;261;260;92;58;932
046266821169;1;234;171;230;53;77;765
018114492474;1;162;210;220;73;101;766
046345704559;1;284;228;154;80;153;899
059537738404;1;185;165;159;109;162;780
044830578747;1;184;219;260;74;61;798
070873580274;1;230;163;201;70;88;752
014416285277;1;140;224;188;114;101;767
051758151881;1;135;209;191;69;163;767
083806887432;1;134;275;103;78;74;664
012266293220;1;153;127;277;54;125;736
059906619536;1;242;248;176;72;85;823
057027791826;1;123;102;200;92;141;658
059501720836;1;168;153;241;59;144;765
092736708058;1;204;196;232;58;157;847
031079443603;1;115;185;127;100;50;577
022304199096;1;266;106;174;68;105;719
089471825713;1;89;216;294;76;117;792
071101162397;1;178;269;238;92;90;867
097428711961;1;115;254;99;98;136;702
002856411509;1;276;163;212;50;178;879
071442293011;1;86;210;253;94;176;819
031390466154;1;222;142;263;97;94;818
096515228714;1;212;169;134;66;96;677
077779333450;1;158;208;168;69;170;773
058378805640;1;271;183;122;65;74;715
027883138477;1;153;260;180;95;63;751
077635848076;1;278;209;276;96;101;960
060315349128;1;131;265;132;74;135;737
023421913927;1;283;87;167;98;56;691
009057846148;1;95;157;118;53;61;484
035787863244;1;130;244;297;85;136;892
097653084088;1;180;82;250;75;122;709
096427779495;1;275;190;108;103;116;792
065330971048;1;184;218;211;82;50;745
048390747689;1;159;149;245;63;129;745
097435886628;1;262;202;158;63;133;818
041756937782;1;232;224;266;82;174;978
013583315257;1;117;278;144;101;60;700
059395351394;1;187;81;286;109;128;791
050269805624;1;160;187;185;115;116;763
017426230093;1;203;151;166;76;168;764
065281192393;1;262;82;299;108;52;803
056039529844;1;108;172;153;70;61;564
046987557187;1;160;234;182;67;138;781
017798685598;1;163;108;105;64;104;544
019131337545;1;131;161;256;111;139;798
096138741586;1;262;246;93;66;110;777
057555636863;1;140;84;222;75;59;580
040506248578;1;118;91;216;52;158;635
075958328864;1;180;130;251;112;134;807
029656056220;1;187;122;187;114;110;720
045401998784;1;214;126;201;58;61;660
011280452330;1;189;282;104;106;94;775
012988254732;1;212;87;282;109;116;806
038739319209;1;160;130;189;87;142;708
016136171993;1;130;97;114;59;53;453
099383378862;1;123;158;183;64;101;629
030460486198;1;260;147;99;76;112;694
095495788736;1;205;174;177;70;109;735
032537436176;1;126;170;196;63;171;726
024629212803;1;222;100;101;83;160;666
016957220885;1;115;177;200;86;95;673
031275627245;1;96;103;296;91;112;698
005977801541;1;273;100;300;79;64;816
079751344799;1;198;175;105;91;154;723
008894697736;1;210;234;191;103;139;877
075629718309;1;168;108;197;119;131;723
066437013380;1;158;118;143;90;127;636
026425859077;1;96;90;154;83;83;506
033900772869;1;229;118;261;97;117;822
017757021470;1;217;152;173;99;171;812
091596747496;1;197;126;150;100;143;716
047053582103;1;87;94;151;57;113;502
027574840868;1;108;148;293;96;145;790
087301624364;1;137;157;117;83;115;609
054674516580;1;201;217;180;107;115;820
020278522023;1;260;80;111;85;62;598
056312757017;1;131;226;294;71;71;793
056322121446;1;176;288;299;119;148;1030
064321478924;1;225;283;120;79;172;879
039259345807;1;261;107;252;99;97;816
005462292081;1;138;187;251;59;94;729
041737094744;1;179;81;298;83;122;763
001858254536;1;151;87;145;61;175;619
087281208855;1;209;268;170;120;83;850
077993247208;1;251;253;208;104;107;923
097237176653;1;247;189;199;107;132;874
077080026567;1;281;153;256;100;82;872
007658232973;1;252;119;110;57;138;676
016366495090;1;87;217;268;105;71;748
055302767251;1;179;231;123;61;152;746
083986022090;1;275;84;125;116;152;752
037418539289;1;167;266;230;87;55;805
029140025330;1;132;171;195;59;96;653
020777180224;1;101;112;185;113;143;654
061512050769;1;138;203;208;77;166;792
006322650871;1;166;244;137;112;146;805
052698530477;1;164;192;135;85;151;727
053852607855;1;186;184;168;54;160;752
098129416777;1;245;228;174;68;121;836
071066324127;1;216;133;132;102;124;707
048320865129;1;281;184;295;103;71;934
086494652649;1;129;121;101;58;66;475
065642036695;1;163;162;222;104;95;746
050664060817;1;151;144;181;119;177;772
044080840828;1;263;227;119;115;178;902
008094903942;1;106;213;109;93;143;664
027247050237;1;200;274;245;74;50;843
013434751022;1;156;227;111;99;50;643
090466132340;1;162;276;292;105;140;975
011816798160;1;140;109;90;98;107;544
019654807069;1;218;126;244;98;112;798
057439662591;1;251;133;101;110;57;652
038623536977;1;292;93;134;107;51;677
011673138402;1;80;239;201;71;71;662
007608248378;1;173;88;237;74;123;695
077950513048;1;216;102;175;64;66;623
022150778986;1;280;147;289;81;100;897
025338363140;1;249;175;161;111;107;803
042665588382;1;193;212;269;107;58;839
040875395630;1;223;226;127;119;106;801
018353244401;1;194;261;147;85;134;821
045661319348;1;189;189;157;92;110;737
055106808082;1;172;176;271;116;150;885
094607519558;1;216;119;173;56;92;656
096001064777;1;204;135;241;97;160;837
091168116591;1;146;126;300;79;76;727
040456846468;1;237;195;285;60;160;937
004796917969;1;248;209;153;64;138;812
069030775514;1;175;213;155;64;66;673
056759358854;1;144;239;158;91;167;799
086490126051;1;231;133;162;88;77;691
041451752996;1;250;257;292;107;143;1049
064210057850;1;126;122;217;80;168;713
004354863960;1;259;241;155;65;164;884
015938679470;1;199;107;212;61;125;704
009934239778;1;139;129;184;120;112;684
011590496072;1;247;133;144;73;144;741
039925589803;1;154;271;92;75;116;708
012976020712;1;81;199;175;101;83;639
059586889232;1;221;169;278;70;92;830
099058694404;1;289;107;263;107;94;860
031679087865;1;146;136;161;78;84;605
087024688396;1;173;94;200;102;143;712
069805636630;1;119;253;173;112;74;731
030029891483;1;271;160;112;118;142;803
026015173579;1;185;207;106;97;98;693
051526269056;1;133;178;216;62;118;707
073461511005;1;98;199;169;65;136;667
072221408059;1;210;83;293;90;132;808
007361251411;1;239;196;139;100;115;789
029912707976;1;192;131;258;108;144;833
054314052240;1;189;124;279;85;80;757
049702886393;1;229;83;233;97;124;766
034231911920;1;139;124;297;117;123;800
013628229676;1;110;234;245;86;87;762
028332242893;1;155;158;214;83;53;663
083019974211;1;235;234;132;64;141;806
033983552689;1;279;84;202;76;137;778
024096348555;1;125;262;101;81;145;714
000001718813;1;277;87;137;71;116;688
038596685166;1;215;288;200;62;50;815
049449090561;1;263;262;221;100;115;961
028610434228;1;103;168;124;99;59;553
071795030055;1;191;265;228;119;155;958
063747586709;1;118;175;148;89;136;666
038630401297;1;109;218;283;105;176;891
045125102058;1;232;204;234;67;159;896
061950609252;1;198;284;142;63;161;848
036604587575;1;212;96;186;84;60;638
073776493301;1;138;211;202;108;83;742
050966792360;1;199;239;233;117;55;843
030915662701;1;120;112;132;63;71;498
018387421132;1;260;184;300;89;88;921
061028077526;1;220;233;196;56;54;759
006097126206;1;104;163;253;55;94;669
097548315476;1;222;126;208;53;68;677
073246249455;1;261;250;252;52;143;958
022158266307;1;191;271;251;54;80;847
043218451223;1;208;252;287;64;73;884
042056241657;1;289;268;158;98;100;913
049857158830;1;117;254;277;90;113;851
026020472564;1;291;169;214;70;67;811
064226100402;1;214;288;105;70;141;818
012462147377;1;103;88;254;106;142;693
094980385987;1;280;269;253;71;111;984
069723340529;1;166;198;158;106;101;729
032317717143;1;100;284;155;63;118;720
008178267235;1;108;262;219;82;81;752
099050810618;1;238;82;288;89;61;758
054038260848;1;189;244;172;66;99;770
069743347876;1;215;99;115;71;153;653
046786210637;1;138;277;207;61;160;843
050647557926;1;189;117;94;87;65;552
047634490876;1;124;248;282;81;110;845
040576009068;1;131;103;186;77;135;632
018430877117;1;89;196;251;68;102;706
095882197868;1;185;140;285;66;73;749
036198007956;1;112;229;117;101;121;680
022143950432;1;193;152;226;68;72;711
049270346058;1;216;215;218;87;106;842
040152426607;1;245;203;156;95;155;854
040970413269;1;122;193;138;97;128;678
004688682354;1;167;139;226;72;106;710
035787747601;1;169;138;127;61;143;638
096873633714;1;266;137;275;67;80;825
026722020053;1;245;112;174;103;98;732
037745497471;1;268;149;173;120;161;871
044341467974;1;275;175;141;84;153;828
044059694117;1;226;106;248;58;124;762
091478401667;1;87;242;109;75;170;683
051973392128;1;191;166;170;98;58;683
080262898154;1;146;226;284;51;73;780
021882615263;1;155;221;139;76;120;711
083609791359;1;148;243;104;120;50;665
049399430127;1;190;193;124;55;165;727
056013617173;1;122;254;217;112;83;788
035791832377;1;174;186;235;77;54;726
065718486469;1;121;85;216;69;61;552
008756568453;1;264;166;147;74;77;728
058220926313;1;221;90;161;77;111;660
051966469072;1;206;225;118;62;150;761
085349761380;1;291;103;235;60;51;740
014995940835;1;190;109;177;113;79;668
011051717647;1;124;244;190;93;89;740
077019171704;1;149;206;175;85;108;723
035934161210;1;86;265;98;105;129;683
077319613678;1;157;85;108;50;59;459
067100288269;1;276;282;133;102;151;944
019428351124;1;269;199;300;81;59;908
004900041714;1;267;185;289;83;126;950
058611916909;1;250;88;180;90;160;768
094327059067;1;132;83;107;111;90;523
035031093586;1;217;182;273;91;153;916
038131358189;1;221;169;160;65;79;694
062705489825;1;91;221;250;55;165;782
092129924686;1;291;190;286;69;54;890
072541144467;1;213;280;154;103;108;858
014466268425;1;224;193;186;114;93;810
018782232372;1;242;222;279;108;84;935
027260448609;1;123;151;264;79;106;723
083167829445;1;256;161;256;77;156;906
032560400568;1;258;178;199;57;56;748
097545745314;1;147;100;189;61;106;603
062415510332;1;181;230;237;65;147;860
069503553644;1;118;118;211;75;54;576
045574907338;1;265;210;213;55;59;802
068207029411;1;116;135;154;79;143;627
015037060168;1;128;216;94;103;74;615
056616966543;1;269;273;100;97;171;910
058655278882;1;250;249;231;84;135;949
064736545887;1;147;252;154;94;81;728
018281459488;1;230;142;195;98;62;727
070103096447;1;211;88;197;79;104;679
003652401012;1;230;190;97;82;95;694
035328830742;1;256;114;126;83;108;687
011311195189;1;170;277;281;74;170;972
079859910566;1;234;205;183;54;154;830
030164758761;1;246;165;157;118;66;752
012047859783;1;230;288;209;66;50;843
018309419278;1;227;279;113;108;143;870
087608330896;1;125;114;201;90;76;606
012444976461;1;147;287;224;118;85;861
080725661860;1;181;194;247;68;163;853
044430096877;1;124;243;113;57;128;665
064665106098;1;96;131;150;97;67;541
088428110850;1;140;233;288;97;113;871
073049225678;1;108;94;137;51;84;474
018772791478;1;287;213;148;57;81;786
027194251619;1;223;271;132;97;135;858
065437359498;1;129;151;285;98;82;745
023114582815;1;243;265;199;59;168;934
074586729397;1;131;273;248;85;139;876
043732705765;1;223;127;205;69;163;787
019282931949;1;243;118;227;95;70;753
035810124739;1;219;94;131;67;145;656
099607751227;1;268;264;280;74;105;991
053031365210;1;285;198;143;107;95;828
007849084814;1;243;257;162;80;55;797
094445319712;1;232;178;216;86;64;776
010840515980;1;101;95;238;90;127;651
006316069645;1;103;288;188;69;76;724
092098433241;1;173;278;97;112;96;756
088376045807;1;136;228;102;79;54;599
015112426284;1;131;171;99;104;122;627
053452600373;1;273;193;247;98;153;964
034623447368;1;246;147;205;74;157;829
009706590056;1;87;175;115;66;149;592
055661977942;1;149;170;230;88;93;730
087632747470;1;112;236;99;69;165;681
033511953676;1;204;98;104;72;117;595
056841446147;1;81;158;255;62;139;695
017970663262;1;211;202;176;71;115;775
020389965897;1;198;125;91;81;77;572
039588472398;1;198;138;139;96;172;743
039551725900;1;87;215;234;112;62;710
042027998418;1;180;134;158;88;88;648
051768014581;1;267;288;135;107;84;881
017925385028;1;270;231;192;99;132;924
035145668343;1;98;148;172;56;133;607
009033475309;1;266;156;112;103;97;734
097302826448;1;131;82;113;92;96;514
035622215736;1;177;108;267;88;144;784
099865736171;1;265;162;106;115;90;738
001356073797;1;197;176;300;116;167;956
081202520416;1;221;253;111;99;104;788
028867896770;1;196;129;200;70;52;647
047583917929;1;179;268;95;78;73;693
088266442387;1;120;107;253;50;129;659
037179888043;1;89;271;283;94;74;811
092251668507;1;115;255;272;94;94;830
071213490334;1;162;288;247;59;159;915
035182231764;1;265;97;210;81;128;781
092520437079;1;268;226;238;87;126;945
007477092473;1;284;149;139;50;139;761
066730151782;1;244;215;194;60;100;813
063987918939;1;197;111;97;65;171;641
089702659013;1;225;111;289;63;81;769
096187679896;1;221;280;92;94;87;774
018663893085;1;91;172;94;103;99;559
087302043202;1;129;152;280;68;114;743
061795364939;1;145;209;207;71;73;705
026486104989;1;275;85;129;118;172;779
020404654802;1;239;143;207;67;108;764
088922831878;1;147;91;232;65;122;657
041623418252;1;285;234;234;78;56;887
027301014007;1;197;265;183;78;177;900
097464223294;1;120;88;268;84;173;733
035929226211;1;234;101;294;82;77;788
076617832738;1;264;279;93;107;121;864
095112520309;1;238;258;251;52;133;932
012164141952;1;162;199;213;108;117;799
005600877844;1;114;213;282;94;95;798
025475949836;1;233;280;111;58;154;836
018604284053;1;133;114;280;112;91;730
033131275285;1;156;140;196;114;91;697
096420658964;1;283;174;200;62;82;801
072071936017;1;282;191;155;50;124;802
009827775278;1;236;195;125;100;135;791
072301648006;1;123;104;241;101;113;682
004008594674;1;153;215;99;62;162;691
072519604649;1;260;270;230;113;105;978
096753426946;1;195;235;211;50;95;786
081871123241;1;245;208;298;79;157;987
016952293485;1;210;144;194;91;82;721
007740899639;1;235;156;97;72;75;635
055113578585;1;156;262;298;74;76;866
093530216216;1;292;225;222;98;127;964
045176957420;1;207;114;206;82;153;762
095134183189;1;171;229;285;51;170;906
059726269899;1;281;254;211;98;96;940
074062597104;1;200;138;201;103;149;791
064456704386;1;224;287;270;93;149;1023
044404903763;1;279;147;286;110;140;962
016053865325;1;173;242;104;64;132;715
057488074614;1;283;230;252;96;141;1002
003742378423;1;165;102;206;52;108;633
007307811753;1;275;239;100;96;87;797
064079057861;1;249;238;151;72;168;878
034575824231;1;186;81;150;98;99;614
005051446809;1;187;270;234;107;87;885
051602104116;1;270;146;232;67;111;826
007563834305;1;179;213;193;63;122;770
016050975280;1;97;284;128;118;151;778
024585578545;1;142;187;181;62;58;630
070295309502;1;234;262;259;75;176;1006
077769447762;1;112;287;238;52;95;784
034822503004;1;138;193;276;74;173;854
026306128470;1;267;94;155;52;91;659
038237478000;1;245;189;120;108;174;836
058830124584;1;87;80;162;68;80;477
017793512149;1;272;250;99;110;159;890
029751107203;1;165;83;91;116;50;505
025427492860;1;151;182;216;106;174;829
027642420048;1;171;287;187;72;101;818
078562480336;1;260;200;120;112;76;768
099358537982;1;130;139;251;57;134;711
096050157929;1;122;117;214;50;134;637
090372891652;1;226;82;96;99;90;593
059219126118;1;167;245;258;78;113;861
014375220355;1;252;118;185;57;125;737
041181307828;1;257;238;273;105;93;966
075590863655;1;136;223;117;73;72;621
098681488731;1;281;140;226;79;136;862
041678729763;1;181;115;240;96;178;810
073167461367;1;201;176;138;120;164;799
032697233045;1;256;145;250;111;72;834
048496288580;1;105;250;237;64;102;758
013292879550;1;197;245;179;88;152;861
038953548146;1;125;96;169;102;171;663
067643498929;1;292;165;114;77;113;761
035653254648;1;172;135;178;53;115;653
052657209501;1;161;184;241;99;86;771
088098646094;1;110;92;112;54;145;513
028710764447;1;182;245;195;110;152;884
092303294737;1;221;228;134;100;70;753
037702453330;1;271;238;232;93;84;918
076288095773;1;288;166;158;91;154;857
007426944925;1;170;107;130;111;128;646
086777926122;1;237;90;101;118;105;651
077282186807;1;91;267;176;82;97;713
059180034227;1;216;150;150;119;100;735
011053416733;1;274;165;114;65;72;690
042860051340;1;194;218;204;97;163;876
045267205303;1;246;122;134;55;131;688
035034685791;1;282;93;178;64;54;671
053318324982;1;143;112;253;71;148;727
062804184539;1;220;260;172;57;73;782
054688877650;1;213;276;171;69;57;786
020480345885;1;284;159;224;81;158;906
095611443449;1;277;93;194;92;153;809
041581859824;1;133;143;232;100;172;780
020000106429;1;188;271;218;109;152;938
092597145246;1;160;148;95;63;72;538
057487668244;1;271;139;228;65;65;768
012374034259;1;209;161;154;109;174;807
087380216094;1;279;91;130;96;90;686
061487036087;1;198;114;150;120;108;690
057123481273;1;199;286;252;106;162;1005
026328273306;1;262;133;206;71;123;795
004213400377;1;240;236;266;91;83;916
071623483748;1;268;169;284;53;81;855
014118536647;1;205;242;278;114;156;995
059899898783;1;213;138;252;52;93;748
099176068194;1;121;214;224;118;115;792
075493573021;1;226;183;121;65;76;671
022182671503;1;275;186;142;112;164;879
052605197816;1;242;276;183;116;140;957
060551628978;1;168;246;126;98;69;707
049911502476;1;165;260;269;60;73;827
097730960481;1;271;120;170;96;106;763
010821328855;1;182;186;127;82;51;628
063194437582;1;152;180;288;58;77;755
003612264533;1;253;154;102;105;130;744
016832274247;1;247;232;104;78;154;815
041989226100;1;110;266;169;107;123;775
041682217080;1;275;276;247;115;100;1013
092035867041;1;152;184;179;54;127;696
026354719605;1;211;270;227;107;149;964
041632646755;1;224;244;290;103;64;925
000572610136;1;284;126;150;99;73;732
041886605377;1;103;195;172;65;174;709
029182657763;1;252;276;153;114;129;924
020085844370;1;218;144;283;64;62;771
047532665138;1;144;243;134;77;146;744
059222984102;1;204;162;239;61;73;739
025089989122;1;277;175;140;101;62;755
012120316790;1;283;229;144;82;164;902
084106683406;1;267;191;209;98;91;856
050299218300;1;145;288;247;96;55;831
025331106130;1;202;194;283;114;141;934
064522791329;1;188;261;289;101;100;939
057844962355;1;148;215;210;76;58;707
019058839286;1;203;110;113;72;148;646
087393574242;1;184;244;203;78;55;764
063687409208;1;170;88;164;81;100;603
039594822363;1;292;115;248;111;160;926
065324465387;1;136;118;163;68;86;571
038668989932;1;117;159;122;55;100;553
062615417802;1;222;189;145;116;97;769
079316332957;1;208;271;241;75;81;876
031876729855;1;91;112;123;89;156;571
094293189813;1;91;145;171;90;67;564
078339230771;1;152;201;197;61;120;731
092623030154;1;236;220;153;90;111;810
083730131531;1;134;127;289;115;123;788
008478764446;1;109;223;203;108;60;703
057599191461;1;100;117;270;102;131;720
092575231778;1;81;126;248;118;176;749
025009012641;1;282;129;215;118;91;835
087197196232;1;151;112;93;69;90;515
068499235916;1;280;253;245;89;147;1014
082981628646;1;87;175;275;62;95;694
018473778082;1;102;118;201;87;117;625
033502731426;1;268;96;242;111;64;781
079068692338;1;277;236;285;98;58;954
098860845967;1;252;166;125;50;66;659
083474079589;1;285;245;186;107;161;984
097064379295;1;120;229;233;54;144;780
013279360696;1;119;237;97;95;64;612
008749697912;1;240;114;300;56;103;813
051619596786;1;148;174;116;75;143;656
086165818685;1;198;288;296;93;53;928
055390398169;1;105;169;175;50;119;618
017805197226;1;227;133;112;83;81;636
021701160460;1;238;233;197;85;58;811
016760095841;1;189;244;119;113;75;740
088960459656;1;242;87;105;50;50;534
049029460084;1;147;129;99;52;175;602
023266234246;1;273;185;112;91;114;775
087947429718;1;184;234;240;63;95;816
081829179839;1;211;116;166;105;152;750
029841668656;1;195;95;160;64;69;583
087751873803;1;180;153;246;84;67;730
074464188365;1;156;252;95;62;61;626
030931020535;1;257;190;138;77;167;829
011828509637;1;122;113;245;55;65;600
081997617271;1;249;86;150;115;160;760
045425434696;1;107;185;246;88;174;800
014883914267;1;184;228;186;104;166;868
047103759306;1;258;156;263;106;118;901
030524463441;1;256;192;258;56;101;863
054524951110;1;250;103;146;101;162;762
053873933544;1;105;237;175;79;67;663
049699607063;1;102;120;273;101;156;752
069282837629;1;160;117;239;119;124;759
000446745379;1;144;89;215;80;152;680
024169812178;1;284;166;276;88;121;935
021912092942;1;103;114;138;104;178;637
056028105517;1;224;217;235;107;83;866
033062660004;1;237;275;121;68;119;820
070839170168;1;158;253;278;83;178;950
008665617055;1;85;93;196;61;166;601
033535583281;1;217;194;146;92;153;802
096601330823;1;245;144;148;115;165;817
089727546174;1;102;80;263;87;131;663
006085119379;1;252;287;204;82;166;991
046938901845;1;186;177;128;64;165;720
099476797552;1;147;277;246;65;87;822
078427495867;1;241;124;269;90;57;781
054727999829;1;169;179;277;87;138;850
060417909074;1;177;175;172;93;146;763
067890351990;1;119;199;259;104;107;788
007141362093;1;208;182;121;70;158;739
039835126016;1;108;162;108;77;77;532
040202868772;1;165;255;278;66;135;899
028670442536;1;129;169;299;76;137;810
014716961582;1;158;247;237;103;170;915
064243751891;1;260;192;136;63;116;767
078586198553;1;258;171;240;104;116;889
049178321244;1;122;199;241;94;61;717
024519535662;1;272;243;153;70;171;909
025848744541;1;96;135;162;91;91;575
047702691203;1;260;252;197;59;168;936
096747967815;1;143;286;175;51;71;726
046006126241;1;266;241;176;58;52;793
069314486082;1;146;134;221;50;163;714
039648930493;1;280;156;157;114;104;811
001203037022;1;146;206;209;60;147;768
087739361723;1;260;148;166;57;168;799
076700338948;1;92;267;123;64;68;614
051941046933;1;221;167;275;64;61;788
093210889568;1;247;222;146;81;162;858
035433369654;1;239;186;101;98;178;802
080787931183;1;239;168;111;75;143;736
086310883001;1;132;91;179;59;157;618
048996085953;1;138;224;96;78;119;655
096578412951;1;217;145;199;55;125;741
026032587384;1;156;95;269;77;54;651
014798424360;1;99;173;213;115;52;652
080677924765;1;142;236;233;113;103;827
070043753126;1;129;195;190;120;177;811
096173806499;1;290;159;288;69;110;916
006071364791;1;266;201;225;83;51;826
084005040642;1;196;84;275;75;60;690
031143191681;1;240;100;245;78;124;787
075224621442;1;92;148;155;67;70;532
057513601512;1;237;196;275;117;160;985
062178889359;1;82;243;139;87;70;621
056055794275;1;165;243;282;95;95;880
052479078676;1;123;88;125;71;121;528
081608983900;1;182;124;268;64;151;789
063476902136;1;82;130;105;100;138;555
072797972027;1;118;227;203;55;79;682
043709550684;1;91;86;295;91;169;732
062956390757;1;159;216;198;108;157;838
074242843644;1;163;83;269;51;101;667
058932641344;1;145;252;120;110;108;735
099664658879;1;286;251;216;50;117;920
022137878626;1;144;138;109;86;130;607
091415064078;1;284;95;264;55;165;863
004760742447;1;162;288;185;95;59;789
063701595156;1;289;204;223;60;133;909
052938121718;1;209;245;290;68;53;865
053157392055;1;170;91;186;85;161;693
026596428305;1;158;230;98;119;86;691
059541034857;1;274;167;267;63;156;927
053613061435;1;153;255;198;67;174;847
081198442912;1;250;260;242;56;152;960
095312937141;1;224;175;271;75;138;883
034172647823;1;242;262;111;93;129;837
014749243663;1;239;214;95;73;53;674
065434151849;1;100;209;212;56;162;739
013501819217;1;86;86;232;103;90;597
024276528060;1;170;124;296;81;66;737
091748591795;1;258;205;249;98;90;900
078118050209;1;202;249;122;117;115;805
002011829416;1;246;252;295;72;70;935
036158521964;1;237;110;195;85;159;786
013720153610;1;287;190;184;117;103;881
023660923148;1;278;198;159;83;133;851
078775607332;1;108;114;267;54;177;720
050224522945;1;237;124;119;118;139;737
073217264299;1;190;180;216;103;83;772
056229818562;1;287;104;274;59;70;794
012057887623;1;190;268;266;62;148;934
091403437309;1;237;247;162;97;82;825
005112368613;1;170;120;223;66;84;663
050649337973;1;138;192;137;54;82;603
045409597379;1;166;172;102;118;97;655
026374136754;1;194;104;278;56;57;689
097495551585;1;118;183;229;98;113;741
049884653416;1;288;99;170;89;149;795
072475012277;1;154;230;111;107;74;676
009565037952;1;111;165;228;62;80;646
072520621233;1;263;270;202;59;73;867
052190285176;1;93;252;106;83;169;703
052121361281;1;197;107;184;114;173;775
007874813302;1;108;154;190;88;98;638
030092466503;1;118;213;190;98;82;701
019024510579;1;81;164;262;85;133;725
046971051152;1;260;275;102;100;98;835
062584778626;1;185;125;103;90;126;629
065144449520;1;127;202;107;50;103;589
079283525706;1;225;200;205;58;144;832
002247124834;1;103;88;171;120;143;625
008614491886;1;203;270;184;50;105;812
004039711821;1;144;99;139;117;163;662
052470290966;1;180;187;247;107;147;868
053825095899;1;148;156;180;72;165;721
070213537847;1;234;210;201;117;102;864
099866600720;1;196;134;243;119;167;859
019439362612;1;120;219;130;100;62;631
078190633695;1;165;117;236;102;166;786
082089519263;1;104;158;263;63;145;733
079954265583;1;100;202;244;81;53;680
004409017660;1;164;84;178;53;140;619
027301767966;1;93;154;298;95;84;724
003978813762;1;201;169;116;97;152;735
077312352722;1;289;206;176;108;155;934
000214504360;1;292;110;99;110;83;694
024757560992;1;174;275;155;120;78;802
066714026478;1;241;144;245;73;69;772
093270998876;1;220;137;188;104;94;743
080753588179;1;260;201;299;65;81;906
092210484818;1;171;287;235;51;56;800
064766071745;1;124;104;161;50;149;588
097200644984;1;97;214;197;86;56;650
049691962931;1;112;103;146;52;135;548
073482913752;1;111;208;111;54;149;633
000818507708;1;246;239;216;98;60;859
071500661762;1;177;250;269;77;111;884
057527466095;1;237;286;136;96;127;882
038558434516;1;217;182;237;108;76;820
052070811513;1;223;101;255;109;137;825
031040280675;1;194;82;170;80;134;660
039745668170;1;202;281;164;60;139;846
017338658691;1;241;270;216;89;113;929
023016926305;1;185;122;236;92;178;813
007102262617;1;136;220;279;82;97;814
034519493941;1;216;140;108;50;112;626
044714231446;1;212;251;175;72;77;787
040567589254;1;146;94;294;76;82;692
010747193304;1;104;228;96;94;138;660
041625921161;1;242;228;104;99;177;850
073111609223;1;117;112;163;103;170;665
069176041104;1;163;185;273;110;120;851
022512771171;1;243;248;297;115;166;1069
088697486320;1;145;132;162;60;120;619
083213462648;1;121;129;257;107;120;734
087535828673;1;151;227;185;61;50;674
005358073205;1;106;206;155;94;111;672
098612047993;1;154;283;262;100;121;920
037080257341;1;154;114;133;115;85;601
007676968707;1;164;151;252;91;94;752
006093163353;1;264;183;218;61;75;801
002773114394;1;165;118;187;105;81;656
026962343707;1;284;116;276;100;114;890
060968340797;1;210;132;300;67;95;804
093948096342;1;271;132;92;97;104;696
056226514486;1;263;179;230;60;124;856
030886551214;1;136;152;279;87;168;822
066475452906;1;95;126;106;99;177;603
012316816107;1;82;127;245;68;52;574
043245662446;1;241;264;153;58;152;868
008621925549;1;235;173;125;75;70;678
086602054957;1;189;265;205;74;123;856
032374259259;1;278;271;223;93;146;1011
033593511948;1;83;121;127;93;112;536
087067479673;1;112;227;128;87;123;677
092208794441;1;271;130;177;119;50;747
080268082667;1;279;167;281;71;50;848
015119776771;1;262;176;257;82;100;877
057193995540;1;84;201;242;94;162;783
096127861271;1;285;98;121;70;158;732
076951799278;1;164;188;124;89;174;739
053022166707;1;287;274;180;114;159;1014
068833454431;1;178;136;192;60;147;713
034364930781;1;273;172;168;70;83;766
023542193007;1;272;111;156;54;54;647
020330176418;1;165;275;223;99;175;937
022790601901;1;233;266;135;61;119;814
089984052657;1;254;86;130;81;131;682
085505008390;1;242;167;297;100;175;981
078225211798;1;240;114;175;84;153;766
076928713562;1;220;95;281;114;56;766
060961563866;1;213;191;94;114;79;691
042234801978;1;88;94;255;64;156;657
085012874600;1;152;108;138;99;137;634
015869460362;1;171;185;232;74;133;795
059783655200;1;279;265;174;61;171;950
045013351815;1;238;251;187;104;87;867
083684764548;1;290;150;201;52;100;793
017889948970;1;191;225;112;65;153;746
072598663429;1;117;189;257;98;86;747
032835916425;1;156;167;231;69;151;774
083649260928;1;144;101;250;98;164;757
070425569981;1;134;97;236;108;102;677
081803892155;1;146;168;281;102;162;859
007113718907;1;201;279;288;79;84;931
055880612941;1;146;82;242;81;130;681
030609563960;1;163;128;206;59;76;632
014809290261;1;248;288;141;57;65;799
049757385332;1;193;214;234;50;177;868
003739889938;1;275;87;272;120;89;843
047205187126;1;164;277;171;76;89;777
067905837256;1;213;254;193;108;135;903
013711186531;1;227;259;281;62;108;937
009888097608;1;102;204;276;77;131;790
001832810806;1;156;114;135;73;83;561
063660498634;1;87;256;110;52;160;665
050641857808;1;267;194;116;83;73;733
099525660701;1;246;86;280;113;142;867
049875037240;1;172;217;104;106;54;653
048841080119;1;103;251;203;79;102;738
036453140878;1;154;190;244;109;112;809
098302817884;1;85;226;243;111;56;721
002628496429;1;263;217;262;95;103;940
006736175399;1;104;159;123;89;60;535
013681558746;1;168;83;201;103;110;665
045119147813;1;116;224;110;120;147;717
015633714678;1;195;147;194;80;177;793
086814010779;1;158;241;235;84;70;788
056230498528;1;164;164;265;109;52;754
009532554063;1;284;192;176;55;122;829
068302233081;1;267;205;145;87;169;873
048923714869;1;223;279;235;119;171;1027
013733251499;1;277;126;278;97;72;850
025384558752;1;122;228;165;75;173;763
003252381907;1;131;274;171;79;126;781
039440375831;1;282;194;96;114;161;847
091816967242;1;162;169;192;57;108;688
073437456900;1;195;140;209;98;65;707
032513094158;1;233;217;151;69;153;823
038764867457;1;192;106;245;89;91;723
004074591383;1;271;151;106;74;156;758
025039725539;1;194;106;267;103;63;733
096933724705;1;169;264;196;101;174;904
036355177302;1;238;94;162;75;72;641
096560880181;1;228;196;258;54;156;892
026534407340;1;263;84;238;106;169;860
032314434341;1;177;288;198;54;114;831
092315407017;1;124;149;179;61;106;619
060529326977;1;155;80;145;84;86;550
085130674393;1;212;232;186;88;77;795
089744464378;1;206;150;130;58;82;626
036957899717;1;117;283;278;108;109;895
082852342488;1;118;189;274;115;74;770
086259545474;1;192;212;229;101;82;816
019757541020;1;195;159;238;61;140;793
028033061570;1;271;225;227;118;80;921
099966815218;1;117;103;104;65;138;527
002997531397;1;236;219;194;112;114;875
071677163338;1;259;96;196;90;76;717
036534243830;1;207;145;208;61;144;765
011163247117;1;200;141;263;76;138;818
008527064155;1;171;241;298;89;156;955
079235354587;1;147;158;160;60;161;686
026375841280;1;125;213;226;99;83;746
046305518669;1;137;231;172;51;154;745
062750097606;1;280;287;152;51;110;880
002536250652;1;213;246;229;109;126;923
085757924418;1;224;276;162;92;131;885
098767493796;1;207;286;197;52;65;807
026019223059;1;193;125;166;54;95;633
059938689082;1;241;281;149;117;157;945
079578744375;1;184;280;147;69;65;745
020704163912;1;115;230;298;112;127;882
089583433927;1;242;263;232;52;94;883
038757901653;1;114;119;134;92;56;515
023162709956;1;258;151;205;58;150;822
089152304607;1;122;128;279;65;77;671
008161099137;1;99;138;194;60;94;585
045618345542;1;143;83;268;86;167;747
071435338876;1;143;168;190;86;69;656
087489920134;1;89;217;248;117;60;731
029555590714;1;211;210;112;87;88;708
084110851098;1;80;248;122;97;82;629
046804745042;1;204;138;191;110;165;808
031522476989;1;146;264;221;62;75;768
024615296214;1;213;138;114;54;134;653
089240934008;1;167;276;295;84;157;979
076713551684;1;247;83;160;75;91;656
035520706949;1;96;268;185;95;90;734
047892060494;1;163;156;203;106;75;703
053569194771;1;175;255;181;84;123;818
030991833125;1;221;234;295;88;133;971
064263436412;1;251;160;105;79;80;675
086128669417;1;246;172;129;57;126;730
025314762917;1;163;110;187;92;54;606
089796155803;1;179;135;96;69;81;560
030534995951;1;173;116;105;107;125;626
040308330421;1;210;160;222;66;177;835
049179142529;1;267;157;278;102;136;940
089094005423;1;151;142;269;52;147;761
029482782120;1;179;118;150;83;64;594
069220015251;1;281;275;124;55;121;856
058554061800;1;145;275;138;76;116;750
099408774454;1;230;280;112;105;67;794
010135739652;1;170;213;190;68;128;769
027521978795;1;281;262;101;120;64;828
027048050888;1;125;208;285;120;87;825
076621382530;1;127;251;217;56;135;786
016888928647;1;239;175;205;117;175;911
048020025648;1;228;123;285;80;110;826
009706587084;1;270;182;102;85;123;762
062169712239;1;242;209;200;85;99;835
042070036844;1;119;211;175;107;108;720
069235465570;1;277;222;225;71;118;913
083199113049;1;242;160;247;115;57;821
051387870457;1;163;249;107;57;84;660
083493215983;1;242;214;109;64;77;706
086567168350;1;104;192;298;51;134;779
004912585636;1;230;167;97;111;92;697
045626353809;1;170;141;152;53;123;639
000870070203;1;236;183;193;89;64;765
050361731542;1;91;151;140;85;171;638
098772785662;1;265;121;196;92;143;817
013064889744;1;146;275;198;69;122;810
081660076239;1;289;246;221;72;100;928
060452484950;1;290;210;118;80;157;855
040743890129;1;155;82;145;100;148;630
077129008015;1;189;137;248;94;149;817
050700576007;1;291;256;184;52;94;877
060707614886;1;109;117;298;112;163;799
020644117095;1;224;230;193;76;166;889
078869963516;1;275;231;279;100;154;1039
062606945984;1;250;266;293;74;86;969
051858193150;1;251;196;142;64;81;734
097327014769;1;98;161;253;114;106;732
059955512164;1;281;216;197;119;96;909
049994454861;1;95;171;116;84;97;563
018916708417;1;205;91;239;90;96;721
095430288351;1;265;99;226;61;116;767
059758154567;1;275;258;205;71;162;971
031889361641;1;122;126;110;100;78;536
035064354244;1;189;137;248;108;77;759
081247793339;1;195;86;114;56;51;502
090018521258;1;149;235;241;65;81;771
065071599890;1;229;176;127;59;156;747
074253087475;1;101;281;240;79;161;862
025062917014;1;80;263;218;108;143;812
015445185341;1;235;228;294;83;177;1017
086445652861;1;230;232;298;83;172;1015
072829486945;1;276;246;117;118;109;866
019402555116;1;141;117;146;98;89;591
047085862209;1;155;227;97;83;121;683
043037975599;1;104;257;126;102;121;710
022161303979;1;87;82;234;111;65;579
053621760742;1;191;283;255;119;141;989
070478247965;1;97;286;234;86;149;852
004153334870;1;134;115;102;71;170;592
024442187013;1;165;183;164;92;96;700
088741504302;1;153;210;247;64;68;742
002618867232;1;235;175;219;91;148;868
069983374527;1;127;166;187;89;170;739
032569477546;1;280;266;282;82;115;1025
087718660033;1;207;121;172;73;75;648
022322627567;1;224;273;259;105;114;975
023033802871;1;255;197;93;64;51;660
042791226008;1;236;180;280;51;94;841
053609132193;1;150;207;188;118;171;834
073565762396;1;128;203;300;112;98;841
005872612161;1;184;286;239;85;86;880
042025094620;1;201;104;125;50;102;582
064539589840;1;219;224;112;53;178;786
016266239832;1;252;182;214;112;136;896
084363542190;1;180;209;159;83;111;742
058957553003;1;207;120;190;101;53;671
064155232729;1;183;98;258;62;123;724
052834440190;1;227;155;185;118;133;818
002371666634;1;165;98;117;52;125;557
065365636083;1;150;85;120;74;101;530
058331349025;1;226;214;257;99;94;890
086413334374;1;131;153;285;90;117;776
001883407388;1;162;200;270;60;177;869
030720443250;1;252;224;294;98;139;1007
025631659546;1;181;200;148;102;50;681
053915140088;1;292;140;266;62;157;917
070638967044;1;276;168;174;92;154;864
097677238192;1;285;246;194;107;152;984
052481489090;1;174;123;202;66;120;685
029298023735;1;184;126;263;98;176;847
052534148507;1;106;255;224;77;150;812
098632371915;1;178;176;221;60;67;702
092821231608;1;235;190;176;119;69;789
078132892112;1;149;194;213;83;89;728
080061642805;1;209;243;297;117;175;1041
014990707256;1;211;207;253;115;135;921
074601797736;1;196;241;227;102;58;824
087124547111;1;101;272;239;77;65;754
025442944540;1;246;165;202;95;53;761
044338525234;1;93;217;163;79;78;630
084763514013;1;147;178;199;75;148;747
089804835347;1;87;210;191;105;64;657
037655452143;1;125;232;227;104;65;753
037416766760;1;134;239;103;82;130;688
003732440923;1;92;286;268;84;175;905
048167398825;1;118;241;114;111;55;639
062413139270;1;228;201;228;119;64;840
061326850039;1;271;132;131;114;96;744
026459915829;1;225;267;143;84;58;777
013946038229;1;290;84;170;109;178;831
032671038178;1;80;94;287;89;130;680
044798827669;1;264;126;272;93;57;812
089264080503;1;241;260;241;75;122;939
036295596640;1;92;255;114;100;87;648
011131318509;1;110;286;131;90;153;770
086685028255;1;142;194;195;79;113;723
000488080719;1;291;283;213;81;65;933
020369010921;1;115;160;218;56;154;703
035383347105;1;209;129;180;116;52;686
016044421051;1;238;146;143;63;65;655
077004569976;1;290;122;144;119;93;768
053850105864;1;184;135;178;97;104;698
082975070414;1;204;88;195;88;69;644
044934851817;1;153;129;92;52;90;516
031154029256;1;290;272;215;88;157;1022
084759451388;1;188;209;269;112;148;926
002274401559;1;274;160;198;83;145;860
036303503234;1;205;84;289;89;109;776
004663163810;1;142;191;153;98;75;659
077423300039;1;97;225;134;76;129;661
050378189236;1;167;260;235;96;129;887
038949968013;1;174;189;209;78;136;786
015315503507;1;101;82;272;64;157;676
088710401724;1;195;122;170;58;64;609
046378457720;1;237;190;138;120;173;858
085922426243;1;200;185;199;102;108;794
051267587427;1;187;185;121;76;140;709
090344907499;1;248;238;189;62;84;821
038203760401;1;103;149;144;105;60;561
010319314693;1;246;96;279;113;164;898
077556177126;1;258;246;276;79;120;979
012247531669;1;170;139;138;119;136;702
095452797833;1;195;188;102;85;110;680
066060697230;1;103;96;294;70;93;656
050721991462;1;180;83;283;59;104;709
017792026329;1;241;254;216;87;143;941
003902708678;1;261;126;138;59;151;735
063014467134;1;151;270;99;78;148;746
006240578464;1;252;229;127;119;85;812
032333576698;1;194;239;228;78;68;807
035952952232;1;126;262;141;100;159;788
017726703552;1;232;149;204;83;60;728
059227267441;1;273;205;97;105;74;754
096668186331;1;150;195;137;82;71;635
019755200863;1;276;156;289;115;73;909
089194597320;1;217;114;243;113;80;767
015845862612;1;174;93;163;104;169;703
089523959365;1;115;85;133;112;52;497
079701803563;1;250;257;147;53;57;764
073381496692;1;126;137;267;89;107;726
038082289925;1;238;153;274;100;129;894
072114389204;1;270;245;241;58;110;924
081056146491;1;287;85;269;103;50;794
019702595302;1;106;131;102;80;98;517
000976023723;1;165;142;229;89;112;737
043371364641;1;112;162;212;111;70;667
083262367648;1;252;245;209;59;91;856
016948902173;1;237;100;192;116;161;806
062197505415;1;145;253;125;85;94;702
080365999603;1;119;218;247;52;155;791
071601685433;1;175;278;199;86;130;868
003310769558;1;191;243;165;110;142;851
066057636514;1;147;277;126;104;121;775
060364599791;1;89;109;127;96;71;492
001830535825;1;249;250;205;53;65;822
008924241869;1;216;283;189;80;137;905
088919987359;1;139;164;94;86;80;563
023284775248;1;146;141;254;61;123;725
079772028283;1;213;217;300;104;80;914
020510415555;1;133;152;203;51;59;598
078642470637;1;126;138;209;51;168;692
014663343150;1;177;155;142;113;174;761
043820605621;1;83;276;288;96;120;863
054624920947;1;173;218;252;77;54;774
022103326646;1;291;206;214;57;90;858
024736675512;1;181;220;276;91;53;821
027190940474;1;196;146;117;55;152;666
094136015889;1;260;249;221;67;105;902
024638625769;1;166;150;157;75;149;697
037706844297;1;139;98;150;56;94;537
087937408971;1;169;130;105;85;80;569
000671244925;1;273;256;93;65;70;757
074483875286;1;107;80;267;89;70;613
050894596999;1;85;138;182;56;122;583
098103457505;1;108;96;293;102;178;777
033853601199;1;197;241;230;53;87;808
017517008293;1;215;210;161;71;87;744
053786035381;1;117;88;182;66;168;621
080393347091;1;143;93;217;68;132;653
088253258140;1;264;282;283;82;65;976
063034498487;1;133;165;114;89;81;582
023094696179;1;94;112;115;86;86;493
060803916599;1;204;156;120;105;152;737
021625301109;1;148;92;275;66;85;666
023140069487;1;193;100;214;87;135;729
005965013979;1;105;232;192;64;71;664
023667842944;1;281;177;297;79;63;897
047094872999;1;146;182;226;52;158;764
072867382762;1;226;155;237;80;101;799
079533249428;1;279;272;156;94;71;872
038508682026;1;283;166;290;78;136;953
046993177063;1;140;179;256;102;172;849
096614190634;1;275;119;201;64;137;796
011525093671;1;274;124;156;85;64;703
040737909434;1;235;263;183;88;67;836
036007735521;1;192;261;225;83;50;811
033039755667;1;271;155;236;105;97;864
018486219943;1;218;181;245;51;159;854
076355002646;1;278;251;297;87;83;996
086860435263;1;217;271;208;101;134;931
037410684086;1;106;172;225;76;145;724
035093349147;1;222;113;156;51;110;652
085841194811;1;242;91;183;105;65;686
053274355737;1;134;124;216;71;75;620
032997098623;1;139;200;273;63;150;825
081776732964;1;246;257;149;76;159;887
043294395799;1;102;103;153;78;99;535
008113755378;1;131;273;96;50;53;603
056290007102;1;134;231;299;83;175;922
073958704599;1;211;239;160;53;57;720
017772437302;1;222;228;231;53;137;871
079375606300;1;192;261;230;58;148;889
099857547033;1;184;220;106;76;113;699
042008731165;1;180;116;148;108;147;699
048350794421;1;165;238;166;70;119;758
067168487466;1;212;123;255;58;96;744
028604231512;1;236;150;202;113;127;828
023822434557;1;121;144;283;84;64;696
031975600478;1;115;255;290;94;71;825
021840701308;1;134;103;148;85;145;615
044021516230;1;255;215;290;56;140;956
064552470421;1;114;153;285;61;86;699
002186385178;1;206;118;133;53;106;616
072850313514;1;120;150;90;75;160;595
091708226417;1;266;238;151;102;85;842
087029540175;1;86;140;275;79;168;748
078084344431;1;117;122;137;108;78;562
073145215107;1;246;125;178;114;116;779
093876444928;1;202;272;264;64;173;975
026912096502;1;266;170;248;113;161;958
032689238842;1;111;287;254;64;151;867
049909047599;1;206;183;142;68;115;714
082430089833;1;137;143;161;52;53;546
021758846062;1;219;231;227;80;161;918
009020261440;1;142;137;136;78;154;647
083753229187;1;253;111;125;98;137;724
006970896903;1;289;126;255;78;53;801
068343782059;1;247;97;97;102;60;603
034625555882;1;145;246;250;78;166;885
002982405120;1;275;253;297;81;84;990
017433698387;1;80;142;233;95;171;721
065006926554;1;220;86;285;55;92;738
060287643533;1;159;106;294;69;142;770
017754649344;1;220;132;139;70;170;731
016602073253;1;230;171;260;80;60;801
093284094087;1;274;253;188;87;176;978
017943373832;1;183;104;256;108;68;719
042871770533;1;151;263;117;51;158;740
088688418953;1;199;232;110;118;132;791
072239873768;1;90;131;204;54;80;559
006633808256;1;235;93;182;56;57;623
056085672737;1;290;261;288;117;102;1058
054289554805;1;259;89;133;91;57;629
084371993638;1;168;86;140;119;103;616
091926614607;1;195;112;149;83;135;674
000295430154;1;170;240;247;62;157;876
016474499288;1;227;207;114;55;87;690
070007511390;1;208;263;137;101;136;845
056835797918;1;292;109;233;109;154;897
058585645580;1;278;102;196;56;175;807
056356310618;1;144;112;101;60;125;542
022090961518;1;144;245;144;86;148;767
074446954123;1;179;249;206;61;134;829
065929167222;1;223;109;119;74;141;666
050622458720;1;291;94;262;60;164;871
062111022332;1;123;126;218;89;90;646
048850813123;1;200;186;300;111;96;893
043170563881;1;162;183;217;85;94;741
097267908564;1;288;140;108;51;66;653
089948142631;1;142;95;135;71;86;529
034799024107;1;88;275;236;53;50;702
008719242649;1;233;213;281;74;156;957
073961910370;1;265;166;235;115;91;872
091624506521;1;228;147;91;64;73;603
049081655383;1;174;255;190;100;89;808
094915640092;1;211;219;259;68;94;851
089240818042;1;170;105;102;117;77;571
092334062974;1;272;285;97;115;58;827
007209479236;1;107;221;240;68;79;715
017014745714;1;85;122;155;51;119;532
003470333561;1;85;267;254;76;154;836
043681467788;1;131;222;278;72;94;797
075714391278;1;282;130;249;86;53;800
020136135830;1;200;232;204;59;172;867
074467678836;1;164;275;120;78;94;731
084393695379;1;260;221;232;111;157;981
051805465641;1;212;166;262;68;95;803
042305833591;1;195;87;119;73;90;564
067358655032;1;192;274;255;55;92;868
058068067580;1;153;139;219;99;63;673
004484341973;1;150;261;109;85;165;770
010272182366;1;227;83;97;62;76;545
016711904304;1;263;267;209;51;150;940
092012999089;1;275;137;299;86;92;889
069372420496;1;203;180;289;52;75;799
078716246366;1;276;161;188;97;135;857
004612031662;1;159;230;162;120;117;788
025719991547;1;219;145;153;108;114;739
005188580130;1;88;148;136;72;128;572
030938915860;1;213;168;127;85;175;768
076779120848;1;137;81;246;95;58;617
084453905537;1;131;265;262;93;111;862
087554716729;1;251;137;194;117;84;783
093573963461;1;121;91;151;57;69;489
080007474314;1;180;266;102;64;51;663
056801995319;1;191;91;215;112;153;762
021974228431;1;243;254;287;67;110;961
059414718240;1;290;252;223;84;132;981
084332539957;1;128;167;125;63;134;617
050179816224;1;195;278;120;97;97;787
087257972660;1;199;105;181;68;153;706
012251620866;1;236;273;256;77;133;975
087076204919;1;271;171;146;65;104;757
071577886750;1;90;165;209;70;153;687
022078260419;1;276;164;256;104;83;883
077127163179;1;144;272;262;86;169;933
012683697781;1;167;196;116;75;132;686
052352585841;1;138;215;106;70;67;596
045717760760;1;271;87;291;93;111;853
010618378869;1;206;194;180;110;126;816
084416083429;1;215;220;132;106;77;750
059848899334;1;138;286;130;98;130;782
095821805533;1;168;286;120;118;102;794
029168849956;1;286;197;200;79;117;879
024931580565;1;178;104;188;110;117;697
088181452640;1;291;187;107;57;50;692
011071788126;1;184;224;183;72;134;797
081486801735;1;116;127;284;72;173;772
087521750147;1;268;272;133;89;176;938
070007055382;1;227;269;173;75;81;825
044265412490;1;242;275;125;112;157;911
055216670374;1;268;81;152;74;155;730
073876822015;1;207;253;225;57;53;795
080061194237;1;127;270;238;119;96;850
039690014217;1;287;80;235;117;105;824
040525086486;1;244;251;243;64;166;968
007001969328;1;143;250;101;89;111;694
043327406150;1;227;170;181;94;75;747
043611490166;1;274;159;259;58;176;926
021633965341;1;96;182;173;68;132;651
015597724160;1;112;187;283;95;175;852
035736817171;1;184;131;239;94;169;817
044064452623;1;134;167;277;115;78;771
098017779206;1;285;265;252;81;124;1007
039536669703;1;106;267;116;60;114;663
037082797123;1;279;213;209;115;147;963
003454098908;1;259;282;269;63;69;942
020483076190;1;122;116;155;77;93;563
044694982802;1;142;205;106;84;125;662
022074141886;1;188;184;141;105;104;722
080335930410;1;240;101;262;106;112;821
090994519006;1;115;86;202;87;113;603
069345861748;1;154;272;229;103;166;924
037449948219;1;243;100;253;111;58;765
090749170651;1;120;94;279;110;171;774
026679389381;1;149;284;109;51;170;763
065611236092;1;286;158;255;95;92;886
070345989649;1;228;151;170;59;106;714
084825161325;1;250;244;168;66;175;903
001072142595;1;92;90;279;80;151;692
075641373570;1;184;200;284;85;172;925
049382791984;1;193;268;175;116;88;840
060424842896;1;123;267;212;101;134;837
086139557866;1;144;209;134;55;103;645
018260026631;1;163;255;134;100;50;702
031751343703;1;125;192;114;53;148;632
054490010911;1;163;176;187;82;69;677
060474349313;1;193;152;117;61;104;627
032429774278;1;218;175;130;120;89;732
086365091680;1;204;183;225;83;76;771
077067781707;1;131;100;281;107;173;792
092842802597;1;132;227;280;91;84;814
061143804326;1;257;143;226;62;175;863
004394535356;1;239;175;224;103;169;910
060814075131;1;128;268;218;83;167;864
099318570301;1;224;254;133;90;142;843
077245682890;1;246;257;290;62;103;958
012050995735;1;109;190;153;99;110;661
004865636349;1;149;94;214;105;160;722
023293877823;1;239;281;285;92;166;1063
014855746204;1;181;153;119;117;67;637
019809485027;1;259;95;288;110;108;860
073084389285;1;209;179;240;73;157;858
035510701120;1;221;280;178;80;165;924
028721172892;1;127;133;190;82;96;628
001831593150;1;112;186;223;83;167;771
046562390608;1;277;229;226;110;151;993
019283155866;1;191;138;90;86;137;642
026347249165;1;90;185;178;52;152;657
031353484330;1;82;134;142;63;134;555
022999797497;1;157;95;180;83;141;656
086683465895;1;221;100;117;88;167;693
059859695251;1;83;248;122;103;66;622
069862817778;1;134;183;165;69;123;674
086871956073;1;276;240;283;72;130;1001
079365754301;1;263;270;214;61;158;966
013280098410;1;249;176;277;112;56;870
078466388825;1;96;93;90;88;54;421
006273022281;1;209;85;95;104;165;658
032541656461;1;203;179;245;54;60;741
084225183049;1;177;170;261;90;157;855
072156563771;1;290;117;286;64;173;930
088970340272;1;80;189;181;50;85;585
081819326634;1;201;239;114;104;118;776
043894325030;1;205;273;255;57;123;913
046975702390;1;174;214;124;104;71;687
009234047563;1;276;215;208;62;110;871
000229670614;1;232;287;123;55;147;844
016424563831;1;235;182;165;82;103;767
022415350182;1;202;155;268;106;53;784
080184905921;1;116;264;164;51;81;676
067594134686;1;258;182;140;112;124;816
004284955806;1;272;153;245;109;87;866
057382893112;1;91;221;147;72;133;664
091976258691;1;273;133;190;67;60;723
006565586438;1;117;263;299;110;109;898
072486167444;1;183;199;205;89;139;815
096715580334;1;218;240;260;53;151;922
046726763781;1;229;223;273;68;153;946
074830088422;1;107;125;263;90;97;682
081543011235;1;89;224;148;61;118;640
031114856528;1;110;189;161;53;90;603
024235055350;1;123;143;271;115;120;772
059202435988;1;285;238;199;80;63;865
086324607785;1;255;180;297;53;67;852
037298436433;1;183;188;210;70;144;795
057722912496;1;186;137;295;61;82;761
016084109244;1;83;159;197;57;122;618
007377509285;1;281;266;242;73;58;920
081524648065;1;236;286;291;68;149;1030
009274988253;1;124;212;142;83;156;717
026523461540;1;91;177;120;97;156;641
070213101240;1;147;237;109;109;174;776
095528045530;1;188;130;288;114;162;882
098152403212;1;289;279;300;58;74;1000
038837457327;1;214;98;267;89;97;765
078379124436;1;255;123;231;64;126;799
067321168954;1;84;267;116;65;69;601
065126929936;1;104;91;123;103;93;514
058741517836;1;278;81;185;53;136;733
001734045760;1;197;206;165;83;119;770
002542341406;1;192;91;94;76;64;517
057580690503;1;262;254;214;90;69;889
093275580094;1;150;200;139;84;159;732
044944475486;1;282;171;114;90;116;773
090517997209;1;292;277;241;110;68;988
044515794621;1;221;126;114;95;134;690
092482496158;1;227;259;208;85;176;955
006223481429;1;119;156;99;86;147;607
002974795873;1;118;110;171;102;127;628
002154735348;1;191;176;123;83;169;742
085765770049;1;183;248;291;75;82;879
086639761541;1;220;163;156;107;124;770
088405886675;1;215;278;99;120;78;790
084406455264;1;202;232;291;112;163;1000
016070500119;1;161;209;222;78;104;774
056758767581;1;107;105;292;74;176;754
070513101086;1;157;262;107;105;100;731
073864653411;1;179;97;188;60;55;579
047128843368;1;116;223;293;109;81;822
076346051645;1;197;132;251;79;70;729
095294781980;1;284;96;91;86;72;629
008576760697;1;157;127;150;56;86;576
069144937477;1;110;128;173;55;107;573
009843194152;1;152;258;115;120;129;774
011356618449;1;202;124;235;55;154;770
060259463306;1;141;203;155;103;152;754
037615591860;1;231;123;96;65;75;590
003869260150;1;141;111;280;64;156;752
074742801007;1;223;254;196;50;141;864
071970317382;1;82;88;233;92;127;622
056430895558;1;101;185;231;56;136;709
014543926340;1;184;159;98;109;115;665
067064171336;1;216;100;206;115;109;746
098372298879;1;279;171;228;113;172;963
086211800268;1;207;125;154;117;74;677
056023641693;1;285;188;205;70;138;886
031250059117;1;135;156;92;81;52;516
017780391991;1;253;192;127;114;74;760
006074771294;1;126;129;99;77;103;534
054273849868;1;291;109;125;83;133;741
097603004274;1;102;219;200;83;61;665
084866439507;1;106;150;222;90;125;693
049914890835;1;218;258;253;74;117;920
078469021193;1;230;240;284;68;65;887
060025866446;1;252;171;250;80;61;814
087745176674;1;133;97;138;90;79;537
040727963093;1;248;92;236;57;59;692
056789964376;1;225;104;107;111;142;689
040292825576;1;159;196;108;83;150;696
063376682860;1;282;203;95;68;111;759
067296757322;1;88;84;134;68;111;485
032548970965;1;198;92;244;115;64;713
082423324751;1;118;250;100;53;128;649
001313885814;1;197;86;103;64;94;544
091207307356;1;205;139;214;63;146;767
036641352174;1;285;275;277;71;138;1046
076468253746;1;189;198;163;97;94;741
045136447896;1;106;256;208;89;162;821
063497845632;1;242;257;224;114;129;966
085623433872;1;210;95;252;68;58;683
021485564533;1;190;141;134;88;61;614
094819116677;1;195;117;167;67;52;598
048172172323;1;206;94;262;80;100;742
015848291153;1;221;231;212;51;96;811
019246501271;1;91;281;132;61;95;660
051381824944;1;139;210;102;93;89;633
018409230512;1;178;130;230;103;136;777
069660994076;1;239;174;192;100;66;771
025570854750;1;258;244;141;55;129;827
075239120766;1;93;236;177;120;85;711
052772843917;1;162;248;109;84;72;675
039344859471;1;130;212;138;108;72;660
037156398545;1;292;236;229;64;132;953
066000239271;1;191;142;207;82;131;753
015389408649;1;250;231;300;88;140;1009
054667635743;1;119;253;224;115;85;796
051280530619;1;163;180;184;55;63;645
042684835997;1;202;251;187;87;63;790
020287625066;1;173;227;96;78;103;677
077691442074;1;207;199;270;75;95;846
049454180362;1;170;110;234;65;74;653
045168330386;1;226;140;292;84;126;868
053206566567;1;123;121;98;113;54;509
079927807366;1;208;154;190;117;104;773
062148830773;1;287;135;162;103;91;778
049895514554;1;148;160;210;113;137;768
054281094788;1;191;91;241;77;100;700
004617291775;1;207;164;132;95;76;674
027184609058;1;276;132;163;93;50;714
021993766883;1;278;99;165;59;104;705
050730918608;1;235;160;240;115;173;923
041210009961;1;267;278;186;90;147;968
022404421526;1;202;234;195;85;59;775
033536708745;1;117;160;231;79;117;704
055480687275;1;125;186;219;87;80;697
055114992809;1;197;145;99;61;137;639
012047712105;1;135;203;160;103;68;669
001493679484;1;171;125;269;112;166;843
047786088449;1;92;211;240;64;148;755
012765112964;1;101;122;250;64;58;595
016551969114;1;248;153;297;118;157;973
098552902792;1;104;186;291;110;160;851
078602851480;1;173;192;198;77;114;754
020851322234;1;287;272;187;111;156;1013
053935024017;1;139;101;183;52;162;637
062059673666;1;157;116;271;78;151;773
015212366890;1;184;268;188;114;112;866
066774536269;1;129;168;298;96;112;803
042010794788;1;204;107;256;103;97;767
091569772846;1;222;141;172;97;70;702
069391598304;1;152;218;246;103;88;807
013124642455;1;161;141;288;57;74;721
093056741603;1;157;231;217;101;173;879
052433995299;1;262;242;294;94;52;944
021551010456;1;246;214;295;67;67;889
030934314969;1;229;221;172;80;124;826
068219561212;1;175;190;268;112;117;862
071500916491;1;153;129;102;57;62;503
010750048869;1;168;194;137;108;104;711
022703029601;1;251;116;133;120;141;761
080034594948;1;252;126;268;97;113;856
063712623727;1;132;118;181;93;148;672
046758465661;1;130;113;259;75;151;728
083515052678;1;110;145;280;98;105;738
049451953716;1;170;88;152;66;137;613
081244186082;1;175;220;108;95;79;677
022193095255;1;136;83;118;113;53;503
086095970017;1;121;163;240;73;87;684
009056817507;1;221;274;197;76;168;936
093716892053;1;140;161;105;71;136;613
060913730809;1;99;186;292;68;62;707
010611016153;1;203;86;174;76;109;648
055778419086;1;200;224;235;65;65;789
043436538747;1;85;93;218;88;55;539
062203645765;1;246;105;183;96;110;740
070605367284;1;163;193;219;89;64;728
082557267192;1;134;259;151;58;120;722
026578122030;1;260;243;279;114;142;1038
000656006933;1;193;237;125;60;70;685
014831111424;1;253;275;247;99;109;983
099256415909;1;181;127;246;50;141;745
031177410051;1;261;114;196;57;84;712
040309986366;1;131;263;221;117;87;819
019537494968;1;130;129;261;102;91;713
099010541938;1;124;85;179;102;62;552
074386892808;1;280;158;257;112;51;858
035644744882;1;173;266;158;58;107;762
041373743721;1;92;149;295;70;133;739
016477349168;1;208;168;193;63;68;700
047861209410;1;171;176;193;86;111;737
046342285698;1;124;119;176;61;72;552
015519069675;1;260;227;163;56;92;798
041960890581;1;147;80;113;93;135;568
058088775657;1;141;83;273;92;75;664
001039195869;1;123;262;260;55;131;831
028702130686;1;218;182;222;74;122;818
073082552710;1;247;186;205;98;142;878
038641132405;1;283;163;235;73;171;925
021922548036;1;167;162;274;88;53;744
025500693314;1;212;153;192;68;109;734
076196213415;1;265;152;238;102;160;917
098027791381;1;266;144;167;118;132;827
038375120381;1;130;197;132;74;124;657
012266187197;1;238;252;131;98;103;822
097216714749;1;223;94;201;58;88;664
072187277325;1;280;105;278;71;158;892
025657357113;1;241;213;227;52;145;878
087256028416;1;200;280;265;71;93;909
058914737831;1;102;141;282;70;145;740
066404280500;1;262;84;297;77;171;891
085304045099;1;114;108;245;59;68;594
094314500445;1;185;262;208;89;141;885
031650169555;1;215;243;106;94;156;814
073458282286;1;80;275;221;53;88;717
063126750722;1;96;252;93;71;119;631
094919517098;1;267;131;250;82;155;885
013851539384;1;177;232;214;54;143;820
056502609004;1;189;152;145;53;101;640
096887713046;1;120;177;253;51;178;779
099935359047;1;100;107;276;62;107;652
015521494416;1;236;149;195;115;125;820
020568586158;1;86;251;256;60;97;750
025224213158;1;110;93;159;94;157;613
095643919817;1;175;172;153;83;81;664
041800734877;1;95;117;95;102;142;551
089156705861;1;224;275;93;61;140;793
001596535921;1;168;216;196;100;61;741
085450468268;1;151;180;101;76;166;674
090936129319;1;286;101;219;69;102;777
068353340284;1;103;187;258;60;159;767
006824929062;1;125;173;196;68;68;630
085802861930;1;136;86;245;118;173;758
050256879150;1;162;194;97;102;105;660
064481399189;1;255;118;277;70;141;861
053443496054;1;124;282;300;119;143;968
043913974443;1;238;139;237;72;96;782
092597460426;1;247;222;289;78;167;1003
032229357363;1;144;146;171;52;119;632
097956472824;1;234;103;108;90;96;631
081224438906;1;122;105;243;105;83;658
016500299092;1;94;192;216;84;64;650
078692043049;1;182;167;220;69;108;746
021278638112;1;130;182;205;114;124;755
019554256704;1;205;173;208;105;175;866
042583007462;1;173;232;90;91;139;725
015440367161;1;131;241;108;55;126;661
049411183698;1;248;223;230;77;83;861
046290751441;1;146;192;297;81;126;842
030619704354;1;86;159;285;51;167;748
018319421995;1;292;283;116;72;96;859
014360099424;1;262;151;213;52;81;759
066707985071;1;211;103;298;71;106;789
071443317153;1;240;287;219;63;152;961
067319541191;1;105;103;267;105;52;632
025782571835;1;177;108;179;102;148;714
086627019901;1;281;194;269;75;118;937
000579147840;1;98;251;289;88;86;812
075988111386;1;92;161;195;69;158;675
089141305908;1;202;172;119;53;102;648
041970962766;1;123;279;123;90;104;719
053747701595;1;283;233;195;79;80;870
053978588539;1;160;99;281;87;95;722
037597864609;1;275;125;136;108;79;723
076756408837;1;156;87;232;86;59;620
018683458816;1;212;203;192;88;84;779
083022275813;1;220;121;103;59;169;672
053511888858;1;283;261;269;98;143;1054
091331943347;1;121;264;245;96;159;885
026003607361;1;85;269;136;87;159;736
037791427882;1;174;246;234;97;119;870
069960215788;1;85;94;189;115;87;570
043694410304;1;233;93;109;75;152;662
088104720026;1;271;189;277;108;92;937
018387092323;1;103;91;161;109;118;582
098572943287;1;144;202;101;94;164;705
042284565021;1;132;192;280;50;178;832
075212216932;1;202;219;210;75;94;800
017557816839;1;219;241;99;65;87;711
014370680064;1;126;126;90;50;63;455
016041297146;1;141;191;218;96;63;709
076572950083;1;177;251;283;81;71;863
037020860422;1;229;119;281;59;54;742
059118168746;1;287;94;179;112;85;757
040432082762;1;124;279;254;86;144;887
050415522077;1;236;234;296;101;115;982
036244469885;1;203;115;237;63;159;777
060203728445;1;241;264;160;59;81;805
070366538011;1;193;151;149;62;120;675
060664933831;1;142;108;244;87;134;715
000855225259;1;254;223;105;87;124;793
091719341620;1;267;233;182;63;150;895
076694969340;1;91;157;133;74;151;606
065494264532;1;135;164;129;86;117;631
070822982488;1;84;130;172;99;134;619
077530750564;1;262;222;98;81;58;721
078748166773;1;114;81;253;73;66;587
052563929614;1;213;195;233;81;84;806
013193358699;1;254;248;295;90;82;969
005268662040;1;126;280;130;68;101;705
068002178986;1;203;101;110;112;67;593
070819356617;1;183;202;181;58;115;739
045471034724;1;123;237;297;55;111;823
023255718189;1;279;97;105;77;166;724
088168852541;1;128;136;218;95;78;655
098594935387;1;285;256;165;51;136;893
000133526476;1;86;84;246;119;146;681
019674565894;1;241;224;253;56;101;875
021525273094;1;130;260;198;65;150;803
025904732952;1;111;288;249;101;143;892
096586443700;1;245;196;109;107;120;777
095151428258;1;92;168;294;67;72;693
061712450697;1;228;144;125;65;152;714
095922487617;1;97;246;290;120;145;898
095335093717;1;149;165;158;88;126;686
062202085874;1;135;142;235;94;102;708
047543982761;1;92;231;170;76;141;710
027721207909;1;275;125;134;77;159;770
037804040095;1;114;251;132;105;51;653
063622125253;1;217;82;281;96;93;769
042500190433;1;171;236;223;84;174;888
006079924702;1;227;165;264;100;89;845
045386423061;1;287;267;202;50;95;901
033892041432;1;245;164;129;95;68;701
025689011311;1;150;168;133;56;150;657
069993025908;1;85;170;168;92;124;639
032823337322;1;264;286;248;115;101;1014
048821368244;1;127;181;101;91;104;604
066074217662;1;181;255;278;101;52;867
061243972691;1;134;188;283;104;151;860
000613886140;1;190;227;171;88;63;739
020108338751;1;172;118;161;109;73;633
094035642410;1;214;215;208;82;120;839
049282258448;1;119;162;160;83;69;593
097885639437;1;131;161;164;101;119;676
050330836153;1;225;100;274;51;69;719
064861124753;1;83;208;225;114;145;775
001285640611;1;215;247;257;113;79;911
079628866996;1;237;266;205;69;119;896
020866519609;1;174;165;235;117;165;856
069695849974;1;232;224;179;103;87;825
007639732158;1;247;172;197;111;115;842
037498866750;1;289;96;212;57;116;770
022568025156;1;207;132;145;67;118;669
002432554976;1;135;139;136;70;131;611
012928048902;1;216;160;266;74;88;804
087878432616;1;113;153;219;85;90;660
034780899259;1;268;188;168;105;124;853
042351885610;1;218;183;107;107;140;755
025216822556;1;176;179;294;102;146;897
028077554177;1;93;192;239;69;90;683
055363767308;1;253;147;300;107;159;966
020470109557;1;87;143;262;94;162;748
047498199186;1;166;149;285;113;62;775
028121947420;1;82;124;104;118;81;509
086677192934;1;202;247;115;70;69;703
052065621045;1;211;269;124;113;78;795
033762431973;1;112;230;179;73;56;650
057252152072;1;278;123;202;93;78;774
021838991783;1;236;238;244;91;94;903
039935840145;1;179;100;133;86;173;671
091463529164;1;122;203;132;104;98;659
012589750813;1;234;282;132;50;118;816
097309266919;1;251;243;295;66;68;923
099881624386;1;209;277;120;119;168;893
063567726316;1;236;283;119;104;176;918
005742755334;1;224;271;296;81;73;945
032299948841;1;200;222;203;90;144;859
071685172879;1;112;86;288;69;140;695
071361113545;1;277;95;186;116;172;846
095445383066;1;150;231;151;66;95;693
004184751447;1;234;260;166;89;92;841
056128701962;1;279;98;92;87;174;730
066127066702;1;286;80;296;98;94;854
069099212238;1;213;160;183;82;112;750
087286255329;1;126;241;183;112;78;740
080404389801;1;90;124;300;82;149;745
054291373250;1;140;228;131;114;62;675
004990206489;1;268;194;244;107;103;916
013910965123;1;148;259;235;50;121;813
005221608099;1;84;123;128;53;176;564
088299782835;1;156;240;238;74;162;870
015675293873;1;229;131;259;52;164;835
082249539336;1;255;176;119;61;131;742
085486009132;1;208;113;283;59;99;762
010543541657;1;95;171;199;54;126;645
019606070554;1;283;225;147;69;145;869
026474382454;1;127;262;180;98;90;757
071559043025;1;149;177;144;52;82;604
017455909415;1;85;229;277;64;172;827
077981472918;1;140;261;121;81;159;762
006328105778;1;138;183;233;50;132;736
019270467205;1;208;207;231;98;117;861
077220107507;1;133;90;167;115;131;636
026336603274;1;218;108;296;91;95;808
093293337668;1;179;238;165;98;80;760
067234338620;1;204;125;149;113;177;768
023123785977;1;170;191;112;87;98;658
090087287266;1;162;106;164;90;91;613
055621668837;1;183;119;187;66;133;688
063384938282;1;211;279;115;92;134;831
070501724220;1;221;124;287;50;150;832
053650937791;1;203;95;247;79;109;733
052994154213;1;248;277;209;58;172;964
032955486811;1;245;231;231;112;106;925
021808850703;1;173;132;216;77;67;665
087305510705;1;245;96;105;61;71;578
008646238105;1;232;143;264;87;55;781
001906011157;1;126;141;218;85;105;675
035764913715;1;203;167;144;102;71;687
049827380100;1;159;86;98;62;170;575
055086131683;1;92;286;257;94;59;788
027821872946;1;96;155;150;64;50;515
033146014581;1;267;120;268;82;165;902
087914509876;1;211;109;248;118;73;759
099457247187;1;274;266;254;96;124;1014
048485334041;1;284;116;112;99;79;690
086859106842;1;197;116;133;60;98;604
004005733432;1;273;201;142;103;86;805
017974846034;1;102;277;297;105;94;875
078773866611;1;165;266;126;56;125;738
012949595149;1;214;156;168;57;124;719
027893913947;1;108;134;255;104;105;706
004027563445;1;285;130;98;108;149;770
070075657218;1;98;275;125;63;59;620
053344560160;1;292;103;212;84;128;819
018859427355;1;159;226;244;74;53;756
067048687956;1;246;265;166;107;81;865
002521313025;1;136;82;248;64;89;619
042982397280;1;280;204;102;103;147;836
020374539498;1;204;223;227;63;52;769
012519202269;1;200;95;272;53;61;681
002114563211;1;205;159;241;116;93;814
048348340638;1;239;170;94;91;67;661
068873950505;1;189;88;114;108;52;551
043896538876;1;291;233;207;50;59;840
078386057859;1;284;136;217;115;157;909
076093900045;1;145;280;294;102;165;986
043384336634;1;94;151;132;84;79;540
058109210708;1;263;272;143;100;54;832
091450805495;1;252;158;222;67;167;866
098658638148;1;198;256;203;75;66;798
034100640521;1;178;121;265;65;124;753
024060186412;1;150;123;144;77;112;606
032331627646;1;213;266;269;112;63;923
022908970907;1;109;104;93;75;57;438
069110816974;1;264;127;296;50;72;809
026430226524;1;289;94;134;51;66;634
080472724940;1;226;232;292;82;154;986
007300559731;1;281;158;236;68;59;802
020539741022;1;279;176;98;109;109;771
030299628809;1;144;219;241;103;124;831
013383966823;1;153;147;130;58;81;569
068338055826;1;211;133;266;113;122;845
079144455390;1;117;162;296;69;132;776
037418246831;1;129;143;255;119;146;792
031143285889;1;143;103;274;98;161;779
096072275345;1;276;154;254;92;127;903
042608981368;1;226;256;226;53;137;898
044870634923;1;272;111;237;57;162;839
047543578684;1;123;196;205;54;65;643
062086300918;1;248;280;278;93;116;1015
062559298567;1;291;147;203;83;68;792
009412700278;1;167;147;98;107;51;570
032939629665;1;270;226;200;94;162;952
029713942002;1;143;282;292;92;103;912
049458276880;1;159;82;271;64;96;672
022673216426;1;182;242;226;114;115;879
067098150933;1;134;127;138;107;70;576
026808953068;1;174;88;249;80;127;718
073464900995;1;272;278;235;100;100;985
030237173034;1;223;286;155;51;99;814
065131707299;1;228;97;182;65;165;737
080660310576;1;266;251;214;95;92;918
048141338436;1;196;112;227;104;149;788
010252537533;1;151;134;208;73;146;712
085295599633;1;289;132;92;59;79;651
045731183757;1;173;256;262;108;71;870
011701103808;1;82;168;166;86;122;624
027547924897;1;255;114;183;91;128;771
071166158899;1;132;288;155;74;73;722
098282420104;1;86;159;144;98;134;621
047137007649;1;213;245;124;72;117;771
068727540626;1;255;277;200;68;92;892
083825152269;1;265;172;232;89;74;832
071078309929;1;238;273;148;84;59;802
019314533861;1;227;181;243;90;65;806
042593252352;1;172;160;104;102;117;655
025781709106;1;99;85;281;106;71;642
069835262772;1;80;136;95;103;130;544
043545485254;1;126;120;280;84;57;667
012907348952;1;203;135;299;115;104;856
095319125681;1;128;232;204;63;87;714
043610326856;1;269;87;214;57;101;728
030305325079;1;195;231;147;72;155;800
074823697956;1;277;267;268;77;170;1059
093869670753;1;191;179;217;72;97;756
001951495844;1;248;153;162;79;116;758
014781776915;1;197;172;213;91;165;838
070471760351;1;150;263;192;99;57;761
065877732865;1;168;243;278;85;125;899
074663639231;1;82;89;205;68;54;498
089914153764;1;144;86;181;90;104;605
032461472497;1;122;212;257;109;135;835
047001185952;1;124;285;245;87;166;907
033061981988;1;205;167;204;75;100;751
003003537322;1;84;281;214;102;148;829
090172069017;1;201;218;293;84;61;857
017710060586;1;228;117;152;52;91;640
088486313670;1;269;246;119;98;132;864
093852224856;1;97;99;269;61;94;620
011300664758;1;279;266;178;65;110;898
033082264474;1;289;160;187;115;91;842
001641784956;1;83;281;255;119;173;911
065137505116;1;182;130;230;102;66;710
094327648086;1;277;230;163;84;74;828
063455918108;1;257;125;279;90;167;918
036881746307;1;81;188;182;54;175;680
025696321473;1;228;158;162;113;162;823
088687518243;1;175;119;238;80;77;689
045487053770;1;206;247;159;91;102;805
073263285702;1;248;211;161;83;78;781
073908216465;1;218;228;90;92;80;708
001485213290;1;184;275;267;87;174;987
002552787622;1;281;99;161;115;103;759
091373593065;1;247;182;134;57;151;771
043934177757;1;137;198;211;85;72;703
052233715052;1;225;199;274;65;177;940
059032300338;1;110;96;200;117;130;653
088222767230;1;123;221;157;67;129;697
067361315405;1;144;233;162;71;83;693
031016878520;1;176;96;277;100;106;755
084012693686;1;222;242;101;114;72;751
062792938679;1;127;154;102;86;90;559
033032967355;1;290;130;164;53;73;710
086001745417;1;113;89;285;80;170;737
078553905738;1;241;193;129;78;54;695
075686100439;1;86;157;269;77;66;655
050236264643;1;179;284;93;117;155;828
019784284080;1;238;149;127;105;55;674
097417668743;1;212;177;97;67;64;617
086186116396;1;253;124;205;116;161;859
005914746202;1;104;141;289;115;161;810
025918366515;1;102;259;239;93;61;754
009159688161;1;213;82;133;58;151;637
037817316938;1;129;132;266;118;161;806
024361084084;1;266;224;205;68;144;907
098853351014;1;271;190;177;110;94;842
039100818505;1;131;125;279;76;77;688
050914486448;1;236;133;254;84;50;757
008077001933;1;116;107;201;55;152;631
048255613148;1;160;268;175;99;58;760
003628362752;1;180;121;232;100;146;779
002360611586;1;111;215;295;71;108;800
008573487886;1;229;244;171;56;159;859
088373570618;1;238;215;278;61;52;844
043679695646;1;214;198;144;85;149;790
015418201666;1;85;265;127;100;124;701
039830335940;1;260;244;198;52;150;904
066623027083;1;184;111;156;82;177;710
093923526331;1;284;282;127;50;142;885
038497931070;1;154;141;265;86;109;755
091857348169;1;176;209;236;98;88;807
080528290934;1;287;191;217;58;161;914
091204360988;1;211;172;105;99;151;738
018177931878;1;105;153;193;87;107;645
050288254505;1;286;271;221;77;128;983
000472108132;1;104;239;227;118;84;772
039132669739;1;152;116;135;88;153;644
034673175713;1;113;184;138;105;52;592
066522635250;1;84;108;231;117;73;613
034157691999;1;196;94;235;67;138;730
086526799366;1;102;284;240;93;151;870
003547357107;1;136;239;269;72;126;842
007350881065;1;172;95;131;97;82;577
011797488262;1;266;278;250;114;108;1016
047327800199;1;212;255;108;66;61;702
085937406640;1;114;185;208;56;62;625
056522970514;1;251;174;164;109;94;792
094998362034;1;121;110;158;74;111;574
025776181619;1;224;84;282;52;135;777
032022858629;1;146;135;236;108;59;684
087057105304;1;268;249;99;119;54;789
099431021577;1;109;148;202;97;70;626
099236555860;1;240;138;223;106;50;757
094817732376;1;182;156;272;51;115;776
019070894268;1;260;91;170;81;64;666
071839841804;1;220;153;215;104;124;816
082736815676;1;237;287;244;76;91;935
058737286130;1;187;206;107;106;79;685
033620365232;1;228;277;187;114;113;919
005269169346;1;252;262;178;71;154;917
022326282672;1;119;98;269;80;102;668
011871305520;1;133;181;90;82;152;638
053431977795;1;122;192;227;84;172;797
061382742224;1;83;245;238;86;63;715
078524566132;1;183;188;162;97;149;779
087637993354;1;253;275;150;75;139;892
072012207764;1;246;84;131;95;95;651
044743434482;1;110;277;158;62;116;723
067235445367;1;145;110;144;108;118;625
019258358830;1;128;287;240;111;76;842
056925902335;1;168;182;135;67;94;646
087265868964;1;126;121;150;60;112;569
044235965928;1;156;134;127;98;64;579
037863655764;1;240;165;290;93;73;861
000670277935;1;250;214;209;74;64;811
092126189256;1;290;187;283;115;112;987
014408123828;1;289;189;101;64;77;720
088836808684;1;156;89;148;77;160;630
085777895474;1;153;223;277;81;59;793
023043215071;1;153;269;244;53;156;875
040874005162;1;279;128;129;86;63;685
028008351606;1;128;158;293;116;149;844
088058247058;1;128;85;213;81;75;582
063410707335;1;109;90;187;79;156;621
049666447573;1;202;170;206;86;132;796
013354186244;1;278;131;151;63;136;759
057399162190;1;193;232;216;99;79;819
065395639989;1;196;189;114;91;106;696
056772574525;1;205;279;93;95;177;849
